LocationID,SensingDateTime,SensingDate,SensingTime,Direction_1,Direction_2,total_of_Directions
6,2023-06-05T11:26:00+10:00,2023-06-05,11:26,6,8,14
29,2023-06-05T11:26:00+10:00,2023-06-05,11:26,2,1,3
31,2023-06-05T11:26:00+10:00,2023-06-05,11:26,0,1,1
36,2023-06-05T11:26:00+10:00,2023-06-05,11:26,5,7,12
37,2023-06-05T11:26:00+10:00,2023-06-05,11:26,1,3,4
41,2023-06-05T11:26:00+10:00,2023-06-05,11:26,37,19,56
47,2023-06-05T11:26:00+10:00,2023-06-05,11:26,9,9,18
50,2023-06-05T11:26:00+10:00,2023-06-05,11:26,0,4,4
66,2023-06-05T11:26:00+10:00,2023-06-05,11:26,5,10,15
70,2023-06-05T11:26:00+10:00,2023-06-05,11:26,1,3,4
87,2023-06-05T11:26:00+10:00,2023-06-05,11:26,2,4,6
1,2023-06-05T11:26:00+10:00,2023-06-05,11:26,8,12,20
12,2023-06-05T11:26:00+10:00,2023-06-05,11:26,1,1,2
18,2023-06-05T11:26:00+10:00,2023-06-05,11:26,1,7,8
19,2023-06-05T11:26:00+10:00,2023-06-05,11:26,2,0,2
57,2023-06-05T11:26:00+10:00,2023-06-05,11:26,4,5,9
58,2023-06-05T11:26:00+10:00,2023-06-05,11:26,11,2,13
62,2023-06-05T11:26:00+10:00,2023-06-05,11:26,0,2,2
67,2023-06-05T11:26:00+10:00,2023-06-05,11:26,5,6,11
79,2023-06-05T11:26:00+10:00,2023-06-05,11:26,20,3,23
3,2023-06-05T11:26:00+10:00,2023-06-05,11:26,17,23,40
4,2023-06-05T11:26:00+10:00,2023-06-05,11:26,16,15,31
5,2023-06-05T11:26:00+10:00,2023-06-05,11:26,19,15,34
8,2023-06-05T11:26:00+10:00,2023-06-05,11:26,1,1,2
14,2023-06-05T11:26:00+10:00,2023-06-05,11:26,4,2,6
26,2023-06-05T11:26:00+10:00,2023-06-05,11:26,1,4,5
28,2023-06-05T11:26:00+10:00,2023-06-05,11:26,3,3,6
40,2023-06-05T11:26:00+10:00,2023-06-05,11:26,3,10,13
42,2023-06-05T11:26:00+10:00,2023-06-05,11:26,1,3,4
44,2023-06-05T11:26:00+10:00,2023-06-05,11:26,3,0,3
45,2023-06-05T11:26:00+10:00,2023-06-05,11:26,13,2,15
54,2023-06-05T11:26:00+10:00,2023-06-05,11:26,2,2,4
61,2023-06-05T11:26:00+10:00,2023-06-05,11:26,3,6,9
65,2023-06-05T11:26:00+10:00,2023-06-05,11:26,30,0,30
75,2023-06-05T11:26:00+10:00,2023-06-05,11:26,3,0,3
77,2023-06-05T11:26:00+10:00,2023-06-05,11:26,1,2,3
78,2023-06-05T11:26:00+10:00,2023-06-05,11:26,0,1,1
108,2023-06-05T11:26:00+10:00,2023-06-05,11:26,3,6,9
9,2023-06-05T11:26:00+10:00,2023-06-05,11:26,0,2,2
17,2023-06-05T11:26:00+10:00,2023-06-05,11:26,1,4,5
24,2023-06-05T11:26:00+10:00,2023-06-05,11:26,15,4,19
30,2023-06-05T11:26:00+10:00,2023-06-05,11:26,3,2,5
48,2023-06-05T11:26:00+10:00,2023-06-05,11:26,1,2,3
49,2023-06-05T11:26:00+10:00,2023-06-05,11:26,0,2,2
53,2023-06-05T11:26:00+10:00,2023-06-05,11:26,7,1,8
63,2023-06-05T11:26:00+10:00,2023-06-05,11:26,1,3,4
72,2023-06-05T11:26:00+10:00,2023-06-05,11:26,3,5,8
21,2023-06-05T11:26:00+10:00,2023-06-05,11:26,7,1,8
39,2023-06-05T11:26:00+10:00,2023-06-05,11:26,1,0,1
55,2023-06-05T11:26:00+10:00,2023-06-05,11:26,6,5,11
2,2023-06-05T11:26:00+10:00,2023-06-05,11:26,6,4,10
10,2023-06-05T11:26:00+10:00,2023-06-05,11:26,0,2,2
20,2023-06-05T11:26:00+10:00,2023-06-05,11:26,1,2,3
23,2023-06-05T11:26:00+10:00,2023-06-05,11:26,1,3,4
35,2023-06-05T11:26:00+10:00,2023-06-05,11:26,7,10,17
46,2023-06-05T11:26:00+10:00,2023-06-05,11:26,0,5,5
51,2023-06-05T11:26:00+10:00,2023-06-05,11:26,0,1,1
52,2023-06-05T11:26:00+10:00,2023-06-05,11:26,9,1,10
56,2023-06-05T11:26:00+10:00,2023-06-05,11:26,9,0,9
68,2023-06-05T11:26:00+10:00,2023-06-05,11:26,1,1,2
76,2023-06-05T11:26:00+10:00,2023-06-05,11:26,1,1,2
85,2023-06-05T11:26:00+10:00,2023-06-05,11:26,0,2,2
86,2023-06-05T11:26:00+10:00,2023-06-05,11:26,4,1,5
3,2023-06-05T11:25:00+10:00,2023-06-05,11:25,10,8,18
4,2023-06-05T11:25:00+10:00,2023-06-05,11:25,12,18,30
5,2023-06-05T11:25:00+10:00,2023-06-05,11:25,4,10,14
14,2023-06-05T11:25:00+10:00,2023-06-05,11:25,18,0,18
36,2023-06-05T11:25:00+10:00,2023-06-05,11:25,1,2,3
37,2023-06-05T11:25:00+10:00,2023-06-05,11:25,1,1,2
39,2023-06-05T11:25:00+10:00,2023-06-05,11:25,2,1,3
45,2023-06-05T11:25:00+10:00,2023-06-05,11:25,5,5,10
47,2023-06-05T11:25:00+10:00,2023-06-05,11:25,8,7,15
50,2023-06-05T11:25:00+10:00,2023-06-05,11:25,2,1,3
54,2023-06-05T11:25:00+10:00,2023-06-05,11:25,1,0,1
61,2023-06-05T11:25:00+10:00,2023-06-05,11:25,2,8,10
84,2023-06-05T11:25:00+10:00,2023-06-05,11:25,65,45,110
108,2023-06-05T11:25:00+10:00,2023-06-05,11:25,2,8,10
2,2023-06-05T11:25:00+10:00,2023-06-05,11:25,4,5,9
9,2023-06-05T11:25:00+10:00,2023-06-05,11:25,4,2,6
10,2023-06-05T11:25:00+10:00,2023-06-05,11:25,3,0,3
11,2023-06-05T11:25:00+10:00,2023-06-05,11:25,1,5,6
12,2023-06-05T11:25:00+10:00,2023-06-05,11:25,2,0,2
48,2023-06-05T11:25:00+10:00,2023-06-05,11:25,3,1,4
56,2023-06-05T11:25:00+10:00,2023-06-05,11:25,4,3,7
57,2023-06-05T11:25:00+10:00,2023-06-05,11:25,4,4,8
58,2023-06-05T11:25:00+10:00,2023-06-05,11:25,1,3,4
68,2023-06-05T11:25:00+10:00,2023-06-05,11:25,6,1,7
72,2023-06-05T11:25:00+10:00,2023-06-05,11:25,3,0,3
86,2023-06-05T11:25:00+10:00,2023-06-05,11:25,0,3,3
21,2023-06-05T11:25:00+10:00,2023-06-05,11:25,6,3,9
26,2023-06-05T11:25:00+10:00,2023-06-05,11:25,6,8,14
29,2023-06-05T11:25:00+10:00,2023-06-05,11:25,2,4,6
41,2023-06-05T11:25:00+10:00,2023-06-05,11:25,35,16,51
55,2023-06-05T11:25:00+10:00,2023-06-05,11:25,7,11,18
59,2023-06-05T11:25:00+10:00,2023-06-05,11:25,27,28,55
65,2023-06-05T11:25:00+10:00,2023-06-05,11:25,3,3,6
66,2023-06-05T11:25:00+10:00,2023-06-05,11:25,5,7,12
107,2023-06-05T11:25:00+10:00,2023-06-05,11:25,9,11,20
17,2023-06-05T11:25:00+10:00,2023-06-05,11:25,6,7,13
20,2023-06-05T11:25:00+10:00,2023-06-05,11:25,1,6,7
24,2023-06-05T11:25:00+10:00,2023-06-05,11:25,3,7,10
30,2023-06-05T11:25:00+10:00,2023-06-05,11:25,2,2,4
49,2023-06-05T11:25:00+10:00,2023-06-05,11:25,0,2,2
52,2023-06-05T11:25:00+10:00,2023-06-05,11:25,8,11,19
62,2023-06-05T11:25:00+10:00,2023-06-05,11:25,4,3,7
63,2023-06-05T11:25:00+10:00,2023-06-05,11:25,7,1,8
67,2023-06-05T11:25:00+10:00,2023-06-05,11:25,19,9,28
76,2023-06-05T11:25:00+10:00,2023-06-05,11:25,0,1,1
109,2023-06-05T11:25:00+10:00,2023-06-05,11:25,11,10,21
6,2023-06-05T11:25:00+10:00,2023-06-05,11:25,4,7,11
28,2023-06-05T11:25:00+10:00,2023-06-05,11:25,2,2,4
31,2023-06-05T11:25:00+10:00,2023-06-05,11:25,1,0,1
40,2023-06-05T11:25:00+10:00,2023-06-05,11:25,0,1,1
44,2023-06-05T11:25:00+10:00,2023-06-05,11:25,0,1,1
69,2023-06-05T11:25:00+10:00,2023-06-05,11:25,4,1,5
75,2023-06-05T11:25:00+10:00,2023-06-05,11:25,1,1,2
77,2023-06-05T11:25:00+10:00,2023-06-05,11:25,0,1,1
87,2023-06-05T11:25:00+10:00,2023-06-05,11:25,0,3,3
1,2023-06-05T11:25:00+10:00,2023-06-05,11:25,15,7,22
18,2023-06-05T11:25:00+10:00,2023-06-05,11:25,6,3,9
19,2023-06-05T11:25:00+10:00,2023-06-05,11:25,7,5,12
23,2023-06-05T11:25:00+10:00,2023-06-05,11:25,3,4,7
27,2023-06-05T11:25:00+10:00,2023-06-05,11:25,2,0,2
35,2023-06-05T11:25:00+10:00,2023-06-05,11:25,8,9,17
46,2023-06-05T11:25:00+10:00,2023-06-05,11:25,1,1,2
53,2023-06-05T11:25:00+10:00,2023-06-05,11:25,11,8,19
79,2023-06-05T11:25:00+10:00,2023-06-05,11:25,3,7,10
85,2023-06-05T11:25:00+10:00,2023-06-05,11:25,1,0,1
117,2023-06-05T11:25:00+10:00,2023-06-05,11:25,10,15,25
21,2023-06-05T11:24:00+10:00,2023-06-05,11:24,5,3,8
26,2023-06-05T11:24:00+10:00,2023-06-05,11:24,4,2,6
40,2023-06-05T11:24:00+10:00,2023-06-05,11:24,2,2,4
42,2023-06-05T11:24:00+10:00,2023-06-05,11:24,2,1,3
55,2023-06-05T11:24:00+10:00,2023-06-05,11:24,5,12,17
65,2023-06-05T11:24:00+10:00,2023-06-05,11:24,5,16,21
66,2023-06-05T11:24:00+10:00,2023-06-05,11:24,8,10,18
108,2023-06-05T11:24:00+10:00,2023-06-05,11:24,3,4,7
1,2023-06-05T11:24:00+10:00,2023-06-05,11:24,8,9,17
2,2023-06-05T11:24:00+10:00,2023-06-05,11:24,9,11,20
10,2023-06-05T11:24:00+10:00,2023-06-05,11:24,1,2,3
30,2023-06-05T11:24:00+10:00,2023-06-05,11:24,2,4,6
35,2023-06-05T11:24:00+10:00,2023-06-05,11:24,10,7,17
48,2023-06-05T11:24:00+10:00,2023-06-05,11:24,1,6,7
49,2023-06-05T11:24:00+10:00,2023-06-05,11:24,1,1,2
52,2023-06-05T11:24:00+10:00,2023-06-05,11:24,1,3,4
53,2023-06-05T11:24:00+10:00,2023-06-05,11:24,11,5,16
58,2023-06-05T11:24:00+10:00,2023-06-05,11:24,8,1,9
62,2023-06-05T11:24:00+10:00,2023-06-05,11:24,0,2,2
67,2023-06-05T11:24:00+10:00,2023-06-05,11:24,11,3,14
68,2023-06-05T11:24:00+10:00,2023-06-05,11:24,3,3,6
4,2023-06-05T11:24:00+10:00,2023-06-05,11:24,16,9,25
5,2023-06-05T11:24:00+10:00,2023-06-05,11:24,3,6,9
6,2023-06-05T11:24:00+10:00,2023-06-05,11:24,9,12,21
14,2023-06-05T11:24:00+10:00,2023-06-05,11:24,8,0,8
31,2023-06-05T11:24:00+10:00,2023-06-05,11:24,1,2,3
44,2023-06-05T11:24:00+10:00,2023-06-05,11:24,0,3,3
54,2023-06-05T11:24:00+10:00,2023-06-05,11:24,1,0,1
61,2023-06-05T11:24:00+10:00,2023-06-05,11:24,4,7,11
70,2023-06-05T11:24:00+10:00,2023-06-05,11:24,0,5,5
75,2023-06-05T11:24:00+10:00,2023-06-05,11:24,1,2,3
12,2023-06-05T11:24:00+10:00,2023-06-05,11:24,2,6,8
18,2023-06-05T11:24:00+10:00,2023-06-05,11:24,3,1,4
20,2023-06-05T11:24:00+10:00,2023-06-05,11:24,2,5,7
23,2023-06-05T11:24:00+10:00,2023-06-05,11:24,4,2,6
51,2023-06-05T11:24:00+10:00,2023-06-05,11:24,1,0,1
56,2023-06-05T11:24:00+10:00,2023-06-05,11:24,2,1,3
76,2023-06-05T11:24:00+10:00,2023-06-05,11:24,0,1,1
79,2023-06-05T11:24:00+10:00,2023-06-05,11:24,2,4,6
86,2023-06-05T11:24:00+10:00,2023-06-05,11:24,1,2,3
3,2023-06-05T11:24:00+10:00,2023-06-05,11:24,6,6,12
8,2023-06-05T11:24:00+10:00,2023-06-05,11:24,0,1,1
28,2023-06-05T11:24:00+10:00,2023-06-05,11:24,0,5,5
29,2023-06-05T11:24:00+10:00,2023-06-05,11:24,7,0,7
36,2023-06-05T11:24:00+10:00,2023-06-05,11:24,3,3,6
37,2023-06-05T11:24:00+10:00,2023-06-05,11:24,1,1,2
41,2023-06-05T11:24:00+10:00,2023-06-05,11:24,25,18,43
45,2023-06-05T11:24:00+10:00,2023-06-05,11:24,1,6,7
47,2023-06-05T11:24:00+10:00,2023-06-05,11:24,6,11,17
50,2023-06-05T11:24:00+10:00,2023-06-05,11:24,6,2,8
87,2023-06-05T11:24:00+10:00,2023-06-05,11:24,3,3,6
17,2023-06-05T11:24:00+10:00,2023-06-05,11:24,5,7,12
19,2023-06-05T11:24:00+10:00,2023-06-05,11:24,10,1,11
24,2023-06-05T11:24:00+10:00,2023-06-05,11:24,7,5,12
27,2023-06-05T11:24:00+10:00,2023-06-05,11:24,3,0,3
46,2023-06-05T11:24:00+10:00,2023-06-05,11:24,1,1,2
57,2023-06-05T11:24:00+10:00,2023-06-05,11:24,1,2,3
63,2023-06-05T11:24:00+10:00,2023-06-05,11:24,3,0,3
72,2023-06-05T11:24:00+10:00,2023-06-05,11:24,3,2,5
85,2023-06-05T11:24:00+10:00,2023-06-05,11:24,1,2,3
4,2023-06-05T11:23:00+10:00,2023-06-05,11:23,21,14,35
6,2023-06-05T11:23:00+10:00,2023-06-05,11:23,7,7,14
28,2023-06-05T11:23:00+10:00,2023-06-05,11:23,11,1,12
31,2023-06-05T11:23:00+10:00,2023-06-05,11:23,2,1,3
39,2023-06-05T11:23:00+10:00,2023-06-05,11:23,0,5,5
41,2023-06-05T11:23:00+10:00,2023-06-05,11:23,24,11,35
44,2023-06-05T11:23:00+10:00,2023-06-05,11:23,0,4,4
45,2023-06-05T11:23:00+10:00,2023-06-05,11:23,7,5,12
47,2023-06-05T11:23:00+10:00,2023-06-05,11:23,7,12,19
66,2023-06-05T11:23:00+10:00,2023-06-05,11:23,8,20,28
69,2023-06-05T11:23:00+10:00,2023-06-05,11:23,0,1,1
75,2023-06-05T11:23:00+10:00,2023-06-05,11:23,1,0,1
78,2023-06-05T11:23:00+10:00,2023-06-05,11:23,0,1,1
87,2023-06-05T11:23:00+10:00,2023-06-05,11:23,0,3,3
1,2023-06-05T11:23:00+10:00,2023-06-05,11:23,14,10,24
24,2023-06-05T11:23:00+10:00,2023-06-05,11:23,8,7,15
30,2023-06-05T11:23:00+10:00,2023-06-05,11:23,2,3,5
35,2023-06-05T11:23:00+10:00,2023-06-05,11:23,6,5,11
51,2023-06-05T11:23:00+10:00,2023-06-05,11:23,0,1,1
52,2023-06-05T11:23:00+10:00,2023-06-05,11:23,4,0,4
58,2023-06-05T11:23:00+10:00,2023-06-05,11:23,9,1,10
62,2023-06-05T11:23:00+10:00,2023-06-05,11:23,1,0,1
67,2023-06-05T11:23:00+10:00,2023-06-05,11:23,2,3,5
68,2023-06-05T11:23:00+10:00,2023-06-05,11:23,3,1,4
5,2023-06-05T11:23:00+10:00,2023-06-05,11:23,9,12,21
8,2023-06-05T11:23:00+10:00,2023-06-05,11:23,0,3,3
14,2023-06-05T11:23:00+10:00,2023-06-05,11:23,2,0,2
61,2023-06-05T11:23:00+10:00,2023-06-05,11:23,3,4,7
65,2023-06-05T11:23:00+10:00,2023-06-05,11:23,4,6,10
70,2023-06-05T11:23:00+10:00,2023-06-05,11:23,2,0,2
108,2023-06-05T11:23:00+10:00,2023-06-05,11:23,4,6,10
2,2023-06-05T11:23:00+10:00,2023-06-05,11:23,6,9,15
10,2023-06-05T11:23:00+10:00,2023-06-05,11:23,0,2,2
12,2023-06-05T11:23:00+10:00,2023-06-05,11:23,0,6,6
19,2023-06-05T11:23:00+10:00,2023-06-05,11:23,1,0,1
48,2023-06-05T11:23:00+10:00,2023-06-05,11:23,2,1,3
53,2023-06-05T11:23:00+10:00,2023-06-05,11:23,16,5,21
56,2023-06-05T11:23:00+10:00,2023-06-05,11:23,8,2,10
63,2023-06-05T11:23:00+10:00,2023-06-05,11:23,4,3,7
3,2023-06-05T11:23:00+10:00,2023-06-05,11:23,6,15,21
21,2023-06-05T11:23:00+10:00,2023-06-05,11:23,3,2,5
26,2023-06-05T11:23:00+10:00,2023-06-05,11:23,8,4,12
29,2023-06-05T11:23:00+10:00,2023-06-05,11:23,6,3,9
36,2023-06-05T11:23:00+10:00,2023-06-05,11:23,1,1,2
40,2023-06-05T11:23:00+10:00,2023-06-05,11:23,2,0,2
42,2023-06-05T11:23:00+10:00,2023-06-05,11:23,0,1,1
50,2023-06-05T11:23:00+10:00,2023-06-05,11:23,1,3,4
54,2023-06-05T11:23:00+10:00,2023-06-05,11:23,4,3,7
55,2023-06-05T11:23:00+10:00,2023-06-05,11:23,3,7,10
17,2023-06-05T11:23:00+10:00,2023-06-05,11:23,4,6,10
18,2023-06-05T11:23:00+10:00,2023-06-05,11:23,1,1,2
20,2023-06-05T11:23:00+10:00,2023-06-05,11:23,6,1,7
27,2023-06-05T11:23:00+10:00,2023-06-05,11:23,0,1,1
49,2023-06-05T11:23:00+10:00,2023-06-05,11:23,1,1,2
57,2023-06-05T11:23:00+10:00,2023-06-05,11:23,5,4,9
72,2023-06-05T11:23:00+10:00,2023-06-05,11:23,2,6,8
79,2023-06-05T11:23:00+10:00,2023-06-05,11:23,4,4,8
86,2023-06-05T11:23:00+10:00,2023-06-05,11:23,0,1,1
14,2023-06-05T11:22:00+10:00,2023-06-05,11:22,3,4,7
21,2023-06-05T11:22:00+10:00,2023-06-05,11:22,6,6,12
29,2023-06-05T11:22:00+10:00,2023-06-05,11:22,8,2,10
44,2023-06-05T11:22:00+10:00,2023-06-05,11:22,1,2,3
45,2023-06-05T11:22:00+10:00,2023-06-05,11:22,11,3,14
50,2023-06-05T11:22:00+10:00,2023-06-05,11:22,1,4,5
55,2023-06-05T11:22:00+10:00,2023-06-05,11:22,6,11,17
66,2023-06-05T11:22:00+10:00,2023-06-05,11:22,35,5,40
69,2023-06-05T11:22:00+10:00,2023-06-05,11:22,2,0,2
75,2023-06-05T11:22:00+10:00,2023-06-05,11:22,2,0,2
78,2023-06-05T11:22:00+10:00,2023-06-05,11:22,1,2,3
87,2023-06-05T11:22:00+10:00,2023-06-05,11:22,1,2,3
108,2023-06-05T11:22:00+10:00,2023-06-05,11:22,7,2,9
1,2023-06-05T11:22:00+10:00,2023-06-05,11:22,21,7,28
2,2023-06-05T11:22:00+10:00,2023-06-05,11:22,5,6,11
11,2023-06-05T11:22:00+10:00,2023-06-05,11:22,0,1,1
20,2023-06-05T11:22:00+10:00,2023-06-05,11:22,8,1,9
23,2023-06-05T11:22:00+10:00,2023-06-05,11:22,6,6,12
51,2023-06-05T11:22:00+10:00,2023-06-05,11:22,3,0,3
56,2023-06-05T11:22:00+10:00,2023-06-05,11:22,4,2,6
63,2023-06-05T11:22:00+10:00,2023-06-05,11:22,1,5,6
72,2023-06-05T11:22:00+10:00,2023-06-05,11:22,0,3,3
79,2023-06-05T11:22:00+10:00,2023-06-05,11:22,2,8,10
85,2023-06-05T11:22:00+10:00,2023-06-05,11:22,1,0,1
86,2023-06-05T11:22:00+10:00,2023-06-05,11:22,1,0,1
3,2023-06-05T11:22:00+10:00,2023-06-05,11:22,4,12,16
6,2023-06-05T11:22:00+10:00,2023-06-05,11:22,9,5,14
26,2023-06-05T11:22:00+10:00,2023-06-05,11:22,5,2,7
28,2023-06-05T11:22:00+10:00,2023-06-05,11:22,3,5,8
40,2023-06-05T11:22:00+10:00,2023-06-05,11:22,3,7,10
41,2023-06-05T11:22:00+10:00,2023-06-05,11:22,30,7,37
42,2023-06-05T11:22:00+10:00,2023-06-05,11:22,1,0,1
47,2023-06-05T11:22:00+10:00,2023-06-05,11:22,9,4,13
61,2023-06-05T11:22:00+10:00,2023-06-05,11:22,6,5,11
17,2023-06-05T11:22:00+10:00,2023-06-05,11:22,8,4,12
18,2023-06-05T11:22:00+10:00,2023-06-05,11:22,3,3,6
24,2023-06-05T11:22:00+10:00,2023-06-05,11:22,3,6,9
46,2023-06-05T11:22:00+10:00,2023-06-05,11:22,5,1,6
48,2023-06-05T11:22:00+10:00,2023-06-05,11:22,2,2,4
52,2023-06-05T11:22:00+10:00,2023-06-05,11:22,1,2,3
53,2023-06-05T11:22:00+10:00,2023-06-05,11:22,9,13,22
57,2023-06-05T11:22:00+10:00,2023-06-05,11:22,4,2,6
58,2023-06-05T11:22:00+10:00,2023-06-05,11:22,4,2,6
4,2023-06-05T11:22:00+10:00,2023-06-05,11:22,16,9,25
5,2023-06-05T11:22:00+10:00,2023-06-05,11:22,1,9,10
8,2023-06-05T11:22:00+10:00,2023-06-05,11:22,1,0,1
36,2023-06-05T11:22:00+10:00,2023-06-05,11:22,1,0,1
37,2023-06-05T11:22:00+10:00,2023-06-05,11:22,0,4,4
39,2023-06-05T11:22:00+10:00,2023-06-05,11:22,4,2,6
54,2023-06-05T11:22:00+10:00,2023-06-05,11:22,2,1,3
65,2023-06-05T11:22:00+10:00,2023-06-05,11:22,2,6,8
70,2023-06-05T11:22:00+10:00,2023-06-05,11:22,4,3,7
77,2023-06-05T11:22:00+10:00,2023-06-05,11:22,0,4,4
9,2023-06-05T11:22:00+10:00,2023-06-05,11:22,6,8,14
12,2023-06-05T11:22:00+10:00,2023-06-05,11:22,2,2,4
19,2023-06-05T11:22:00+10:00,2023-06-05,11:22,3,5,8
27,2023-06-05T11:22:00+10:00,2023-06-05,11:22,3,1,4
35,2023-06-05T11:22:00+10:00,2023-06-05,11:22,6,5,11
62,2023-06-05T11:22:00+10:00,2023-06-05,11:22,6,4,10
67,2023-06-05T11:22:00+10:00,2023-06-05,11:22,8,3,11
68,2023-06-05T11:22:00+10:00,2023-06-05,11:22,3,0,3
76,2023-06-05T11:22:00+10:00,2023-06-05,11:22,2,3,5
8,2023-06-05T11:21:00+10:00,2023-06-05,11:21,0,4,4
26,2023-06-05T11:21:00+10:00,2023-06-05,11:21,0,3,3
31,2023-06-05T11:21:00+10:00,2023-06-05,11:21,0,3,3
39,2023-06-05T11:21:00+10:00,2023-06-05,11:21,2,2,4
41,2023-06-05T11:21:00+10:00,2023-06-05,11:21,10,10,20
54,2023-06-05T11:21:00+10:00,2023-06-05,11:21,0,1,1
61,2023-06-05T11:21:00+10:00,2023-06-05,11:21,2,4,6
77,2023-06-05T11:21:00+10:00,2023-06-05,11:21,5,0,5
87,2023-06-05T11:21:00+10:00,2023-06-05,11:21,1,0,1
1,2023-06-05T11:21:00+10:00,2023-06-05,11:21,34,13,47
18,2023-06-05T11:21:00+10:00,2023-06-05,11:21,3,3,6
24,2023-06-05T11:21:00+10:00,2023-06-05,11:21,10,9,19
49,2023-06-05T11:21:00+10:00,2023-06-05,11:21,1,2,3
62,2023-06-05T11:21:00+10:00,2023-06-05,11:21,0,1,1
63,2023-06-05T11:21:00+10:00,2023-06-05,11:21,4,4,8
5,2023-06-05T11:21:00+10:00,2023-06-05,11:21,2,10,12
21,2023-06-05T11:21:00+10:00,2023-06-05,11:21,5,5,10
28,2023-06-05T11:21:00+10:00,2023-06-05,11:21,1,4,5
40,2023-06-05T11:21:00+10:00,2023-06-05,11:21,3,6,9
42,2023-06-05T11:21:00+10:00,2023-06-05,11:21,2,2,4
47,2023-06-05T11:21:00+10:00,2023-06-05,11:21,8,20,28
50,2023-06-05T11:21:00+10:00,2023-06-05,11:21,5,4,9
55,2023-06-05T11:21:00+10:00,2023-06-05,11:21,4,9,13
65,2023-06-05T11:21:00+10:00,2023-06-05,11:21,2,4,6
75,2023-06-05T11:21:00+10:00,2023-06-05,11:21,0,1,1
2,2023-06-05T11:21:00+10:00,2023-06-05,11:21,8,6,14
9,2023-06-05T11:21:00+10:00,2023-06-05,11:21,0,4,4
10,2023-06-05T11:21:00+10:00,2023-06-05,11:21,2,1,3
12,2023-06-05T11:21:00+10:00,2023-06-05,11:21,1,0,1
20,2023-06-05T11:21:00+10:00,2023-06-05,11:21,4,0,4
23,2023-06-05T11:21:00+10:00,2023-06-05,11:21,1,5,6
30,2023-06-05T11:21:00+10:00,2023-06-05,11:21,2,4,6
52,2023-06-05T11:21:00+10:00,2023-06-05,11:21,4,3,7
53,2023-06-05T11:21:00+10:00,2023-06-05,11:21,6,10,16
58,2023-06-05T11:21:00+10:00,2023-06-05,11:21,3,2,5
67,2023-06-05T11:21:00+10:00,2023-06-05,11:21,7,1,8
68,2023-06-05T11:21:00+10:00,2023-06-05,11:21,4,3,7
85,2023-06-05T11:21:00+10:00,2023-06-05,11:21,2,0,2
3,2023-06-05T11:21:00+10:00,2023-06-05,11:21,5,12,17
4,2023-06-05T11:21:00+10:00,2023-06-05,11:21,15,9,24
6,2023-06-05T11:21:00+10:00,2023-06-05,11:21,4,1,5
14,2023-06-05T11:21:00+10:00,2023-06-05,11:21,8,2,10
29,2023-06-05T11:21:00+10:00,2023-06-05,11:21,2,1,3
36,2023-06-05T11:21:00+10:00,2023-06-05,11:21,2,3,5
45,2023-06-05T11:21:00+10:00,2023-06-05,11:21,3,2,5
66,2023-06-05T11:21:00+10:00,2023-06-05,11:21,9,7,16
70,2023-06-05T11:21:00+10:00,2023-06-05,11:21,0,4,4
108,2023-06-05T11:21:00+10:00,2023-06-05,11:21,4,4,8
17,2023-06-05T11:21:00+10:00,2023-06-05,11:21,7,7,14
19,2023-06-05T11:21:00+10:00,2023-06-05,11:21,8,1,9
35,2023-06-05T11:21:00+10:00,2023-06-05,11:21,8,4,12
48,2023-06-05T11:21:00+10:00,2023-06-05,11:21,1,12,13
57,2023-06-05T11:21:00+10:00,2023-06-05,11:21,0,2,2
72,2023-06-05T11:21:00+10:00,2023-06-05,11:21,2,2,4
76,2023-06-05T11:21:00+10:00,2023-06-05,11:21,0,1,1
79,2023-06-05T11:21:00+10:00,2023-06-05,11:21,7,1,8
86,2023-06-05T11:21:00+10:00,2023-06-05,11:21,1,0,1
3,2023-06-05T11:20:00+10:00,2023-06-05,11:20,11,7,18
28,2023-06-05T11:20:00+10:00,2023-06-05,11:20,7,8,15
29,2023-06-05T11:20:00+10:00,2023-06-05,11:20,2,1,3
31,2023-06-05T11:20:00+10:00,2023-06-05,11:20,2,1,3
41,2023-06-05T11:20:00+10:00,2023-06-05,11:20,11,27,38
44,2023-06-05T11:20:00+10:00,2023-06-05,11:20,0,2,2
55,2023-06-05T11:20:00+10:00,2023-06-05,11:20,0,6,6
59,2023-06-05T11:20:00+10:00,2023-06-05,11:20,33,43,76
108,2023-06-05T11:20:00+10:00,2023-06-05,11:20,6,5,11
1,2023-06-05T11:20:00+10:00,2023-06-05,11:20,6,5,11
12,2023-06-05T11:20:00+10:00,2023-06-05,11:20,1,0,1
17,2023-06-05T11:20:00+10:00,2023-06-05,11:20,6,1,7
23,2023-06-05T11:20:00+10:00,2023-06-05,11:20,0,6,6
24,2023-06-05T11:20:00+10:00,2023-06-05,11:20,5,11,16
48,2023-06-05T11:20:00+10:00,2023-06-05,11:20,1,3,4
51,2023-06-05T11:20:00+10:00,2023-06-05,11:20,2,0,2
53,2023-06-05T11:20:00+10:00,2023-06-05,11:20,11,9,20
62,2023-06-05T11:20:00+10:00,2023-06-05,11:20,0,4,4
67,2023-06-05T11:20:00+10:00,2023-06-05,11:20,5,7,12
4,2023-06-05T11:20:00+10:00,2023-06-05,11:20,14,15,29
8,2023-06-05T11:20:00+10:00,2023-06-05,11:20,3,2,5
45,2023-06-05T11:20:00+10:00,2023-06-05,11:20,6,12,18
47,2023-06-05T11:20:00+10:00,2023-06-05,11:20,6,7,13
50,2023-06-05T11:20:00+10:00,2023-06-05,11:20,0,2,2
54,2023-06-05T11:20:00+10:00,2023-06-05,11:20,3,0,3
61,2023-06-05T11:20:00+10:00,2023-06-05,11:20,1,3,4
66,2023-06-05T11:20:00+10:00,2023-06-05,11:20,5,10,15
78,2023-06-05T11:20:00+10:00,2023-06-05,11:20,1,1,2
84,2023-06-05T11:20:00+10:00,2023-06-05,11:20,48,40,88
87,2023-06-05T11:20:00+10:00,2023-06-05,11:20,1,0,1
107,2023-06-05T11:20:00+10:00,2023-06-05,11:20,5,3,8
118,2023-06-05T11:20:00+10:00,2023-06-05,11:20,0,2,2
2,2023-06-05T11:20:00+10:00,2023-06-05,11:20,6,13,19
10,2023-06-05T11:20:00+10:00,2023-06-05,11:20,0,1,1
46,2023-06-05T11:20:00+10:00,2023-06-05,11:20,2,2,4
63,2023-06-05T11:20:00+10:00,2023-06-05,11:20,5,3,8
68,2023-06-05T11:20:00+10:00,2023-06-05,11:20,2,1,3
79,2023-06-05T11:20:00+10:00,2023-06-05,11:20,2,2,4
85,2023-06-05T11:20:00+10:00,2023-06-05,11:20,0,1,1
109,2023-06-05T11:20:00+10:00,2023-06-05,11:20,18,13,31
117,2023-06-05T11:20:00+10:00,2023-06-05,11:20,8,14,22
5,2023-06-05T11:20:00+10:00,2023-06-05,11:20,2,3,5
6,2023-06-05T11:20:00+10:00,2023-06-05,11:20,5,7,12
14,2023-06-05T11:20:00+10:00,2023-06-05,11:20,4,0,4
21,2023-06-05T11:20:00+10:00,2023-06-05,11:20,2,9,11
26,2023-06-05T11:20:00+10:00,2023-06-05,11:20,4,4,8
36,2023-06-05T11:20:00+10:00,2023-06-05,11:20,4,7,11
37,2023-06-05T11:20:00+10:00,2023-06-05,11:20,1,3,4
39,2023-06-05T11:20:00+10:00,2023-06-05,11:20,2,1,3
40,2023-06-05T11:20:00+10:00,2023-06-05,11:20,4,2,6
42,2023-06-05T11:20:00+10:00,2023-06-05,11:20,2,0,2
65,2023-06-05T11:20:00+10:00,2023-06-05,11:20,3,1,4
69,2023-06-05T11:20:00+10:00,2023-06-05,11:20,3,2,5
70,2023-06-05T11:20:00+10:00,2023-06-05,11:20,1,1,2
75,2023-06-05T11:20:00+10:00,2023-06-05,11:20,0,1,1
77,2023-06-05T11:20:00+10:00,2023-06-05,11:20,7,1,8
9,2023-06-05T11:20:00+10:00,2023-06-05,11:20,4,4,8
11,2023-06-05T11:20:00+10:00,2023-06-05,11:20,1,2,3
18,2023-06-05T11:20:00+10:00,2023-06-05,11:20,7,3,10
19,2023-06-05T11:20:00+10:00,2023-06-05,11:20,0,3,3
20,2023-06-05T11:20:00+10:00,2023-06-05,11:20,2,2,4
30,2023-06-05T11:20:00+10:00,2023-06-05,11:20,1,3,4
35,2023-06-05T11:20:00+10:00,2023-06-05,11:20,8,5,13
49,2023-06-05T11:20:00+10:00,2023-06-05,11:20,3,1,4
52,2023-06-05T11:20:00+10:00,2023-06-05,11:20,5,6,11
57,2023-06-05T11:20:00+10:00,2023-06-05,11:20,3,0,3
58,2023-06-05T11:20:00+10:00,2023-06-05,11:20,7,2,9
72,2023-06-05T11:20:00+10:00,2023-06-05,11:20,2,1,3
76,2023-06-05T11:20:00+10:00,2023-06-05,11:20,0,1,1
4,2023-06-05T11:19:00+10:00,2023-06-05,11:19,22,11,33
21,2023-06-05T11:19:00+10:00,2023-06-05,11:19,1,5,6
36,2023-06-05T11:19:00+10:00,2023-06-05,11:19,3,3,6
37,2023-06-05T11:19:00+10:00,2023-06-05,11:19,0,1,1
39,2023-06-05T11:19:00+10:00,2023-06-05,11:19,2,3,5
54,2023-06-05T11:19:00+10:00,2023-06-05,11:19,1,2,3
65,2023-06-05T11:19:00+10:00,2023-06-05,11:19,4,8,12
75,2023-06-05T11:19:00+10:00,2023-06-05,11:19,1,0,1
11,2023-06-05T11:19:00+10:00,2023-06-05,11:19,0,1,1
18,2023-06-05T11:19:00+10:00,2023-06-05,11:19,3,5,8
23,2023-06-05T11:19:00+10:00,2023-06-05,11:19,2,1,3
27,2023-06-05T11:19:00+10:00,2023-06-05,11:19,5,0,5
35,2023-06-05T11:19:00+10:00,2023-06-05,11:19,4,8,12
46,2023-06-05T11:19:00+10:00,2023-06-05,11:19,0,1,1
76,2023-06-05T11:19:00+10:00,2023-06-05,11:19,3,0,3
3,2023-06-05T11:19:00+10:00,2023-06-05,11:19,5,5,10
8,2023-06-05T11:19:00+10:00,2023-06-05,11:19,2,0,2
26,2023-06-05T11:19:00+10:00,2023-06-05,11:19,6,1,7
28,2023-06-05T11:19:00+10:00,2023-06-05,11:19,6,3,9
29,2023-06-05T11:19:00+10:00,2023-06-05,11:19,9,4,13
31,2023-06-05T11:19:00+10:00,2023-06-05,11:19,1,0,1
40,2023-06-05T11:19:00+10:00,2023-06-05,11:19,3,0,3
45,2023-06-05T11:19:00+10:00,2023-06-05,11:19,5,2,7
55,2023-06-05T11:19:00+10:00,2023-06-05,11:19,6,8,14
66,2023-06-05T11:19:00+10:00,2023-06-05,11:19,12,11,23
77,2023-06-05T11:19:00+10:00,2023-06-05,11:19,1,0,1
87,2023-06-05T11:19:00+10:00,2023-06-05,11:19,1,0,1
108,2023-06-05T11:19:00+10:00,2023-06-05,11:19,2,7,9
1,2023-06-05T11:19:00+10:00,2023-06-05,11:19,11,9,20
17,2023-06-05T11:19:00+10:00,2023-06-05,11:19,8,4,12
19,2023-06-05T11:19:00+10:00,2023-06-05,11:19,2,0,2
20,2023-06-05T11:19:00+10:00,2023-06-05,11:19,1,2,3
24,2023-06-05T11:19:00+10:00,2023-06-05,11:19,12,10,22
48,2023-06-05T11:19:00+10:00,2023-06-05,11:19,1,1,2
49,2023-06-05T11:19:00+10:00,2023-06-05,11:19,0,2,2
51,2023-06-05T11:19:00+10:00,2023-06-05,11:19,2,5,7
53,2023-06-05T11:19:00+10:00,2023-06-05,11:19,21,8,29
57,2023-06-05T11:19:00+10:00,2023-06-05,11:19,3,3,6
63,2023-06-05T11:19:00+10:00,2023-06-05,11:19,2,3,5
67,2023-06-05T11:19:00+10:00,2023-06-05,11:19,4,7,11
72,2023-06-05T11:19:00+10:00,2023-06-05,11:19,0,3,3
79,2023-06-05T11:19:00+10:00,2023-06-05,11:19,6,3,9
5,2023-06-05T11:19:00+10:00,2023-06-05,11:19,6,13,19
6,2023-06-05T11:19:00+10:00,2023-06-05,11:19,8,3,11
14,2023-06-05T11:19:00+10:00,2023-06-05,11:19,3,2,5
41,2023-06-05T11:19:00+10:00,2023-06-05,11:19,24,19,43
42,2023-06-05T11:19:00+10:00,2023-06-05,11:19,2,1,3
47,2023-06-05T11:19:00+10:00,2023-06-05,11:19,5,6,11
50,2023-06-05T11:19:00+10:00,2023-06-05,11:19,4,0,4
61,2023-06-05T11:19:00+10:00,2023-06-05,11:19,4,12,16
69,2023-06-05T11:19:00+10:00,2023-06-05,11:19,4,0,4
70,2023-06-05T11:19:00+10:00,2023-06-05,11:19,3,2,5
78,2023-06-05T11:19:00+10:00,2023-06-05,11:19,1,1,2
2,2023-06-05T11:19:00+10:00,2023-06-05,11:19,5,4,9
9,2023-06-05T11:19:00+10:00,2023-06-05,11:19,1,2,3
12,2023-06-05T11:19:00+10:00,2023-06-05,11:19,3,2,5
30,2023-06-05T11:19:00+10:00,2023-06-05,11:19,1,12,13
52,2023-06-05T11:19:00+10:00,2023-06-05,11:19,3,2,5
56,2023-06-05T11:19:00+10:00,2023-06-05,11:19,1,2,3
58,2023-06-05T11:19:00+10:00,2023-06-05,11:19,9,2,11
62,2023-06-05T11:19:00+10:00,2023-06-05,11:19,3,0,3
68,2023-06-05T11:19:00+10:00,2023-06-05,11:19,1,1,2
85,2023-06-05T11:19:00+10:00,2023-06-05,11:19,1,0,1
86,2023-06-05T11:19:00+10:00,2023-06-05,11:19,0,1,1
4,2023-06-05T11:18:00+10:00,2023-06-05,11:18,13,9,22
21,2023-06-05T11:18:00+10:00,2023-06-05,11:18,1,8,9
26,2023-06-05T11:18:00+10:00,2023-06-05,11:18,4,7,11
28,2023-06-05T11:18:00+10:00,2023-06-05,11:18,14,6,20
31,2023-06-05T11:18:00+10:00,2023-06-05,11:18,2,0,2
36,2023-06-05T11:18:00+10:00,2023-06-05,11:18,4,2,6
42,2023-06-05T11:18:00+10:00,2023-06-05,11:18,5,1,6
50,2023-06-05T11:18:00+10:00,2023-06-05,11:18,1,2,3
66,2023-06-05T11:18:00+10:00,2023-06-05,11:18,13,11,24
75,2023-06-05T11:18:00+10:00,2023-06-05,11:18,1,0,1
78,2023-06-05T11:18:00+10:00,2023-06-05,11:18,1,1,2
17,2023-06-05T11:18:00+10:00,2023-06-05,11:18,5,3,8
18,2023-06-05T11:18:00+10:00,2023-06-05,11:18,3,2,5
24,2023-06-05T11:18:00+10:00,2023-06-05,11:18,8,7,15
30,2023-06-05T11:18:00+10:00,2023-06-05,11:18,5,4,9
35,2023-06-05T11:18:00+10:00,2023-06-05,11:18,6,4,10
46,2023-06-05T11:18:00+10:00,2023-06-05,11:18,2,0,2
48,2023-06-05T11:18:00+10:00,2023-06-05,11:18,2,1,3
49,2023-06-05T11:18:00+10:00,2023-06-05,11:18,1,0,1
53,2023-06-05T11:18:00+10:00,2023-06-05,11:18,9,13,22
58,2023-06-05T11:18:00+10:00,2023-06-05,11:18,4,1,5
62,2023-06-05T11:18:00+10:00,2023-06-05,11:18,0,2,2
5,2023-06-05T11:18:00+10:00,2023-06-05,11:18,0,2,2
6,2023-06-05T11:18:00+10:00,2023-06-05,11:18,9,3,12
8,2023-06-05T11:18:00+10:00,2023-06-05,11:18,1,0,1
14,2023-06-05T11:18:00+10:00,2023-06-05,11:18,3,3,6
29,2023-06-05T11:18:00+10:00,2023-06-05,11:18,2,0,2
39,2023-06-05T11:18:00+10:00,2023-06-05,11:18,2,1,3
54,2023-06-05T11:18:00+10:00,2023-06-05,11:18,2,1,3
61,2023-06-05T11:18:00+10:00,2023-06-05,11:18,2,15,17
65,2023-06-05T11:18:00+10:00,2023-06-05,11:18,5,6,11
70,2023-06-05T11:18:00+10:00,2023-06-05,11:18,1,2,3
71,2023-06-05T11:18:00+10:00,2023-06-05,11:18,0,1,1
9,2023-06-05T11:18:00+10:00,2023-06-05,11:18,0,3,3
10,2023-06-05T11:18:00+10:00,2023-06-05,11:18,1,0,1
11,2023-06-05T11:18:00+10:00,2023-06-05,11:18,2,1,3
20,2023-06-05T11:18:00+10:00,2023-06-05,11:18,4,2,6
51,2023-06-05T11:18:00+10:00,2023-06-05,11:18,3,2,5
52,2023-06-05T11:18:00+10:00,2023-06-05,11:18,5,0,5
56,2023-06-05T11:18:00+10:00,2023-06-05,11:18,4,0,4
57,2023-06-05T11:18:00+10:00,2023-06-05,11:18,3,2,5
63,2023-06-05T11:18:00+10:00,2023-06-05,11:18,1,3,4
67,2023-06-05T11:18:00+10:00,2023-06-05,11:18,11,9,20
68,2023-06-05T11:18:00+10:00,2023-06-05,11:18,1,1,2
3,2023-06-05T11:18:00+10:00,2023-06-05,11:18,13,10,23
40,2023-06-05T11:18:00+10:00,2023-06-05,11:18,1,3,4
41,2023-06-05T11:18:00+10:00,2023-06-05,11:18,13,15,28
45,2023-06-05T11:18:00+10:00,2023-06-05,11:18,6,8,14
47,2023-06-05T11:18:00+10:00,2023-06-05,11:18,2,22,24
55,2023-06-05T11:18:00+10:00,2023-06-05,11:18,4,10,14
69,2023-06-05T11:18:00+10:00,2023-06-05,11:18,0,1,1
77,2023-06-05T11:18:00+10:00,2023-06-05,11:18,0,1,1
87,2023-06-05T11:18:00+10:00,2023-06-05,11:18,3,1,4
108,2023-06-05T11:18:00+10:00,2023-06-05,11:18,3,1,4
1,2023-06-05T11:18:00+10:00,2023-06-05,11:18,14,7,21
2,2023-06-05T11:18:00+10:00,2023-06-05,11:18,10,5,15
12,2023-06-05T11:18:00+10:00,2023-06-05,11:18,0,3,3
19,2023-06-05T11:18:00+10:00,2023-06-05,11:18,4,0,4
23,2023-06-05T11:18:00+10:00,2023-06-05,11:18,7,2,9
27,2023-06-05T11:18:00+10:00,2023-06-05,11:18,1,1,2
72,2023-06-05T11:18:00+10:00,2023-06-05,11:18,2,3,5
79,2023-06-05T11:18:00+10:00,2023-06-05,11:18,12,2,14
86,2023-06-05T11:18:00+10:00,2023-06-05,11:18,2,0,2
4,2023-06-05T11:17:00+10:00,2023-06-05,11:17,21,18,39
8,2023-06-05T11:17:00+10:00,2023-06-05,11:17,0,2,2
28,2023-06-05T11:17:00+10:00,2023-06-05,11:17,7,6,13
41,2023-06-05T11:17:00+10:00,2023-06-05,11:17,20,19,39
44,2023-06-05T11:17:00+10:00,2023-06-05,11:17,1,3,4
54,2023-06-05T11:17:00+10:00,2023-06-05,11:17,1,2,3
66,2023-06-05T11:17:00+10:00,2023-06-05,11:17,2,22,24
75,2023-06-05T11:17:00+10:00,2023-06-05,11:17,1,1,2
77,2023-06-05T11:17:00+10:00,2023-06-05,11:17,7,0,7
9,2023-06-05T11:17:00+10:00,2023-06-05,11:17,0,5,5
12,2023-06-05T11:17:00+10:00,2023-06-05,11:17,1,0,1
20,2023-06-05T11:17:00+10:00,2023-06-05,11:17,2,3,5
24,2023-06-05T11:17:00+10:00,2023-06-05,11:17,6,2,8
49,2023-06-05T11:17:00+10:00,2023-06-05,11:17,3,1,4
51,2023-06-05T11:17:00+10:00,2023-06-05,11:17,0,1,1
57,2023-06-05T11:17:00+10:00,2023-06-05,11:17,1,4,5
62,2023-06-05T11:17:00+10:00,2023-06-05,11:17,0,2,2
68,2023-06-05T11:17:00+10:00,2023-06-05,11:17,3,1,4
79,2023-06-05T11:17:00+10:00,2023-06-05,11:17,7,4,11
3,2023-06-05T11:17:00+10:00,2023-06-05,11:17,13,13,26
6,2023-06-05T11:17:00+10:00,2023-06-05,11:17,26,6,32
21,2023-06-05T11:17:00+10:00,2023-06-05,11:17,5,3,8
26,2023-06-05T11:17:00+10:00,2023-06-05,11:17,0,3,3
45,2023-06-05T11:17:00+10:00,2023-06-05,11:17,8,10,18
47,2023-06-05T11:17:00+10:00,2023-06-05,11:17,5,15,20
50,2023-06-05T11:17:00+10:00,2023-06-05,11:17,3,1,4
65,2023-06-05T11:17:00+10:00,2023-06-05,11:17,4,5,9
108,2023-06-05T11:17:00+10:00,2023-06-05,11:17,2,8,10
2,2023-06-05T11:17:00+10:00,2023-06-05,11:17,3,4,7
17,2023-06-05T11:17:00+10:00,2023-06-05,11:17,5,3,8
19,2023-06-05T11:17:00+10:00,2023-06-05,11:17,5,4,9
27,2023-06-05T11:17:00+10:00,2023-06-05,11:17,4,2,6
30,2023-06-05T11:17:00+10:00,2023-06-05,11:17,3,2,5
35,2023-06-05T11:17:00+10:00,2023-06-05,11:17,7,5,12
46,2023-06-05T11:17:00+10:00,2023-06-05,11:17,0,2,2
56,2023-06-05T11:17:00+10:00,2023-06-05,11:17,9,0,9
67,2023-06-05T11:17:00+10:00,2023-06-05,11:17,10,5,15
76,2023-06-05T11:17:00+10:00,2023-06-05,11:17,1,0,1
5,2023-06-05T11:17:00+10:00,2023-06-05,11:17,1,6,7
14,2023-06-05T11:17:00+10:00,2023-06-05,11:17,1,3,4
31,2023-06-05T11:17:00+10:00,2023-06-05,11:17,0,2,2
36,2023-06-05T11:17:00+10:00,2023-06-05,11:17,3,0,3
39,2023-06-05T11:17:00+10:00,2023-06-05,11:17,1,5,6
40,2023-06-05T11:17:00+10:00,2023-06-05,11:17,5,1,6
42,2023-06-05T11:17:00+10:00,2023-06-05,11:17,3,1,4
55,2023-06-05T11:17:00+10:00,2023-06-05,11:17,6,16,22
61,2023-06-05T11:17:00+10:00,2023-06-05,11:17,6,8,14
69,2023-06-05T11:17:00+10:00,2023-06-05,11:17,4,5,9
70,2023-06-05T11:17:00+10:00,2023-06-05,11:17,0,3,3
78,2023-06-05T11:17:00+10:00,2023-06-05,11:17,0,1,1
87,2023-06-05T11:17:00+10:00,2023-06-05,11:17,3,0,3
1,2023-06-05T11:17:00+10:00,2023-06-05,11:17,11,12,23
11,2023-06-05T11:17:00+10:00,2023-06-05,11:17,1,0,1
18,2023-06-05T11:17:00+10:00,2023-06-05,11:17,1,1,2
23,2023-06-05T11:17:00+10:00,2023-06-05,11:17,4,4,8
52,2023-06-05T11:17:00+10:00,2023-06-05,11:17,7,6,13
53,2023-06-05T11:17:00+10:00,2023-06-05,11:17,4,5,9
58,2023-06-05T11:17:00+10:00,2023-06-05,11:17,2,2,4
63,2023-06-05T11:17:00+10:00,2023-06-05,11:17,6,6,12
72,2023-06-05T11:17:00+10:00,2023-06-05,11:17,0,1,1
85,2023-06-05T11:17:00+10:00,2023-06-05,11:17,1,0,1
8,2023-06-05T11:16:00+10:00,2023-06-05,11:16,1,2,3
26,2023-06-05T11:16:00+10:00,2023-06-05,11:16,7,3,10
29,2023-06-05T11:16:00+10:00,2023-06-05,11:16,5,2,7
55,2023-06-05T11:16:00+10:00,2023-06-05,11:16,1,3,4
69,2023-06-05T11:16:00+10:00,2023-06-05,11:16,2,8,10
70,2023-06-05T11:16:00+10:00,2023-06-05,11:16,4,3,7
75,2023-06-05T11:16:00+10:00,2023-06-05,11:16,1,1,2
1,2023-06-05T11:16:00+10:00,2023-06-05,11:16,15,5,20
2,2023-06-05T11:16:00+10:00,2023-06-05,11:16,4,3,7
11,2023-06-05T11:16:00+10:00,2023-06-05,11:16,1,0,1
12,2023-06-05T11:16:00+10:00,2023-06-05,11:16,1,2,3
18,2023-06-05T11:16:00+10:00,2023-06-05,11:16,1,2,3
30,2023-06-05T11:16:00+10:00,2023-06-05,11:16,1,7,8
46,2023-06-05T11:16:00+10:00,2023-06-05,11:16,0,3,3
62,2023-06-05T11:16:00+10:00,2023-06-05,11:16,2,1,3
79,2023-06-05T11:16:00+10:00,2023-06-05,11:16,2,5,7
85,2023-06-05T11:16:00+10:00,2023-06-05,11:16,1,1,2
3,2023-06-05T11:16:00+10:00,2023-06-05,11:16,4,5,9
4,2023-06-05T11:16:00+10:00,2023-06-05,11:16,16,15,31
5,2023-06-05T11:16:00+10:00,2023-06-05,11:16,8,8,16
6,2023-06-05T11:16:00+10:00,2023-06-05,11:16,3,7,10
14,2023-06-05T11:16:00+10:00,2023-06-05,11:16,4,0,4
21,2023-06-05T11:16:00+10:00,2023-06-05,11:16,2,3,5
31,2023-06-05T11:16:00+10:00,2023-06-05,11:16,0,7,7
41,2023-06-05T11:16:00+10:00,2023-06-05,11:16,18,16,34
42,2023-06-05T11:16:00+10:00,2023-06-05,11:16,1,4,5
45,2023-06-05T11:16:00+10:00,2023-06-05,11:16,23,6,29
47,2023-06-05T11:16:00+10:00,2023-06-05,11:16,9,15,24
66,2023-06-05T11:16:00+10:00,2023-06-05,11:16,13,7,20
9,2023-06-05T11:16:00+10:00,2023-06-05,11:16,1,5,6
10,2023-06-05T11:16:00+10:00,2023-06-05,11:16,2,0,2
17,2023-06-05T11:16:00+10:00,2023-06-05,11:16,9,1,10
19,2023-06-05T11:16:00+10:00,2023-06-05,11:16,4,0,4
24,2023-06-05T11:16:00+10:00,2023-06-05,11:16,20,4,24
35,2023-06-05T11:16:00+10:00,2023-06-05,11:16,8,4,12
49,2023-06-05T11:16:00+10:00,2023-06-05,11:16,1,1,2
51,2023-06-05T11:16:00+10:00,2023-06-05,11:16,1,0,1
63,2023-06-05T11:16:00+10:00,2023-06-05,11:16,5,1,6
67,2023-06-05T11:16:00+10:00,2023-06-05,11:16,13,9,22
28,2023-06-05T11:16:00+10:00,2023-06-05,11:16,6,5,11
36,2023-06-05T11:16:00+10:00,2023-06-05,11:16,1,1,2
39,2023-06-05T11:16:00+10:00,2023-06-05,11:16,1,3,4
50,2023-06-05T11:16:00+10:00,2023-06-05,11:16,3,6,9
54,2023-06-05T11:16:00+10:00,2023-06-05,11:16,1,0,1
61,2023-06-05T11:16:00+10:00,2023-06-05,11:16,2,4,6
65,2023-06-05T11:16:00+10:00,2023-06-05,11:16,2,6,8
77,2023-06-05T11:16:00+10:00,2023-06-05,11:16,0,4,4
108,2023-06-05T11:16:00+10:00,2023-06-05,11:16,4,7,11
20,2023-06-05T11:16:00+10:00,2023-06-05,11:16,7,3,10
23,2023-06-05T11:16:00+10:00,2023-06-05,11:16,2,7,9
27,2023-06-05T11:16:00+10:00,2023-06-05,11:16,1,1,2
48,2023-06-05T11:16:00+10:00,2023-06-05,11:16,2,0,2
52,2023-06-05T11:16:00+10:00,2023-06-05,11:16,1,1,2
53,2023-06-05T11:16:00+10:00,2023-06-05,11:16,25,3,28
56,2023-06-05T11:16:00+10:00,2023-06-05,11:16,6,2,8
57,2023-06-05T11:16:00+10:00,2023-06-05,11:16,0,4,4
58,2023-06-05T11:16:00+10:00,2023-06-05,11:16,14,1,15
68,2023-06-05T11:16:00+10:00,2023-06-05,11:16,4,3,7
72,2023-06-05T11:16:00+10:00,2023-06-05,11:16,1,2,3
6,2023-06-05T11:15:00+10:00,2023-06-05,11:15,3,2,5
8,2023-06-05T11:15:00+10:00,2023-06-05,11:15,1,1,2
31,2023-06-05T11:15:00+10:00,2023-06-05,11:15,1,1,2
47,2023-06-05T11:15:00+10:00,2023-06-05,11:15,4,12,16
54,2023-06-05T11:15:00+10:00,2023-06-05,11:15,1,3,4
65,2023-06-05T11:15:00+10:00,2023-06-05,11:15,5,2,7
69,2023-06-05T11:15:00+10:00,2023-06-05,11:15,0,3,3
84,2023-06-05T11:15:00+10:00,2023-06-05,11:15,49,48,97
87,2023-06-05T11:15:00+10:00,2023-06-05,11:15,2,4,6
107,2023-06-05T11:15:00+10:00,2023-06-05,11:15,8,15,23
118,2023-06-05T11:15:00+10:00,2023-06-05,11:15,2,0,2
2,2023-06-05T11:15:00+10:00,2023-06-05,11:15,16,7,23
9,2023-06-05T11:15:00+10:00,2023-06-05,11:15,0,2,2
11,2023-06-05T11:15:00+10:00,2023-06-05,11:15,2,2,4
12,2023-06-05T11:15:00+10:00,2023-06-05,11:15,3,0,3
17,2023-06-05T11:15:00+10:00,2023-06-05,11:15,2,2,4
18,2023-06-05T11:15:00+10:00,2023-06-05,11:15,1,1,2
20,2023-06-05T11:15:00+10:00,2023-06-05,11:15,2,3,5
49,2023-06-05T11:15:00+10:00,2023-06-05,11:15,2,0,2
51,2023-06-05T11:15:00+10:00,2023-06-05,11:15,1,0,1
56,2023-06-05T11:15:00+10:00,2023-06-05,11:15,1,5,6
57,2023-06-05T11:15:00+10:00,2023-06-05,11:15,4,3,7
63,2023-06-05T11:15:00+10:00,2023-06-05,11:15,3,3,6
67,2023-06-05T11:15:00+10:00,2023-06-05,11:15,10,12,22
3,2023-06-05T11:15:00+10:00,2023-06-05,11:15,8,11,19
5,2023-06-05T11:15:00+10:00,2023-06-05,11:15,7,8,15
14,2023-06-05T11:15:00+10:00,2023-06-05,11:15,0,3,3
21,2023-06-05T11:15:00+10:00,2023-06-05,11:15,0,7,7
26,2023-06-05T11:15:00+10:00,2023-06-05,11:15,5,10,15
28,2023-06-05T11:15:00+10:00,2023-06-05,11:15,3,4,7
29,2023-06-05T11:15:00+10:00,2023-06-05,11:15,8,1,9
36,2023-06-05T11:15:00+10:00,2023-06-05,11:15,0,4,4
37,2023-06-05T11:15:00+10:00,2023-06-05,11:15,2,3,5
39,2023-06-05T11:15:00+10:00,2023-06-05,11:15,1,2,3
42,2023-06-05T11:15:00+10:00,2023-06-05,11:15,2,4,6
55,2023-06-05T11:15:00+10:00,2023-06-05,11:15,3,3,6
61,2023-06-05T11:15:00+10:00,2023-06-05,11:15,1,4,5
66,2023-06-05T11:15:00+10:00,2023-06-05,11:15,7,6,13
71,2023-06-05T11:15:00+10:00,2023-06-05,11:15,1,1,2
78,2023-06-05T11:15:00+10:00,2023-06-05,11:15,4,0,4
108,2023-06-05T11:15:00+10:00,2023-06-05,11:15,3,4,7
1,2023-06-05T11:15:00+10:00,2023-06-05,11:15,8,17,25
19,2023-06-05T11:15:00+10:00,2023-06-05,11:15,7,8,15
24,2023-06-05T11:15:00+10:00,2023-06-05,11:15,5,4,9
27,2023-06-05T11:15:00+10:00,2023-06-05,11:15,0,2,2
52,2023-06-05T11:15:00+10:00,2023-06-05,11:15,2,5,7
58,2023-06-05T11:15:00+10:00,2023-06-05,11:15,13,2,15
76,2023-06-05T11:15:00+10:00,2023-06-05,11:15,1,0,1
85,2023-06-05T11:15:00+10:00,2023-06-05,11:15,2,2,4
109,2023-06-05T11:15:00+10:00,2023-06-05,11:15,23,14,37
4,2023-06-05T11:15:00+10:00,2023-06-05,11:15,26,18,44
40,2023-06-05T11:15:00+10:00,2023-06-05,11:15,1,2,3
41,2023-06-05T11:15:00+10:00,2023-06-05,11:15,10,10,20
45,2023-06-05T11:15:00+10:00,2023-06-05,11:15,5,5,10
50,2023-06-05T11:15:00+10:00,2023-06-05,11:15,5,1,6
59,2023-06-05T11:15:00+10:00,2023-06-05,11:15,29,29,58
75,2023-06-05T11:15:00+10:00,2023-06-05,11:15,0,5,5
77,2023-06-05T11:15:00+10:00,2023-06-05,11:15,2,0,2
23,2023-06-05T11:15:00+10:00,2023-06-05,11:15,1,6,7
30,2023-06-05T11:15:00+10:00,2023-06-05,11:15,1,1,2
35,2023-06-05T11:15:00+10:00,2023-06-05,11:15,4,2,6
46,2023-06-05T11:15:00+10:00,2023-06-05,11:15,0,2,2
48,2023-06-05T11:15:00+10:00,2023-06-05,11:15,0,6,6
53,2023-06-05T11:15:00+10:00,2023-06-05,11:15,20,5,25
68,2023-06-05T11:15:00+10:00,2023-06-05,11:15,1,1,2
72,2023-06-05T11:15:00+10:00,2023-06-05,11:15,9,3,12
79,2023-06-05T11:15:00+10:00,2023-06-05,11:15,1,2,3
117,2023-06-05T11:15:00+10:00,2023-06-05,11:15,6,4,10
5,2023-06-05T11:14:00+10:00,2023-06-05,11:14,2,10,12
6,2023-06-05T11:14:00+10:00,2023-06-05,11:14,9,2,11
8,2023-06-05T11:14:00+10:00,2023-06-05,11:14,2,4,6
26,2023-06-05T11:14:00+10:00,2023-06-05,11:14,3,7,10
28,2023-06-05T11:14:00+10:00,2023-06-05,11:14,15,2,17
31,2023-06-05T11:14:00+10:00,2023-06-05,11:14,0,2,2
37,2023-06-05T11:14:00+10:00,2023-06-05,11:14,0,1,1
39,2023-06-05T11:14:00+10:00,2023-06-05,11:14,3,0,3
41,2023-06-05T11:14:00+10:00,2023-06-05,11:14,15,9,24
55,2023-06-05T11:14:00+10:00,2023-06-05,11:14,10,10,20
61,2023-06-05T11:14:00+10:00,2023-06-05,11:14,1,4,5
65,2023-06-05T11:14:00+10:00,2023-06-05,11:14,7,2,9
66,2023-06-05T11:14:00+10:00,2023-06-05,11:14,6,6,12
70,2023-06-05T11:14:00+10:00,2023-06-05,11:14,0,1,1
9,2023-06-05T11:14:00+10:00,2023-06-05,11:14,4,5,9
12,2023-06-05T11:14:00+10:00,2023-06-05,11:14,3,2,5
17,2023-06-05T11:14:00+10:00,2023-06-05,11:14,5,0,5
20,2023-06-05T11:14:00+10:00,2023-06-05,11:14,1,1,2
27,2023-06-05T11:14:00+10:00,2023-06-05,11:14,0,1,1
30,2023-06-05T11:14:00+10:00,2023-06-05,11:14,1,0,1
35,2023-06-05T11:14:00+10:00,2023-06-05,11:14,3,4,7
49,2023-06-05T11:14:00+10:00,2023-06-05,11:14,0,3,3
51,2023-06-05T11:14:00+10:00,2023-06-05,11:14,1,0,1
58,2023-06-05T11:14:00+10:00,2023-06-05,11:14,7,6,13
63,2023-06-05T11:14:00+10:00,2023-06-05,11:14,3,3,6
68,2023-06-05T11:14:00+10:00,2023-06-05,11:14,6,6,12
79,2023-06-05T11:14:00+10:00,2023-06-05,11:14,13,7,20
85,2023-06-05T11:14:00+10:00,2023-06-05,11:14,0,1,1
14,2023-06-05T11:14:00+10:00,2023-06-05,11:14,5,3,8
21,2023-06-05T11:14:00+10:00,2023-06-05,11:14,3,9,12
45,2023-06-05T11:14:00+10:00,2023-06-05,11:14,1,7,8
47,2023-06-05T11:14:00+10:00,2023-06-05,11:14,15,5,20
50,2023-06-05T11:14:00+10:00,2023-06-05,11:14,2,0,2
75,2023-06-05T11:14:00+10:00,2023-06-05,11:14,1,0,1
78,2023-06-05T11:14:00+10:00,2023-06-05,11:14,0,1,1
87,2023-06-05T11:14:00+10:00,2023-06-05,11:14,0,1,1
108,2023-06-05T11:14:00+10:00,2023-06-05,11:14,3,6,9
1,2023-06-05T11:14:00+10:00,2023-06-05,11:14,14,3,17
2,2023-06-05T11:14:00+10:00,2023-06-05,11:14,6,7,13
19,2023-06-05T11:14:00+10:00,2023-06-05,11:14,7,4,11
24,2023-06-05T11:14:00+10:00,2023-06-05,11:14,3,8,11
48,2023-06-05T11:14:00+10:00,2023-06-05,11:14,0,1,1
86,2023-06-05T11:14:00+10:00,2023-06-05,11:14,0,1,1
3,2023-06-05T11:14:00+10:00,2023-06-05,11:14,16,6,22
4,2023-06-05T11:14:00+10:00,2023-06-05,11:14,10,17,27
29,2023-06-05T11:14:00+10:00,2023-06-05,11:14,1,1,2
40,2023-06-05T11:14:00+10:00,2023-06-05,11:14,3,3,6
42,2023-06-05T11:14:00+10:00,2023-06-05,11:14,0,4,4
54,2023-06-05T11:14:00+10:00,2023-06-05,11:14,2,1,3
69,2023-06-05T11:14:00+10:00,2023-06-05,11:14,1,0,1
77,2023-06-05T11:14:00+10:00,2023-06-05,11:14,1,3,4
18,2023-06-05T11:14:00+10:00,2023-06-05,11:14,3,3,6
23,2023-06-05T11:14:00+10:00,2023-06-05,11:14,0,5,5
52,2023-06-05T11:14:00+10:00,2023-06-05,11:14,2,3,5
53,2023-06-05T11:14:00+10:00,2023-06-05,11:14,18,2,20
57,2023-06-05T11:14:00+10:00,2023-06-05,11:14,1,4,5
62,2023-06-05T11:14:00+10:00,2023-06-05,11:14,3,1,4
67,2023-06-05T11:14:00+10:00,2023-06-05,11:14,8,8,16
72,2023-06-05T11:14:00+10:00,2023-06-05,11:14,2,2,4
5,2023-06-05T11:13:00+10:00,2023-06-05,11:13,4,6,10
29,2023-06-05T11:13:00+10:00,2023-06-05,11:13,3,0,3
37,2023-06-05T11:13:00+10:00,2023-06-05,11:13,1,2,3
47,2023-06-05T11:13:00+10:00,2023-06-05,11:13,12,10,22
69,2023-06-05T11:13:00+10:00,2023-06-05,11:13,2,3,5
75,2023-06-05T11:13:00+10:00,2023-06-05,11:13,1,0,1
77,2023-06-05T11:13:00+10:00,2023-06-05,11:13,1,0,1
108,2023-06-05T11:13:00+10:00,2023-06-05,11:13,3,3,6
1,2023-06-05T11:13:00+10:00,2023-06-05,11:13,9,14,23
18,2023-06-05T11:13:00+10:00,2023-06-05,11:13,3,1,4
24,2023-06-05T11:13:00+10:00,2023-06-05,11:13,11,10,21
46,2023-06-05T11:13:00+10:00,2023-06-05,11:13,1,2,3
49,2023-06-05T11:13:00+10:00,2023-06-05,11:13,0,3,3
85,2023-06-05T11:13:00+10:00,2023-06-05,11:13,1,1,2
6,2023-06-05T11:13:00+10:00,2023-06-05,11:13,1,3,4
8,2023-06-05T11:13:00+10:00,2023-06-05,11:13,2,2,4
14,2023-06-05T11:13:00+10:00,2023-06-05,11:13,0,2,2
21,2023-06-05T11:13:00+10:00,2023-06-05,11:13,5,2,7
26,2023-06-05T11:13:00+10:00,2023-06-05,11:13,8,4,12
39,2023-06-05T11:13:00+10:00,2023-06-05,11:13,1,2,3
40,2023-06-05T11:13:00+10:00,2023-06-05,11:13,1,2,3
41,2023-06-05T11:13:00+10:00,2023-06-05,11:13,35,8,43
44,2023-06-05T11:13:00+10:00,2023-06-05,11:13,0,1,1
50,2023-06-05T11:13:00+10:00,2023-06-05,11:13,2,2,4
55,2023-06-05T11:13:00+10:00,2023-06-05,11:13,0,10,10
65,2023-06-05T11:13:00+10:00,2023-06-05,11:13,2,6,8
66,2023-06-05T11:13:00+10:00,2023-06-05,11:13,8,17,25
70,2023-06-05T11:13:00+10:00,2023-06-05,11:13,6,2,8
2,2023-06-05T11:13:00+10:00,2023-06-05,11:13,13,6,19
9,2023-06-05T11:13:00+10:00,2023-06-05,11:13,1,1,2
11,2023-06-05T11:13:00+10:00,2023-06-05,11:13,1,2,3
17,2023-06-05T11:13:00+10:00,2023-06-05,11:13,2,6,8
19,2023-06-05T11:13:00+10:00,2023-06-05,11:13,5,1,6
23,2023-06-05T11:13:00+10:00,2023-06-05,11:13,2,3,5
27,2023-06-05T11:13:00+10:00,2023-06-05,11:13,1,0,1
35,2023-06-05T11:13:00+10:00,2023-06-05,11:13,8,6,14
48,2023-06-05T11:13:00+10:00,2023-06-05,11:13,1,1,2
67,2023-06-05T11:13:00+10:00,2023-06-05,11:13,11,5,16
76,2023-06-05T11:13:00+10:00,2023-06-05,11:13,0,3,3
79,2023-06-05T11:13:00+10:00,2023-06-05,11:13,7,2,9
3,2023-06-05T11:13:00+10:00,2023-06-05,11:13,9,10,19
4,2023-06-05T11:13:00+10:00,2023-06-05,11:13,15,5,20
28,2023-06-05T11:13:00+10:00,2023-06-05,11:13,6,2,8
31,2023-06-05T11:13:00+10:00,2023-06-05,11:13,1,0,1
36,2023-06-05T11:13:00+10:00,2023-06-05,11:13,0,5,5
45,2023-06-05T11:13:00+10:00,2023-06-05,11:13,8,4,12
61,2023-06-05T11:13:00+10:00,2023-06-05,11:13,2,10,12
12,2023-06-05T11:13:00+10:00,2023-06-05,11:13,3,4,7
20,2023-06-05T11:13:00+10:00,2023-06-05,11:13,1,1,2
30,2023-06-05T11:13:00+10:00,2023-06-05,11:13,1,1,2
51,2023-06-05T11:13:00+10:00,2023-06-05,11:13,1,1,2
52,2023-06-05T11:13:00+10:00,2023-06-05,11:13,3,3,6
53,2023-06-05T11:13:00+10:00,2023-06-05,11:13,4,3,7
56,2023-06-05T11:13:00+10:00,2023-06-05,11:13,2,4,6
57,2023-06-05T11:13:00+10:00,2023-06-05,11:13,1,3,4
58,2023-06-05T11:13:00+10:00,2023-06-05,11:13,10,2,12
62,2023-06-05T11:13:00+10:00,2023-06-05,11:13,2,0,2
63,2023-06-05T11:13:00+10:00,2023-06-05,11:13,1,0,1
68,2023-06-05T11:13:00+10:00,2023-06-05,11:13,0,3,3
72,2023-06-05T11:13:00+10:00,2023-06-05,11:13,1,2,3
86,2023-06-05T11:13:00+10:00,2023-06-05,11:13,0,1,1
26,2023-06-05T11:12:00+10:00,2023-06-05,11:12,1,7,8
29,2023-06-05T11:12:00+10:00,2023-06-05,11:12,2,0,2
47,2023-06-05T11:12:00+10:00,2023-06-05,11:12,9,18,27
1,2023-06-05T11:12:00+10:00,2023-06-05,11:12,8,9,17
9,2023-06-05T11:12:00+10:00,2023-06-05,11:12,0,2,2
35,2023-06-05T11:12:00+10:00,2023-06-05,11:12,12,10,22
46,2023-06-05T11:12:00+10:00,2023-06-05,11:12,1,2,3
49,2023-06-05T11:12:00+10:00,2023-06-05,11:12,0,1,1
52,2023-06-05T11:12:00+10:00,2023-06-05,11:12,3,4,7
56,2023-06-05T11:12:00+10:00,2023-06-05,11:12,12,3,15
57,2023-06-05T11:12:00+10:00,2023-06-05,11:12,2,2,4
85,2023-06-05T11:12:00+10:00,2023-06-05,11:12,1,0,1
3,2023-06-05T11:12:00+10:00,2023-06-05,11:12,10,16,26
5,2023-06-05T11:12:00+10:00,2023-06-05,11:12,0,12,12
6,2023-06-05T11:12:00+10:00,2023-06-05,11:12,6,2,8
14,2023-06-05T11:12:00+10:00,2023-06-05,11:12,1,3,4
21,2023-06-05T11:12:00+10:00,2023-06-05,11:12,6,4,10
31,2023-06-05T11:12:00+10:00,2023-06-05,11:12,1,0,1
37,2023-06-05T11:12:00+10:00,2023-06-05,11:12,2,0,2
44,2023-06-05T11:12:00+10:00,2023-06-05,11:12,0,2,2
45,2023-06-05T11:12:00+10:00,2023-06-05,11:12,5,6,11
54,2023-06-05T11:12:00+10:00,2023-06-05,11:12,3,0,3
55,2023-06-05T11:12:00+10:00,2023-06-05,11:12,5,9,14
69,2023-06-05T11:12:00+10:00,2023-06-05,11:12,7,3,10
70,2023-06-05T11:12:00+10:00,2023-06-05,11:12,2,2,4
77,2023-06-05T11:12:00+10:00,2023-06-05,11:12,3,2,5
108,2023-06-05T11:12:00+10:00,2023-06-05,11:12,3,2,5
2,2023-06-05T11:12:00+10:00,2023-06-05,11:12,11,6,17
11,2023-06-05T11:12:00+10:00,2023-06-05,11:12,0,1,1
17,2023-06-05T11:12:00+10:00,2023-06-05,11:12,6,6,12
20,2023-06-05T11:12:00+10:00,2023-06-05,11:12,0,2,2
24,2023-06-05T11:12:00+10:00,2023-06-05,11:12,4,5,9
30,2023-06-05T11:12:00+10:00,2023-06-05,11:12,0,4,4
51,2023-06-05T11:12:00+10:00,2023-06-05,11:12,0,2,2
62,2023-06-05T11:12:00+10:00,2023-06-05,11:12,4,0,4
68,2023-06-05T11:12:00+10:00,2023-06-05,11:12,3,3,6
79,2023-06-05T11:12:00+10:00,2023-06-05,11:12,0,5,5
4,2023-06-05T11:12:00+10:00,2023-06-05,11:12,14,9,23
8,2023-06-05T11:12:00+10:00,2023-06-05,11:12,0,5,5
28,2023-06-05T11:12:00+10:00,2023-06-05,11:12,10,5,15
39,2023-06-05T11:12:00+10:00,2023-06-05,11:12,1,0,1
40,2023-06-05T11:12:00+10:00,2023-06-05,11:12,0,3,3
41,2023-06-05T11:12:00+10:00,2023-06-05,11:12,17,12,29
42,2023-06-05T11:12:00+10:00,2023-06-05,11:12,3,6,9
61,2023-06-05T11:12:00+10:00,2023-06-05,11:12,1,7,8
65,2023-06-05T11:12:00+10:00,2023-06-05,11:12,2,6,8
66,2023-06-05T11:12:00+10:00,2023-06-05,11:12,10,6,16
87,2023-06-05T11:12:00+10:00,2023-06-05,11:12,3,1,4
12,2023-06-05T11:12:00+10:00,2023-06-05,11:12,0,2,2
18,2023-06-05T11:12:00+10:00,2023-06-05,11:12,2,2,4
19,2023-06-05T11:12:00+10:00,2023-06-05,11:12,3,1,4
23,2023-06-05T11:12:00+10:00,2023-06-05,11:12,0,2,2
53,2023-06-05T11:12:00+10:00,2023-06-05,11:12,10,10,20
58,2023-06-05T11:12:00+10:00,2023-06-05,11:12,4,9,13
63,2023-06-05T11:12:00+10:00,2023-06-05,11:12,1,9,10
67,2023-06-05T11:12:00+10:00,2023-06-05,11:12,6,9,15
72,2023-06-05T11:12:00+10:00,2023-06-05,11:12,1,1,2
3,2023-06-05T11:11:00+10:00,2023-06-05,11:11,7,10,17
14,2023-06-05T11:11:00+10:00,2023-06-05,11:11,6,0,6
21,2023-06-05T11:11:00+10:00,2023-06-05,11:11,8,6,14
28,2023-06-05T11:11:00+10:00,2023-06-05,11:11,6,8,14
29,2023-06-05T11:11:00+10:00,2023-06-05,11:11,1,1,2
36,2023-06-05T11:11:00+10:00,2023-06-05,11:11,1,9,10
55,2023-06-05T11:11:00+10:00,2023-06-05,11:11,9,16,25
65,2023-06-05T11:11:00+10:00,2023-06-05,11:11,6,5,11
69,2023-06-05T11:11:00+10:00,2023-06-05,11:11,2,0,2
87,2023-06-05T11:11:00+10:00,2023-06-05,11:11,2,1,3
9,2023-06-05T11:11:00+10:00,2023-06-05,11:11,3,3,6
11,2023-06-05T11:11:00+10:00,2023-06-05,11:11,1,1,2
12,2023-06-05T11:11:00+10:00,2023-06-05,11:11,2,2,4
27,2023-06-05T11:11:00+10:00,2023-06-05,11:11,1,1,2
30,2023-06-05T11:11:00+10:00,2023-06-05,11:11,1,1,2
51,2023-06-05T11:11:00+10:00,2023-06-05,11:11,0,1,1
58,2023-06-05T11:11:00+10:00,2023-06-05,11:11,10,2,12
62,2023-06-05T11:11:00+10:00,2023-06-05,11:11,4,1,5
72,2023-06-05T11:11:00+10:00,2023-06-05,11:11,4,5,9
4,2023-06-05T11:11:00+10:00,2023-06-05,11:11,7,10,17
31,2023-06-05T11:11:00+10:00,2023-06-05,11:11,1,0,1
37,2023-06-05T11:11:00+10:00,2023-06-05,11:11,0,1,1
39,2023-06-05T11:11:00+10:00,2023-06-05,11:11,4,2,6
40,2023-06-05T11:11:00+10:00,2023-06-05,11:11,3,2,5
44,2023-06-05T11:11:00+10:00,2023-06-05,11:11,3,0,3
70,2023-06-05T11:11:00+10:00,2023-06-05,11:11,5,0,5
77,2023-06-05T11:11:00+10:00,2023-06-05,11:11,2,0,2
108,2023-06-05T11:11:00+10:00,2023-06-05,11:11,2,1,3
1,2023-06-05T11:11:00+10:00,2023-06-05,11:11,8,6,14
10,2023-06-05T11:11:00+10:00,2023-06-05,11:11,1,1,2
17,2023-06-05T11:11:00+10:00,2023-06-05,11:11,12,6,18
18,2023-06-05T11:11:00+10:00,2023-06-05,11:11,3,1,4
24,2023-06-05T11:11:00+10:00,2023-06-05,11:11,9,7,16
49,2023-06-05T11:11:00+10:00,2023-06-05,11:11,2,0,2
52,2023-06-05T11:11:00+10:00,2023-06-05,11:11,7,3,10
56,2023-06-05T11:11:00+10:00,2023-06-05,11:11,2,1,3
63,2023-06-05T11:11:00+10:00,2023-06-05,11:11,1,8,9
67,2023-06-05T11:11:00+10:00,2023-06-05,11:11,10,3,13
79,2023-06-05T11:11:00+10:00,2023-06-05,11:11,9,5,14
5,2023-06-05T11:11:00+10:00,2023-06-05,11:11,3,9,12
6,2023-06-05T11:11:00+10:00,2023-06-05,11:11,8,5,13
8,2023-06-05T11:11:00+10:00,2023-06-05,11:11,1,2,3
26,2023-06-05T11:11:00+10:00,2023-06-05,11:11,1,4,5
41,2023-06-05T11:11:00+10:00,2023-06-05,11:11,9,10,19
42,2023-06-05T11:11:00+10:00,2023-06-05,11:11,2,0,2
45,2023-06-05T11:11:00+10:00,2023-06-05,11:11,0,3,3
47,2023-06-05T11:11:00+10:00,2023-06-05,11:11,16,12,28
54,2023-06-05T11:11:00+10:00,2023-06-05,11:11,2,0,2
61,2023-06-05T11:11:00+10:00,2023-06-05,11:11,2,9,11
66,2023-06-05T11:11:00+10:00,2023-06-05,11:11,6,3,9
78,2023-06-05T11:11:00+10:00,2023-06-05,11:11,1,0,1
2,2023-06-05T11:11:00+10:00,2023-06-05,11:11,4,1,5
19,2023-06-05T11:11:00+10:00,2023-06-05,11:11,4,3,7
20,2023-06-05T11:11:00+10:00,2023-06-05,11:11,3,0,3
23,2023-06-05T11:11:00+10:00,2023-06-05,11:11,4,5,9
35,2023-06-05T11:11:00+10:00,2023-06-05,11:11,11,6,17
46,2023-06-05T11:11:00+10:00,2023-06-05,11:11,2,0,2
53,2023-06-05T11:11:00+10:00,2023-06-05,11:11,21,8,29
57,2023-06-05T11:11:00+10:00,2023-06-05,11:11,1,3,4
85,2023-06-05T11:11:00+10:00,2023-06-05,11:11,1,1,2
3,2023-06-05T11:10:00+10:00,2023-06-05,11:10,0,11,11
4,2023-06-05T11:10:00+10:00,2023-06-05,11:10,14,9,23
26,2023-06-05T11:10:00+10:00,2023-06-05,11:10,2,6,8
42,2023-06-05T11:10:00+10:00,2023-06-05,11:10,1,2,3
55,2023-06-05T11:10:00+10:00,2023-06-05,11:10,1,7,8
61,2023-06-05T11:10:00+10:00,2023-06-05,11:10,2,2,4
70,2023-06-05T11:10:00+10:00,2023-06-05,11:10,4,2,6
77,2023-06-05T11:10:00+10:00,2023-06-05,11:10,6,2,8
84,2023-06-05T11:10:00+10:00,2023-06-05,11:10,46,40,86
108,2023-06-05T11:10:00+10:00,2023-06-05,11:10,1,6,7
12,2023-06-05T11:10:00+10:00,2023-06-05,11:10,4,2,6
20,2023-06-05T11:10:00+10:00,2023-06-05,11:10,2,0,2
23,2023-06-05T11:10:00+10:00,2023-06-05,11:10,0,1,1
46,2023-06-05T11:10:00+10:00,2023-06-05,11:10,3,2,5
51,2023-06-05T11:10:00+10:00,2023-06-05,11:10,3,1,4
52,2023-06-05T11:10:00+10:00,2023-06-05,11:10,1,0,1
57,2023-06-05T11:10:00+10:00,2023-06-05,11:10,0,1,1
68,2023-06-05T11:10:00+10:00,2023-06-05,11:10,4,4,8
86,2023-06-05T11:10:00+10:00,2023-06-05,11:10,0,1,1
6,2023-06-05T11:10:00+10:00,2023-06-05,11:10,6,4,10
8,2023-06-05T11:10:00+10:00,2023-06-05,11:10,3,1,4
14,2023-06-05T11:10:00+10:00,2023-06-05,11:10,1,3,4
21,2023-06-05T11:10:00+10:00,2023-06-05,11:10,5,2,7
28,2023-06-05T11:10:00+10:00,2023-06-05,11:10,11,5,16
29,2023-06-05T11:10:00+10:00,2023-06-05,11:10,4,2,6
31,2023-06-05T11:10:00+10:00,2023-06-05,11:10,1,2,3
39,2023-06-05T11:10:00+10:00,2023-06-05,11:10,5,0,5
41,2023-06-05T11:10:00+10:00,2023-06-05,11:10,28,14,42
54,2023-06-05T11:10:00+10:00,2023-06-05,11:10,1,0,1
59,2023-06-05T11:10:00+10:00,2023-06-05,11:10,39,36,75
66,2023-06-05T11:10:00+10:00,2023-06-05,11:10,11,9,20
69,2023-06-05T11:10:00+10:00,2023-06-05,11:10,2,2,4
75,2023-06-05T11:10:00+10:00,2023-06-05,11:10,1,1,2
107,2023-06-05T11:10:00+10:00,2023-06-05,11:10,4,13,17
1,2023-06-05T11:10:00+10:00,2023-06-05,11:10,12,10,22
24,2023-06-05T11:10:00+10:00,2023-06-05,11:10,4,1,5
27,2023-06-05T11:10:00+10:00,2023-06-05,11:10,1,0,1
30,2023-06-05T11:10:00+10:00,2023-06-05,11:10,1,3,4
35,2023-06-05T11:10:00+10:00,2023-06-05,11:10,5,4,9
48,2023-06-05T11:10:00+10:00,2023-06-05,11:10,0,2,2
53,2023-06-05T11:10:00+10:00,2023-06-05,11:10,16,1,17
56,2023-06-05T11:10:00+10:00,2023-06-05,11:10,5,0,5
62,2023-06-05T11:10:00+10:00,2023-06-05,11:10,3,0,3
67,2023-06-05T11:10:00+10:00,2023-06-05,11:10,7,14,21
76,2023-06-05T11:10:00+10:00,2023-06-05,11:10,1,0,1
79,2023-06-05T11:10:00+10:00,2023-06-05,11:10,9,9,18
85,2023-06-05T11:10:00+10:00,2023-06-05,11:10,0,1,1
5,2023-06-05T11:10:00+10:00,2023-06-05,11:10,5,12,17
36,2023-06-05T11:10:00+10:00,2023-06-05,11:10,1,1,2
40,2023-06-05T11:10:00+10:00,2023-06-05,11:10,3,1,4
45,2023-06-05T11:10:00+10:00,2023-06-05,11:10,6,6,12
47,2023-06-05T11:10:00+10:00,2023-06-05,11:10,5,4,9
50,2023-06-05T11:10:00+10:00,2023-06-05,11:10,1,1,2
65,2023-06-05T11:10:00+10:00,2023-06-05,11:10,3,7,10
78,2023-06-05T11:10:00+10:00,2023-06-05,11:10,0,2,2
2,2023-06-05T11:10:00+10:00,2023-06-05,11:10,3,5,8
9,2023-06-05T11:10:00+10:00,2023-06-05,11:10,1,1,2
11,2023-06-05T11:10:00+10:00,2023-06-05,11:10,2,4,6
17,2023-06-05T11:10:00+10:00,2023-06-05,11:10,4,2,6
18,2023-06-05T11:10:00+10:00,2023-06-05,11:10,1,1,2
19,2023-06-05T11:10:00+10:00,2023-06-05,11:10,6,1,7
58,2023-06-05T11:10:00+10:00,2023-06-05,11:10,4,3,7
63,2023-06-05T11:10:00+10:00,2023-06-05,11:10,3,9,12
109,2023-06-05T11:10:00+10:00,2023-06-05,11:10,13,19,32
117,2023-06-05T11:10:00+10:00,2023-06-05,11:10,4,6,10
3,2023-06-05T11:09:00+10:00,2023-06-05,11:09,8,7,15
6,2023-06-05T11:09:00+10:00,2023-06-05,11:09,4,4,8
29,2023-06-05T11:09:00+10:00,2023-06-05,11:09,3,0,3
31,2023-06-05T11:09:00+10:00,2023-06-05,11:09,0,2,2
36,2023-06-05T11:09:00+10:00,2023-06-05,11:09,0,3,3
47,2023-06-05T11:09:00+10:00,2023-06-05,11:09,5,13,18
61,2023-06-05T11:09:00+10:00,2023-06-05,11:09,2,5,7
65,2023-06-05T11:09:00+10:00,2023-06-05,11:09,7,2,9
69,2023-06-05T11:09:00+10:00,2023-06-05,11:09,0,1,1
78,2023-06-05T11:09:00+10:00,2023-06-05,11:09,0,2,2
108,2023-06-05T11:09:00+10:00,2023-06-05,11:09,3,3,6
1,2023-06-05T11:09:00+10:00,2023-06-05,11:09,18,13,31
9,2023-06-05T11:09:00+10:00,2023-06-05,11:09,0,3,3
17,2023-06-05T11:09:00+10:00,2023-06-05,11:09,6,4,10
18,2023-06-05T11:09:00+10:00,2023-06-05,11:09,4,1,5
23,2023-06-05T11:09:00+10:00,2023-06-05,11:09,1,3,4
24,2023-06-05T11:09:00+10:00,2023-06-05,11:09,8,6,14
35,2023-06-05T11:09:00+10:00,2023-06-05,11:09,9,3,12
48,2023-06-05T11:09:00+10:00,2023-06-05,11:09,2,2,4
49,2023-06-05T11:09:00+10:00,2023-06-05,11:09,2,1,3
56,2023-06-05T11:09:00+10:00,2023-06-05,11:09,4,3,7
58,2023-06-05T11:09:00+10:00,2023-06-05,11:09,9,0,9
63,2023-06-05T11:09:00+10:00,2023-06-05,11:09,5,4,9
8,2023-06-05T11:09:00+10:00,2023-06-05,11:09,0,2,2
21,2023-06-05T11:09:00+10:00,2023-06-05,11:09,5,4,9
28,2023-06-05T11:09:00+10:00,2023-06-05,11:09,2,8,10
44,2023-06-05T11:09:00+10:00,2023-06-05,11:09,3,0,3
45,2023-06-05T11:09:00+10:00,2023-06-05,11:09,9,1,10
54,2023-06-05T11:09:00+10:00,2023-06-05,11:09,2,1,3
66,2023-06-05T11:09:00+10:00,2023-06-05,11:09,7,12,19
87,2023-06-05T11:09:00+10:00,2023-06-05,11:09,2,2,4
10,2023-06-05T11:09:00+10:00,2023-06-05,11:09,1,0,1
11,2023-06-05T11:09:00+10:00,2023-06-05,11:09,0,2,2
12,2023-06-05T11:09:00+10:00,2023-06-05,11:09,1,0,1
30,2023-06-05T11:09:00+10:00,2023-06-05,11:09,1,6,7
52,2023-06-05T11:09:00+10:00,2023-06-05,11:09,8,2,10
53,2023-06-05T11:09:00+10:00,2023-06-05,11:09,12,6,18
72,2023-06-05T11:09:00+10:00,2023-06-05,11:09,0,2,2
76,2023-06-05T11:09:00+10:00,2023-06-05,11:09,0,3,3
85,2023-06-05T11:09:00+10:00,2023-06-05,11:09,1,0,1
86,2023-06-05T11:09:00+10:00,2023-06-05,11:09,1,0,1
4,2023-06-05T11:09:00+10:00,2023-06-05,11:09,16,8,24
5,2023-06-05T11:09:00+10:00,2023-06-05,11:09,10,21,31
14,2023-06-05T11:09:00+10:00,2023-06-05,11:09,0,4,4
26,2023-06-05T11:09:00+10:00,2023-06-05,11:09,9,4,13
39,2023-06-05T11:09:00+10:00,2023-06-05,11:09,1,2,3
40,2023-06-05T11:09:00+10:00,2023-06-05,11:09,9,3,12
41,2023-06-05T11:09:00+10:00,2023-06-05,11:09,32,10,42
50,2023-06-05T11:09:00+10:00,2023-06-05,11:09,5,5,10
55,2023-06-05T11:09:00+10:00,2023-06-05,11:09,8,4,12
77,2023-06-05T11:09:00+10:00,2023-06-05,11:09,3,0,3
2,2023-06-05T11:09:00+10:00,2023-06-05,11:09,5,7,12
19,2023-06-05T11:09:00+10:00,2023-06-05,11:09,2,2,4
20,2023-06-05T11:09:00+10:00,2023-06-05,11:09,1,4,5
46,2023-06-05T11:09:00+10:00,2023-06-05,11:09,0,4,4
57,2023-06-05T11:09:00+10:00,2023-06-05,11:09,5,3,8
62,2023-06-05T11:09:00+10:00,2023-06-05,11:09,8,0,8
67,2023-06-05T11:09:00+10:00,2023-06-05,11:09,7,2,9
68,2023-06-05T11:09:00+10:00,2023-06-05,11:09,6,7,13
79,2023-06-05T11:09:00+10:00,2023-06-05,11:09,5,1,6
3,2023-06-05T11:08:00+10:00,2023-06-05,11:08,11,9,20
4,2023-06-05T11:08:00+10:00,2023-06-05,11:08,22,6,28
14,2023-06-05T11:08:00+10:00,2023-06-05,11:08,2,0,2
31,2023-06-05T11:08:00+10:00,2023-06-05,11:08,4,1,5
36,2023-06-05T11:08:00+10:00,2023-06-05,11:08,1,2,3
47,2023-06-05T11:08:00+10:00,2023-06-05,11:08,1,17,18
55,2023-06-05T11:08:00+10:00,2023-06-05,11:08,8,17,25
61,2023-06-05T11:08:00+10:00,2023-06-05,11:08,9,8,17
71,2023-06-05T11:08:00+10:00,2023-06-05,11:08,1,0,1
75,2023-06-05T11:08:00+10:00,2023-06-05,11:08,5,1,6
108,2023-06-05T11:08:00+10:00,2023-06-05,11:08,7,2,9
10,2023-06-05T11:08:00+10:00,2023-06-05,11:08,0,1,1
18,2023-06-05T11:08:00+10:00,2023-06-05,11:08,3,3,6
23,2023-06-05T11:08:00+10:00,2023-06-05,11:08,4,4,8
27,2023-06-05T11:08:00+10:00,2023-06-05,11:08,1,0,1
30,2023-06-05T11:08:00+10:00,2023-06-05,11:08,3,0,3
35,2023-06-05T11:08:00+10:00,2023-06-05,11:08,7,5,12
48,2023-06-05T11:08:00+10:00,2023-06-05,11:08,4,0,4
51,2023-06-05T11:08:00+10:00,2023-06-05,11:08,1,0,1
52,2023-06-05T11:08:00+10:00,2023-06-05,11:08,3,5,8
56,2023-06-05T11:08:00+10:00,2023-06-05,11:08,2,1,3
63,2023-06-05T11:08:00+10:00,2023-06-05,11:08,2,5,7
6,2023-06-05T11:08:00+10:00,2023-06-05,11:08,4,5,9
26,2023-06-05T11:08:00+10:00,2023-06-05,11:08,1,9,10
29,2023-06-05T11:08:00+10:00,2023-06-05,11:08,2,0,2
37,2023-06-05T11:08:00+10:00,2023-06-05,11:08,3,0,3
41,2023-06-05T11:08:00+10:00,2023-06-05,11:08,23,17,40
54,2023-06-05T11:08:00+10:00,2023-06-05,11:08,1,0,1
69,2023-06-05T11:08:00+10:00,2023-06-05,11:08,8,4,12
70,2023-06-05T11:08:00+10:00,2023-06-05,11:08,2,1,3
77,2023-06-05T11:08:00+10:00,2023-06-05,11:08,1,0,1
20,2023-06-05T11:08:00+10:00,2023-06-05,11:08,1,1,2
46,2023-06-05T11:08:00+10:00,2023-06-05,11:08,0,1,1
49,2023-06-05T11:08:00+10:00,2023-06-05,11:08,0,2,2
72,2023-06-05T11:08:00+10:00,2023-06-05,11:08,1,12,13
76,2023-06-05T11:08:00+10:00,2023-06-05,11:08,0,2,2
79,2023-06-05T11:08:00+10:00,2023-06-05,11:08,9,3,12
86,2023-06-05T11:08:00+10:00,2023-06-05,11:08,1,0,1
5,2023-06-05T11:08:00+10:00,2023-06-05,11:08,10,12,22
8,2023-06-05T11:08:00+10:00,2023-06-05,11:08,3,1,4
21,2023-06-05T11:08:00+10:00,2023-06-05,11:08,3,1,4
28,2023-06-05T11:08:00+10:00,2023-06-05,11:08,10,7,17
39,2023-06-05T11:08:00+10:00,2023-06-05,11:08,0,2,2
40,2023-06-05T11:08:00+10:00,2023-06-05,11:08,3,0,3
42,2023-06-05T11:08:00+10:00,2023-06-05,11:08,2,0,2
44,2023-06-05T11:08:00+10:00,2023-06-05,11:08,0,1,1
45,2023-06-05T11:08:00+10:00,2023-06-05,11:08,3,5,8
50,2023-06-05T11:08:00+10:00,2023-06-05,11:08,1,1,2
65,2023-06-05T11:08:00+10:00,2023-06-05,11:08,4,3,7
66,2023-06-05T11:08:00+10:00,2023-06-05,11:08,3,6,9
87,2023-06-05T11:08:00+10:00,2023-06-05,11:08,0,1,1
1,2023-06-05T11:08:00+10:00,2023-06-05,11:08,12,8,20
2,2023-06-05T11:08:00+10:00,2023-06-05,11:08,10,1,11
9,2023-06-05T11:08:00+10:00,2023-06-05,11:08,5,2,7
12,2023-06-05T11:08:00+10:00,2023-06-05,11:08,1,4,5
17,2023-06-05T11:08:00+10:00,2023-06-05,11:08,5,1,6
19,2023-06-05T11:08:00+10:00,2023-06-05,11:08,7,2,9
24,2023-06-05T11:08:00+10:00,2023-06-05,11:08,10,11,21
53,2023-06-05T11:08:00+10:00,2023-06-05,11:08,11,4,15
57,2023-06-05T11:08:00+10:00,2023-06-05,11:08,0,6,6
58,2023-06-05T11:08:00+10:00,2023-06-05,11:08,12,0,12
62,2023-06-05T11:08:00+10:00,2023-06-05,11:08,1,0,1
67,2023-06-05T11:08:00+10:00,2023-06-05,11:08,3,11,14
68,2023-06-05T11:08:00+10:00,2023-06-05,11:08,4,2,6
85,2023-06-05T11:08:00+10:00,2023-06-05,11:08,0,1,1
4,2023-06-05T11:07:00+10:00,2023-06-05,11:07,13,5,18
6,2023-06-05T11:07:00+10:00,2023-06-05,11:07,7,4,11
28,2023-06-05T11:07:00+10:00,2023-06-05,11:07,11,10,21
37,2023-06-05T11:07:00+10:00,2023-06-05,11:07,1,0,1
42,2023-06-05T11:07:00+10:00,2023-06-05,11:07,0,6,6
50,2023-06-05T11:07:00+10:00,2023-06-05,11:07,3,5,8
61,2023-06-05T11:07:00+10:00,2023-06-05,11:07,2,9,11
65,2023-06-05T11:07:00+10:00,2023-06-05,11:07,6,6,12
66,2023-06-05T11:07:00+10:00,2023-06-05,11:07,5,15,20
69,2023-06-05T11:07:00+10:00,2023-06-05,11:07,6,3,9
77,2023-06-05T11:07:00+10:00,2023-06-05,11:07,1,2,3
108,2023-06-05T11:07:00+10:00,2023-06-05,11:07,3,0,3
2,2023-06-05T11:07:00+10:00,2023-06-05,11:07,3,5,8
11,2023-06-05T11:07:00+10:00,2023-06-05,11:07,1,0,1
20,2023-06-05T11:07:00+10:00,2023-06-05,11:07,3,2,5
24,2023-06-05T11:07:00+10:00,2023-06-05,11:07,5,7,12
56,2023-06-05T11:07:00+10:00,2023-06-05,11:07,3,0,3
58,2023-06-05T11:07:00+10:00,2023-06-05,11:07,6,6,12
62,2023-06-05T11:07:00+10:00,2023-06-05,11:07,1,1,2
72,2023-06-05T11:07:00+10:00,2023-06-05,11:07,4,0,4
3,2023-06-05T11:07:00+10:00,2023-06-05,11:07,5,14,19
5,2023-06-05T11:07:00+10:00,2023-06-05,11:07,3,16,19
14,2023-06-05T11:07:00+10:00,2023-06-05,11:07,4,1,5
21,2023-06-05T11:07:00+10:00,2023-06-05,11:07,1,3,4
26,2023-06-05T11:07:00+10:00,2023-06-05,11:07,3,0,3
29,2023-06-05T11:07:00+10:00,2023-06-05,11:07,1,0,1
44,2023-06-05T11:07:00+10:00,2023-06-05,11:07,1,0,1
47,2023-06-05T11:07:00+10:00,2023-06-05,11:07,10,6,16
55,2023-06-05T11:07:00+10:00,2023-06-05,11:07,1,15,16
1,2023-06-05T11:07:00+10:00,2023-06-05,11:07,9,3,12
9,2023-06-05T11:07:00+10:00,2023-06-05,11:07,4,2,6
18,2023-06-05T11:07:00+10:00,2023-06-05,11:07,1,5,6
19,2023-06-05T11:07:00+10:00,2023-06-05,11:07,2,4,6
35,2023-06-05T11:07:00+10:00,2023-06-05,11:07,3,27,30
46,2023-06-05T11:07:00+10:00,2023-06-05,11:07,2,0,2
51,2023-06-05T11:07:00+10:00,2023-06-05,11:07,0,1,1
52,2023-06-05T11:07:00+10:00,2023-06-05,11:07,3,1,4
53,2023-06-05T11:07:00+10:00,2023-06-05,11:07,10,9,19
57,2023-06-05T11:07:00+10:00,2023-06-05,11:07,5,1,6
63,2023-06-05T11:07:00+10:00,2023-06-05,11:07,0,3,3
67,2023-06-05T11:07:00+10:00,2023-06-05,11:07,7,11,18
31,2023-06-05T11:07:00+10:00,2023-06-05,11:07,0,1,1
36,2023-06-05T11:07:00+10:00,2023-06-05,11:07,2,4,6
40,2023-06-05T11:07:00+10:00,2023-06-05,11:07,4,3,7
41,2023-06-05T11:07:00+10:00,2023-06-05,11:07,23,9,32
45,2023-06-05T11:07:00+10:00,2023-06-05,11:07,1,2,3
70,2023-06-05T11:07:00+10:00,2023-06-05,11:07,1,0,1
10,2023-06-05T11:07:00+10:00,2023-06-05,11:07,1,2,3
17,2023-06-05T11:07:00+10:00,2023-06-05,11:07,0,5,5
23,2023-06-05T11:07:00+10:00,2023-06-05,11:07,2,3,5
30,2023-06-05T11:07:00+10:00,2023-06-05,11:07,0,4,4
48,2023-06-05T11:07:00+10:00,2023-06-05,11:07,0,1,1
68,2023-06-05T11:07:00+10:00,2023-06-05,11:07,4,3,7
79,2023-06-05T11:07:00+10:00,2023-06-05,11:07,11,8,19
85,2023-06-05T11:07:00+10:00,2023-06-05,11:07,1,1,2
3,2023-06-05T11:06:00+10:00,2023-06-05,11:06,8,9,17
5,2023-06-05T11:06:00+10:00,2023-06-05,11:06,2,5,7
21,2023-06-05T11:06:00+10:00,2023-06-05,11:06,1,7,8
36,2023-06-05T11:06:00+10:00,2023-06-05,11:06,2,6,8
39,2023-06-05T11:06:00+10:00,2023-06-05,11:06,2,0,2
42,2023-06-05T11:06:00+10:00,2023-06-05,11:06,6,3,9
44,2023-06-05T11:06:00+10:00,2023-06-05,11:06,1,0,1
47,2023-06-05T11:06:00+10:00,2023-06-05,11:06,4,6,10
54,2023-06-05T11:06:00+10:00,2023-06-05,11:06,2,8,10
55,2023-06-05T11:06:00+10:00,2023-06-05,11:06,5,11,16
61,2023-06-05T11:06:00+10:00,2023-06-05,11:06,6,2,8
65,2023-06-05T11:06:00+10:00,2023-06-05,11:06,3,3,6
108,2023-06-05T11:06:00+10:00,2023-06-05,11:06,4,3,7
10,2023-06-05T11:06:00+10:00,2023-06-05,11:06,4,0,4
12,2023-06-05T11:06:00+10:00,2023-06-05,11:06,3,4,7
17,2023-06-05T11:06:00+10:00,2023-06-05,11:06,7,4,11
19,2023-06-05T11:06:00+10:00,2023-06-05,11:06,0,1,1
27,2023-06-05T11:06:00+10:00,2023-06-05,11:06,0,2,2
30,2023-06-05T11:06:00+10:00,2023-06-05,11:06,2,1,3
58,2023-06-05T11:06:00+10:00,2023-06-05,11:06,8,1,9
68,2023-06-05T11:06:00+10:00,2023-06-05,11:06,0,1,1
4,2023-06-05T11:06:00+10:00,2023-06-05,11:06,16,6,22
6,2023-06-05T11:06:00+10:00,2023-06-05,11:06,4,7,11
8,2023-06-05T11:06:00+10:00,2023-06-05,11:06,5,1,6
14,2023-06-05T11:06:00+10:00,2023-06-05,11:06,7,2,9
26,2023-06-05T11:06:00+10:00,2023-06-05,11:06,8,12,20
28,2023-06-05T11:06:00+10:00,2023-06-05,11:06,15,6,21
29,2023-06-05T11:06:00+10:00,2023-06-05,11:06,0,3,3
40,2023-06-05T11:06:00+10:00,2023-06-05,11:06,6,3,9
70,2023-06-05T11:06:00+10:00,2023-06-05,11:06,0,1,1
2,2023-06-05T11:06:00+10:00,2023-06-05,11:06,4,3,7
9,2023-06-05T11:06:00+10:00,2023-06-05,11:06,3,3,6
18,2023-06-05T11:06:00+10:00,2023-06-05,11:06,1,1,2
35,2023-06-05T11:06:00+10:00,2023-06-05,11:06,2,4,6
46,2023-06-05T11:06:00+10:00,2023-06-05,11:06,1,3,4
48,2023-06-05T11:06:00+10:00,2023-06-05,11:06,1,0,1
52,2023-06-05T11:06:00+10:00,2023-06-05,11:06,3,5,8
53,2023-06-05T11:06:00+10:00,2023-06-05,11:06,16,5,21
56,2023-06-05T11:06:00+10:00,2023-06-05,11:06,0,1,1
57,2023-06-05T11:06:00+10:00,2023-06-05,11:06,1,5,6
72,2023-06-05T11:06:00+10:00,2023-06-05,11:06,3,2,5
79,2023-06-05T11:06:00+10:00,2023-06-05,11:06,0,4,4
31,2023-06-05T11:06:00+10:00,2023-06-05,11:06,2,1,3
41,2023-06-05T11:06:00+10:00,2023-06-05,11:06,31,13,44
45,2023-06-05T11:06:00+10:00,2023-06-05,11:06,6,5,11
50,2023-06-05T11:06:00+10:00,2023-06-05,11:06,0,4,4
66,2023-06-05T11:06:00+10:00,2023-06-05,11:06,7,8,15
69,2023-06-05T11:06:00+10:00,2023-06-05,11:06,4,0,4
87,2023-06-05T11:06:00+10:00,2023-06-05,11:06,0,3,3
1,2023-06-05T11:06:00+10:00,2023-06-05,11:06,8,8,16
11,2023-06-05T11:06:00+10:00,2023-06-05,11:06,1,0,1
23,2023-06-05T11:06:00+10:00,2023-06-05,11:06,1,2,3
24,2023-06-05T11:06:00+10:00,2023-06-05,11:06,8,3,11
62,2023-06-05T11:06:00+10:00,2023-06-05,11:06,3,1,4
63,2023-06-05T11:06:00+10:00,2023-06-05,11:06,8,2,10
67,2023-06-05T11:06:00+10:00,2023-06-05,11:06,7,6,13
85,2023-06-05T11:06:00+10:00,2023-06-05,11:06,1,1,2
86,2023-06-05T11:06:00+10:00,2023-06-05,11:06,1,1,2
3,2023-06-05T11:05:00+10:00,2023-06-05,11:05,7,20,27
4,2023-06-05T11:05:00+10:00,2023-06-05,11:05,9,10,19
31,2023-06-05T11:05:00+10:00,2023-06-05,11:05,2,0,2
45,2023-06-05T11:05:00+10:00,2023-06-05,11:05,1,4,5
55,2023-06-05T11:05:00+10:00,2023-06-05,11:05,9,12,21
65,2023-06-05T11:05:00+10:00,2023-06-05,11:05,2,3,5
70,2023-06-05T11:05:00+10:00,2023-06-05,11:05,1,5,6
71,2023-06-05T11:05:00+10:00,2023-06-05,11:05,0,1,1
84,2023-06-05T11:05:00+10:00,2023-06-05,11:05,45,36,81
87,2023-06-05T11:05:00+10:00,2023-06-05,11:05,1,0,1
108,2023-06-05T11:05:00+10:00,2023-06-05,11:05,1,3,4
17,2023-06-05T11:05:00+10:00,2023-06-05,11:05,5,2,7
18,2023-06-05T11:05:00+10:00,2023-06-05,11:05,2,4,6
20,2023-06-05T11:05:00+10:00,2023-06-05,11:05,1,2,3
27,2023-06-05T11:05:00+10:00,2023-06-05,11:05,1,2,3
49,2023-06-05T11:05:00+10:00,2023-06-05,11:05,0,1,1
53,2023-06-05T11:05:00+10:00,2023-06-05,11:05,5,12,17
56,2023-06-05T11:05:00+10:00,2023-06-05,11:05,1,0,1
67,2023-06-05T11:05:00+10:00,2023-06-05,11:05,9,17,26
72,2023-06-05T11:05:00+10:00,2023-06-05,11:05,2,0,2
76,2023-06-05T11:05:00+10:00,2023-06-05,11:05,1,0,1
79,2023-06-05T11:05:00+10:00,2023-06-05,11:05,2,7,9
85,2023-06-05T11:05:00+10:00,2023-06-05,11:05,2,0,2
5,2023-06-05T11:05:00+10:00,2023-06-05,11:05,10,7,17
8,2023-06-05T11:05:00+10:00,2023-06-05,11:05,1,4,5
36,2023-06-05T11:05:00+10:00,2023-06-05,11:05,2,1,3
37,2023-06-05T11:05:00+10:00,2023-06-05,11:05,0,1,1
39,2023-06-05T11:05:00+10:00,2023-06-05,11:05,1,3,4
40,2023-06-05T11:05:00+10:00,2023-06-05,11:05,1,0,1
50,2023-06-05T11:05:00+10:00,2023-06-05,11:05,1,4,5
61,2023-06-05T11:05:00+10:00,2023-06-05,11:05,3,5,8
66,2023-06-05T11:05:00+10:00,2023-06-05,11:05,5,10,15
77,2023-06-05T11:05:00+10:00,2023-06-05,11:05,0,1,1
118,2023-06-05T11:05:00+10:00,2023-06-05,11:05,0,1,1
1,2023-06-05T11:05:00+10:00,2023-06-05,11:05,8,15,23
2,2023-06-05T11:05:00+10:00,2023-06-05,11:05,2,0,2
9,2023-06-05T11:05:00+10:00,2023-06-05,11:05,3,8,11
11,2023-06-05T11:05:00+10:00,2023-06-05,11:05,2,6,8
12,2023-06-05T11:05:00+10:00,2023-06-05,11:05,1,2,3
23,2023-06-05T11:05:00+10:00,2023-06-05,11:05,4,4,8
24,2023-06-05T11:05:00+10:00,2023-06-05,11:05,4,3,7
30,2023-06-05T11:05:00+10:00,2023-06-05,11:05,3,2,5
46,2023-06-05T11:05:00+10:00,2023-06-05,11:05,1,0,1
48,2023-06-05T11:05:00+10:00,2023-06-05,11:05,1,1,2
52,2023-06-05T11:05:00+10:00,2023-06-05,11:05,2,5,7
57,2023-06-05T11:05:00+10:00,2023-06-05,11:05,3,4,7
109,2023-06-05T11:05:00+10:00,2023-06-05,11:05,9,12,21
117,2023-06-05T11:05:00+10:00,2023-06-05,11:05,7,10,17
6,2023-06-05T11:05:00+10:00,2023-06-05,11:05,3,6,9
21,2023-06-05T11:05:00+10:00,2023-06-05,11:05,1,3,4
26,2023-06-05T11:05:00+10:00,2023-06-05,11:05,3,1,4
28,2023-06-05T11:05:00+10:00,2023-06-05,11:05,8,14,22
41,2023-06-05T11:05:00+10:00,2023-06-05,11:05,13,17,30
42,2023-06-05T11:05:00+10:00,2023-06-05,11:05,3,6,9
47,2023-06-05T11:05:00+10:00,2023-06-05,11:05,5,11,16
59,2023-06-05T11:05:00+10:00,2023-06-05,11:05,31,29,60
69,2023-06-05T11:05:00+10:00,2023-06-05,11:05,1,1,2
107,2023-06-05T11:05:00+10:00,2023-06-05,11:05,17,14,31
10,2023-06-05T11:05:00+10:00,2023-06-05,11:05,1,0,1
19,2023-06-05T11:05:00+10:00,2023-06-05,11:05,1,8,9
35,2023-06-05T11:05:00+10:00,2023-06-05,11:05,8,4,12
58,2023-06-05T11:05:00+10:00,2023-06-05,11:05,2,5,7
62,2023-06-05T11:05:00+10:00,2023-06-05,11:05,5,1,6
63,2023-06-05T11:05:00+10:00,2023-06-05,11:05,2,4,6
68,2023-06-05T11:05:00+10:00,2023-06-05,11:05,2,2,4
28,2023-06-05T11:04:00+10:00,2023-06-05,11:04,9,3,12
40,2023-06-05T11:04:00+10:00,2023-06-05,11:04,5,2,7
42,2023-06-05T11:04:00+10:00,2023-06-05,11:04,1,3,4
44,2023-06-05T11:04:00+10:00,2023-06-05,11:04,0,2,2
45,2023-06-05T11:04:00+10:00,2023-06-05,11:04,5,3,8
71,2023-06-05T11:04:00+10:00,2023-06-05,11:04,0,1,1
77,2023-06-05T11:04:00+10:00,2023-06-05,11:04,8,0,8
1,2023-06-05T11:04:00+10:00,2023-06-05,11:04,7,9,16
9,2023-06-05T11:04:00+10:00,2023-06-05,11:04,0,2,2
10,2023-06-05T11:04:00+10:00,2023-06-05,11:04,3,4,7
30,2023-06-05T11:04:00+10:00,2023-06-05,11:04,2,3,5
35,2023-06-05T11:04:00+10:00,2023-06-05,11:04,4,4,8
51,2023-06-05T11:04:00+10:00,2023-06-05,11:04,0,5,5
56,2023-06-05T11:04:00+10:00,2023-06-05,11:04,5,1,6
57,2023-06-05T11:04:00+10:00,2023-06-05,11:04,3,2,5
79,2023-06-05T11:04:00+10:00,2023-06-05,11:04,4,1,5
85,2023-06-05T11:04:00+10:00,2023-06-05,11:04,0,3,3
3,2023-06-05T11:04:00+10:00,2023-06-05,11:04,2,7,9
4,2023-06-05T11:04:00+10:00,2023-06-05,11:04,16,12,28
21,2023-06-05T11:04:00+10:00,2023-06-05,11:04,1,0,1
26,2023-06-05T11:04:00+10:00,2023-06-05,11:04,1,2,3
29,2023-06-05T11:04:00+10:00,2023-06-05,11:04,1,2,3
36,2023-06-05T11:04:00+10:00,2023-06-05,11:04,3,2,5
50,2023-06-05T11:04:00+10:00,2023-06-05,11:04,6,4,10
55,2023-06-05T11:04:00+10:00,2023-06-05,11:04,7,12,19
65,2023-06-05T11:04:00+10:00,2023-06-05,11:04,7,11,18
66,2023-06-05T11:04:00+10:00,2023-06-05,11:04,8,5,13
2,2023-06-05T11:04:00+10:00,2023-06-05,11:04,8,3,11
17,2023-06-05T11:04:00+10:00,2023-06-05,11:04,5,2,7
18,2023-06-05T11:04:00+10:00,2023-06-05,11:04,3,8,11
19,2023-06-05T11:04:00+10:00,2023-06-05,11:04,9,2,11
20,2023-06-05T11:04:00+10:00,2023-06-05,11:04,1,2,3
53,2023-06-05T11:04:00+10:00,2023-06-05,11:04,11,9,20
58,2023-06-05T11:04:00+10:00,2023-06-05,11:04,8,2,10
62,2023-06-05T11:04:00+10:00,2023-06-05,11:04,1,0,1
63,2023-06-05T11:04:00+10:00,2023-06-05,11:04,3,7,10
68,2023-06-05T11:04:00+10:00,2023-06-05,11:04,6,4,10
72,2023-06-05T11:04:00+10:00,2023-06-05,11:04,0,2,2
76,2023-06-05T11:04:00+10:00,2023-06-05,11:04,0,1,1
5,2023-06-05T11:04:00+10:00,2023-06-05,11:04,7,5,12
6,2023-06-05T11:04:00+10:00,2023-06-05,11:04,6,3,9
8,2023-06-05T11:04:00+10:00,2023-06-05,11:04,2,1,3
37,2023-06-05T11:04:00+10:00,2023-06-05,11:04,1,0,1
41,2023-06-05T11:04:00+10:00,2023-06-05,11:04,28,7,35
47,2023-06-05T11:04:00+10:00,2023-06-05,11:04,8,7,15
61,2023-06-05T11:04:00+10:00,2023-06-05,11:04,6,5,11
69,2023-06-05T11:04:00+10:00,2023-06-05,11:04,3,7,10
70,2023-06-05T11:04:00+10:00,2023-06-05,11:04,0,3,3
87,2023-06-05T11:04:00+10:00,2023-06-05,11:04,1,1,2
108,2023-06-05T11:04:00+10:00,2023-06-05,11:04,3,7,10
12,2023-06-05T11:04:00+10:00,2023-06-05,11:04,0,4,4
23,2023-06-05T11:04:00+10:00,2023-06-05,11:04,2,2,4
24,2023-06-05T11:04:00+10:00,2023-06-05,11:04,7,2,9
46,2023-06-05T11:04:00+10:00,2023-06-05,11:04,1,3,4
49,2023-06-05T11:04:00+10:00,2023-06-05,11:04,0,3,3
52,2023-06-05T11:04:00+10:00,2023-06-05,11:04,4,1,5
67,2023-06-05T11:04:00+10:00,2023-06-05,11:04,4,11,15
86,2023-06-05T11:04:00+10:00,2023-06-05,11:04,1,0,1
5,2023-06-05T11:03:00+10:00,2023-06-05,11:03,6,9,15
8,2023-06-05T11:03:00+10:00,2023-06-05,11:03,0,2,2
14,2023-06-05T11:03:00+10:00,2023-06-05,11:03,3,0,3
21,2023-06-05T11:03:00+10:00,2023-06-05,11:03,1,4,5
28,2023-06-05T11:03:00+10:00,2023-06-05,11:03,8,5,13
29,2023-06-05T11:03:00+10:00,2023-06-05,11:03,2,0,2
37,2023-06-05T11:03:00+10:00,2023-06-05,11:03,1,0,1
47,2023-06-05T11:03:00+10:00,2023-06-05,11:03,13,12,25
50,2023-06-05T11:03:00+10:00,2023-06-05,11:03,4,0,4
55,2023-06-05T11:03:00+10:00,2023-06-05,11:03,6,9,15
23,2023-06-05T11:03:00+10:00,2023-06-05,11:03,8,0,8
35,2023-06-05T11:03:00+10:00,2023-06-05,11:03,10,6,16
46,2023-06-05T11:03:00+10:00,2023-06-05,11:03,0,2,2
51,2023-06-05T11:03:00+10:00,2023-06-05,11:03,1,2,3
53,2023-06-05T11:03:00+10:00,2023-06-05,11:03,9,10,19
57,2023-06-05T11:03:00+10:00,2023-06-05,11:03,1,4,5
76,2023-06-05T11:03:00+10:00,2023-06-05,11:03,1,0,1
79,2023-06-05T11:03:00+10:00,2023-06-05,11:03,6,9,15
85,2023-06-05T11:03:00+10:00,2023-06-05,11:03,0,1,1
3,2023-06-05T11:03:00+10:00,2023-06-05,11:03,6,16,22
4,2023-06-05T11:03:00+10:00,2023-06-05,11:03,24,7,31
26,2023-06-05T11:03:00+10:00,2023-06-05,11:03,7,3,10
41,2023-06-05T11:03:00+10:00,2023-06-05,11:03,33,9,42
44,2023-06-05T11:03:00+10:00,2023-06-05,11:03,1,0,1
61,2023-06-05T11:03:00+10:00,2023-06-05,11:03,2,8,10
65,2023-06-05T11:03:00+10:00,2023-06-05,11:03,9,1,10
69,2023-06-05T11:03:00+10:00,2023-06-05,11:03,6,3,9
70,2023-06-05T11:03:00+10:00,2023-06-05,11:03,1,5,6
75,2023-06-05T11:03:00+10:00,2023-06-05,11:03,3,0,3
77,2023-06-05T11:03:00+10:00,2023-06-05,11:03,0,1,1
2,2023-06-05T11:03:00+10:00,2023-06-05,11:03,9,3,12
9,2023-06-05T11:03:00+10:00,2023-06-05,11:03,1,3,4
10,2023-06-05T11:03:00+10:00,2023-06-05,11:03,0,1,1
17,2023-06-05T11:03:00+10:00,2023-06-05,11:03,5,5,10
24,2023-06-05T11:03:00+10:00,2023-06-05,11:03,14,3,17
58,2023-06-05T11:03:00+10:00,2023-06-05,11:03,9,14,23
67,2023-06-05T11:03:00+10:00,2023-06-05,11:03,7,7,14
68,2023-06-05T11:03:00+10:00,2023-06-05,11:03,7,3,10
6,2023-06-05T11:03:00+10:00,2023-06-05,11:03,3,3,6
31,2023-06-05T11:03:00+10:00,2023-06-05,11:03,0,1,1
36,2023-06-05T11:03:00+10:00,2023-06-05,11:03,5,0,5
39,2023-06-05T11:03:00+10:00,2023-06-05,11:03,1,1,2
40,2023-06-05T11:03:00+10:00,2023-06-05,11:03,3,2,5
42,2023-06-05T11:03:00+10:00,2023-06-05,11:03,1,3,4
45,2023-06-05T11:03:00+10:00,2023-06-05,11:03,7,9,16
54,2023-06-05T11:03:00+10:00,2023-06-05,11:03,2,1,3
66,2023-06-05T11:03:00+10:00,2023-06-05,11:03,9,10,19
87,2023-06-05T11:03:00+10:00,2023-06-05,11:03,1,2,3
108,2023-06-05T11:03:00+10:00,2023-06-05,11:03,3,11,14
1,2023-06-05T11:03:00+10:00,2023-06-05,11:03,6,5,11
12,2023-06-05T11:03:00+10:00,2023-06-05,11:03,0,1,1
18,2023-06-05T11:03:00+10:00,2023-06-05,11:03,1,2,3
20,2023-06-05T11:03:00+10:00,2023-06-05,11:03,1,1,2
27,2023-06-05T11:03:00+10:00,2023-06-05,11:03,0,1,1
30,2023-06-05T11:03:00+10:00,2023-06-05,11:03,3,8,11
48,2023-06-05T11:03:00+10:00,2023-06-05,11:03,4,1,5
52,2023-06-05T11:03:00+10:00,2023-06-05,11:03,2,5,7
62,2023-06-05T11:03:00+10:00,2023-06-05,11:03,1,1,2
63,2023-06-05T11:03:00+10:00,2023-06-05,11:03,1,4,5
72,2023-06-05T11:03:00+10:00,2023-06-05,11:03,4,2,6
86,2023-06-05T11:03:00+10:00,2023-06-05,11:03,2,1,3
5,2023-06-05T11:02:00+10:00,2023-06-05,11:02,5,5,10
8,2023-06-05T11:02:00+10:00,2023-06-05,11:02,1,1,2
21,2023-06-05T11:02:00+10:00,2023-06-05,11:02,2,3,5
26,2023-06-05T11:02:00+10:00,2023-06-05,11:02,5,4,9
29,2023-06-05T11:02:00+10:00,2023-06-05,11:02,0,4,4
39,2023-06-05T11:02:00+10:00,2023-06-05,11:02,1,2,3
47,2023-06-05T11:02:00+10:00,2023-06-05,11:02,4,8,12
55,2023-06-05T11:02:00+10:00,2023-06-05,11:02,10,6,16
61,2023-06-05T11:02:00+10:00,2023-06-05,11:02,0,3,3
69,2023-06-05T11:02:00+10:00,2023-06-05,11:02,1,3,4
70,2023-06-05T11:02:00+10:00,2023-06-05,11:02,1,2,3
75,2023-06-05T11:02:00+10:00,2023-06-05,11:02,1,0,1
77,2023-06-05T11:02:00+10:00,2023-06-05,11:02,1,2,3
78,2023-06-05T11:02:00+10:00,2023-06-05,11:02,0,1,1
108,2023-06-05T11:02:00+10:00,2023-06-05,11:02,1,3,4
2,2023-06-05T11:02:00+10:00,2023-06-05,11:02,6,9,15
20,2023-06-05T11:02:00+10:00,2023-06-05,11:02,0,1,1
30,2023-06-05T11:02:00+10:00,2023-06-05,11:02,3,5,8
52,2023-06-05T11:02:00+10:00,2023-06-05,11:02,7,7,14
57,2023-06-05T11:02:00+10:00,2023-06-05,11:02,2,2,4
58,2023-06-05T11:02:00+10:00,2023-06-05,11:02,6,0,6
62,2023-06-05T11:02:00+10:00,2023-06-05,11:02,2,0,2
67,2023-06-05T11:02:00+10:00,2023-06-05,11:02,10,13,23
76,2023-06-05T11:02:00+10:00,2023-06-05,11:02,0,1,1
86,2023-06-05T11:02:00+10:00,2023-06-05,11:02,2,0,2
28,2023-06-05T11:02:00+10:00,2023-06-05,11:02,5,1,6
41,2023-06-05T11:02:00+10:00,2023-06-05,11:02,10,9,19
45,2023-06-05T11:02:00+10:00,2023-06-05,11:02,5,5,10
54,2023-06-05T11:02:00+10:00,2023-06-05,11:02,2,2,4
65,2023-06-05T11:02:00+10:00,2023-06-05,11:02,17,8,25
87,2023-06-05T11:02:00+10:00,2023-06-05,11:02,1,2,3
1,2023-06-05T11:02:00+10:00,2023-06-05,11:02,5,9,14
18,2023-06-05T11:02:00+10:00,2023-06-05,11:02,1,2,3
23,2023-06-05T11:02:00+10:00,2023-06-05,11:02,0,6,6
24,2023-06-05T11:02:00+10:00,2023-06-05,11:02,7,1,8
35,2023-06-05T11:02:00+10:00,2023-06-05,11:02,8,3,11
48,2023-06-05T11:02:00+10:00,2023-06-05,11:02,1,0,1
53,2023-06-05T11:02:00+10:00,2023-06-05,11:02,14,5,19
68,2023-06-05T11:02:00+10:00,2023-06-05,11:02,1,2,3
79,2023-06-05T11:02:00+10:00,2023-06-05,11:02,5,10,15
85,2023-06-05T11:02:00+10:00,2023-06-05,11:02,2,1,3
3,2023-06-05T11:02:00+10:00,2023-06-05,11:02,4,9,13
4,2023-06-05T11:02:00+10:00,2023-06-05,11:02,13,11,24
6,2023-06-05T11:02:00+10:00,2023-06-05,11:02,2,1,3
14,2023-06-05T11:02:00+10:00,2023-06-05,11:02,3,3,6
36,2023-06-05T11:02:00+10:00,2023-06-05,11:02,5,2,7
40,2023-06-05T11:02:00+10:00,2023-06-05,11:02,8,3,11
42,2023-06-05T11:02:00+10:00,2023-06-05,11:02,1,1,2
50,2023-06-05T11:02:00+10:00,2023-06-05,11:02,1,4,5
66,2023-06-05T11:02:00+10:00,2023-06-05,11:02,5,2,7
10,2023-06-05T11:02:00+10:00,2023-06-05,11:02,2,3,5
12,2023-06-05T11:02:00+10:00,2023-06-05,11:02,1,2,3
17,2023-06-05T11:02:00+10:00,2023-06-05,11:02,6,1,7
19,2023-06-05T11:02:00+10:00,2023-06-05,11:02,7,8,15
46,2023-06-05T11:02:00+10:00,2023-06-05,11:02,2,0,2
51,2023-06-05T11:02:00+10:00,2023-06-05,11:02,2,0,2
56,2023-06-05T11:02:00+10:00,2023-06-05,11:02,1,1,2
63,2023-06-05T11:02:00+10:00,2023-06-05,11:02,4,7,11
72,2023-06-05T11:02:00+10:00,2023-06-05,11:02,2,2,4
6,2023-06-05T11:01:00+10:00,2023-06-05,11:01,10,7,17
8,2023-06-05T11:01:00+10:00,2023-06-05,11:01,1,1,2
40,2023-06-05T11:01:00+10:00,2023-06-05,11:01,6,1,7
44,2023-06-05T11:01:00+10:00,2023-06-05,11:01,2,1,3
55,2023-06-05T11:01:00+10:00,2023-06-05,11:01,4,6,10
70,2023-06-05T11:01:00+10:00,2023-06-05,11:01,5,1,6
108,2023-06-05T11:01:00+10:00,2023-06-05,11:01,2,3,5
9,2023-06-05T11:01:00+10:00,2023-06-05,11:01,2,4,6
12,2023-06-05T11:01:00+10:00,2023-06-05,11:01,3,1,4
17,2023-06-05T11:01:00+10:00,2023-06-05,11:01,1,2,3
18,2023-06-05T11:01:00+10:00,2023-06-05,11:01,4,3,7
19,2023-06-05T11:01:00+10:00,2023-06-05,11:01,2,1,3
27,2023-06-05T11:01:00+10:00,2023-06-05,11:01,2,0,2
48,2023-06-05T11:01:00+10:00,2023-06-05,11:01,1,0,1
49,2023-06-05T11:01:00+10:00,2023-06-05,11:01,1,1,2
57,2023-06-05T11:01:00+10:00,2023-06-05,11:01,2,1,3
79,2023-06-05T11:01:00+10:00,2023-06-05,11:01,8,8,16
85,2023-06-05T11:01:00+10:00,2023-06-05,11:01,0,2,2
86,2023-06-05T11:01:00+10:00,2023-06-05,11:01,1,0,1
3,2023-06-05T11:01:00+10:00,2023-06-05,11:01,3,4,7
4,2023-06-05T11:01:00+10:00,2023-06-05,11:01,13,9,22
26,2023-06-05T11:01:00+10:00,2023-06-05,11:01,3,5,8
28,2023-06-05T11:01:00+10:00,2023-06-05,11:01,7,8,15
31,2023-06-05T11:01:00+10:00,2023-06-05,11:01,3,1,4
36,2023-06-05T11:01:00+10:00,2023-06-05,11:01,5,1,6
39,2023-06-05T11:01:00+10:00,2023-06-05,11:01,1,1,2
41,2023-06-05T11:01:00+10:00,2023-06-05,11:01,20,16,36
45,2023-06-05T11:01:00+10:00,2023-06-05,11:01,2,6,8
61,2023-06-05T11:01:00+10:00,2023-06-05,11:01,0,17,17
65,2023-06-05T11:01:00+10:00,2023-06-05,11:01,8,1,9
66,2023-06-05T11:01:00+10:00,2023-06-05,11:01,11,3,14
69,2023-06-05T11:01:00+10:00,2023-06-05,11:01,2,8,10
87,2023-06-05T11:01:00+10:00,2023-06-05,11:01,2,3,5
11,2023-06-05T11:01:00+10:00,2023-06-05,11:01,1,0,1
24,2023-06-05T11:01:00+10:00,2023-06-05,11:01,37,19,56
52,2023-06-05T11:01:00+10:00,2023-06-05,11:01,10,0,10
58,2023-06-05T11:01:00+10:00,2023-06-05,11:01,10,2,12
62,2023-06-05T11:01:00+10:00,2023-06-05,11:01,3,3,6
67,2023-06-05T11:01:00+10:00,2023-06-05,11:01,5,12,17
72,2023-06-05T11:01:00+10:00,2023-06-05,11:01,0,2,2
76,2023-06-05T11:01:00+10:00,2023-06-05,11:01,1,2,3
5,2023-06-05T11:01:00+10:00,2023-06-05,11:01,4,13,17
14,2023-06-05T11:01:00+10:00,2023-06-05,11:01,2,3,5
21,2023-06-05T11:01:00+10:00,2023-06-05,11:01,1,1,2
37,2023-06-05T11:01:00+10:00,2023-06-05,11:01,1,4,5
47,2023-06-05T11:01:00+10:00,2023-06-05,11:01,8,13,21
50,2023-06-05T11:01:00+10:00,2023-06-05,11:01,2,1,3
75,2023-06-05T11:01:00+10:00,2023-06-05,11:01,0,2,2
77,2023-06-05T11:01:00+10:00,2023-06-05,11:01,5,0,5
1,2023-06-05T11:01:00+10:00,2023-06-05,11:01,15,15,30
2,2023-06-05T11:01:00+10:00,2023-06-05,11:01,10,8,18
10,2023-06-05T11:01:00+10:00,2023-06-05,11:01,2,0,2
20,2023-06-05T11:01:00+10:00,2023-06-05,11:01,2,0,2
23,2023-06-05T11:01:00+10:00,2023-06-05,11:01,1,3,4
30,2023-06-05T11:01:00+10:00,2023-06-05,11:01,2,1,3
35,2023-06-05T11:01:00+10:00,2023-06-05,11:01,8,7,15
46,2023-06-05T11:01:00+10:00,2023-06-05,11:01,2,1,3
53,2023-06-05T11:01:00+10:00,2023-06-05,11:01,12,5,17
56,2023-06-05T11:01:00+10:00,2023-06-05,11:01,2,2,4
63,2023-06-05T11:01:00+10:00,2023-06-05,11:01,8,3,11
68,2023-06-05T11:01:00+10:00,2023-06-05,11:01,5,3,8
4,2023-06-05T11:00:00+10:00,2023-06-05,11:00,23,4,27
14,2023-06-05T11:00:00+10:00,2023-06-05,11:00,5,5,10
28,2023-06-05T11:00:00+10:00,2023-06-05,11:00,4,1,5
37,2023-06-05T11:00:00+10:00,2023-06-05,11:00,1,1,2
41,2023-06-05T11:00:00+10:00,2023-06-05,11:00,18,8,26
45,2023-06-05T11:00:00+10:00,2023-06-05,11:00,3,3,6
54,2023-06-05T11:00:00+10:00,2023-06-05,11:00,2,1,3
69,2023-06-05T11:00:00+10:00,2023-06-05,11:00,3,3,6
70,2023-06-05T11:00:00+10:00,2023-06-05,11:00,0,3,3
108,2023-06-05T11:00:00+10:00,2023-06-05,11:00,4,7,11
11,2023-06-05T11:00:00+10:00,2023-06-05,11:00,4,2,6
23,2023-06-05T11:00:00+10:00,2023-06-05,11:00,1,5,6
30,2023-06-05T11:00:00+10:00,2023-06-05,11:00,4,2,6
49,2023-06-05T11:00:00+10:00,2023-06-05,11:00,1,0,1
53,2023-06-05T11:00:00+10:00,2023-06-05,11:00,10,13,23
57,2023-06-05T11:00:00+10:00,2023-06-05,11:00,3,4,7
109,2023-06-05T11:00:00+10:00,2023-06-05,11:00,9,16,25
117,2023-06-05T11:00:00+10:00,2023-06-05,11:00,5,3,8
26,2023-06-05T11:00:00+10:00,2023-06-05,11:00,5,1,6
36,2023-06-05T11:00:00+10:00,2023-06-05,11:00,0,1,1
40,2023-06-05T11:00:00+10:00,2023-06-05,11:00,3,1,4
44,2023-06-05T11:00:00+10:00,2023-06-05,11:00,0,2,2
47,2023-06-05T11:00:00+10:00,2023-06-05,11:00,12,4,16
50,2023-06-05T11:00:00+10:00,2023-06-05,11:00,2,2,4
61,2023-06-05T11:00:00+10:00,2023-06-05,11:00,2,3,5
77,2023-06-05T11:00:00+10:00,2023-06-05,11:00,1,1,2
1,2023-06-05T11:00:00+10:00,2023-06-05,11:00,15,8,23
9,2023-06-05T11:00:00+10:00,2023-06-05,11:00,3,3,6
10,2023-06-05T11:00:00+10:00,2023-06-05,11:00,2,0,2
18,2023-06-05T11:00:00+10:00,2023-06-05,11:00,0,1,1
35,2023-06-05T11:00:00+10:00,2023-06-05,11:00,4,3,7
48,2023-06-05T11:00:00+10:00,2023-06-05,11:00,6,0,6
56,2023-06-05T11:00:00+10:00,2023-06-05,11:00,4,0,4
63,2023-06-05T11:00:00+10:00,2023-06-05,11:00,6,4,10
72,2023-06-05T11:00:00+10:00,2023-06-05,11:00,3,2,5
76,2023-06-05T11:00:00+10:00,2023-06-05,11:00,1,0,1
79,2023-06-05T11:00:00+10:00,2023-06-05,11:00,10,4,14
86,2023-06-05T11:00:00+10:00,2023-06-05,11:00,0,1,1
3,2023-06-05T11:00:00+10:00,2023-06-05,11:00,6,13,19
5,2023-06-05T11:00:00+10:00,2023-06-05,11:00,1,13,14
6,2023-06-05T11:00:00+10:00,2023-06-05,11:00,4,2,6
8,2023-06-05T11:00:00+10:00,2023-06-05,11:00,0,1,1
21,2023-06-05T11:00:00+10:00,2023-06-05,11:00,9,1,10
29,2023-06-05T11:00:00+10:00,2023-06-05,11:00,1,5,6
31,2023-06-05T11:00:00+10:00,2023-06-05,11:00,2,1,3
39,2023-06-05T11:00:00+10:00,2023-06-05,11:00,4,5,9
42,2023-06-05T11:00:00+10:00,2023-06-05,11:00,1,0,1
55,2023-06-05T11:00:00+10:00,2023-06-05,11:00,3,12,15
59,2023-06-05T11:00:00+10:00,2023-06-05,11:00,27,28,55
65,2023-06-05T11:00:00+10:00,2023-06-05,11:00,4,6,10
66,2023-06-05T11:00:00+10:00,2023-06-05,11:00,9,4,13
71,2023-06-05T11:00:00+10:00,2023-06-05,11:00,1,0,1
75,2023-06-05T11:00:00+10:00,2023-06-05,11:00,1,0,1
84,2023-06-05T11:00:00+10:00,2023-06-05,11:00,50,40,90
107,2023-06-05T11:00:00+10:00,2023-06-05,11:00,4,14,18
118,2023-06-05T11:00:00+10:00,2023-06-05,11:00,0,1,1
2,2023-06-05T11:00:00+10:00,2023-06-05,11:00,7,7,14
19,2023-06-05T11:00:00+10:00,2023-06-05,11:00,1,2,3
20,2023-06-05T11:00:00+10:00,2023-06-05,11:00,1,1,2
24,2023-06-05T11:00:00+10:00,2023-06-05,11:00,70,9,79
46,2023-06-05T11:00:00+10:00,2023-06-05,11:00,1,4,5
51,2023-06-05T11:00:00+10:00,2023-06-05,11:00,3,2,5
52,2023-06-05T11:00:00+10:00,2023-06-05,11:00,7,4,11
58,2023-06-05T11:00:00+10:00,2023-06-05,11:00,14,6,20
62,2023-06-05T11:00:00+10:00,2023-06-05,11:00,5,0,5
67,2023-06-05T11:00:00+10:00,2023-06-05,11:00,10,1,11
68,2023-06-05T11:00:00+10:00,2023-06-05,11:00,0,5,5
85,2023-06-05T11:00:00+10:00,2023-06-05,11:00,2,1,3
5,2023-06-05T10:59:00+10:00,2023-06-05,10:59,3,9,12
14,2023-06-05T10:59:00+10:00,2023-06-05,10:59,1,4,5
21,2023-06-05T10:59:00+10:00,2023-06-05,10:59,8,1,9
28,2023-06-05T10:59:00+10:00,2023-06-05,10:59,8,4,12
29,2023-06-05T10:59:00+10:00,2023-06-05,10:59,3,1,4
37,2023-06-05T10:59:00+10:00,2023-06-05,10:59,1,4,5
40,2023-06-05T10:59:00+10:00,2023-06-05,10:59,0,2,2
45,2023-06-05T10:59:00+10:00,2023-06-05,10:59,7,6,13
54,2023-06-05T10:59:00+10:00,2023-06-05,10:59,5,1,6
71,2023-06-05T10:59:00+10:00,2023-06-05,10:59,0,1,1
2,2023-06-05T10:59:00+10:00,2023-06-05,10:59,5,4,9
11,2023-06-05T10:59:00+10:00,2023-06-05,10:59,0,1,1
18,2023-06-05T10:59:00+10:00,2023-06-05,10:59,5,1,6
30,2023-06-05T10:59:00+10:00,2023-06-05,10:59,2,5,7
63,2023-06-05T10:59:00+10:00,2023-06-05,10:59,2,6,8
67,2023-06-05T10:59:00+10:00,2023-06-05,10:59,2,6,8
26,2023-06-05T10:59:00+10:00,2023-06-05,10:59,2,5,7
41,2023-06-05T10:59:00+10:00,2023-06-05,10:59,13,19,32
44,2023-06-05T10:59:00+10:00,2023-06-05,10:59,0,2,2
61,2023-06-05T10:59:00+10:00,2023-06-05,10:59,5,6,11
65,2023-06-05T10:59:00+10:00,2023-06-05,10:59,3,5,8
66,2023-06-05T10:59:00+10:00,2023-06-05,10:59,3,10,13
69,2023-06-05T10:59:00+10:00,2023-06-05,10:59,4,2,6
77,2023-06-05T10:59:00+10:00,2023-06-05,10:59,0,1,1
78,2023-06-05T10:59:00+10:00,2023-06-05,10:59,0,2,2
1,2023-06-05T10:59:00+10:00,2023-06-05,10:59,12,11,23
9,2023-06-05T10:59:00+10:00,2023-06-05,10:59,5,2,7
19,2023-06-05T10:59:00+10:00,2023-06-05,10:59,2,1,3
23,2023-06-05T10:59:00+10:00,2023-06-05,10:59,1,6,7
24,2023-06-05T10:59:00+10:00,2023-06-05,10:59,17,9,26
35,2023-06-05T10:59:00+10:00,2023-06-05,10:59,10,4,14
46,2023-06-05T10:59:00+10:00,2023-06-05,10:59,0,2,2
48,2023-06-05T10:59:00+10:00,2023-06-05,10:59,2,4,6
53,2023-06-05T10:59:00+10:00,2023-06-05,10:59,13,8,21
56,2023-06-05T10:59:00+10:00,2023-06-05,10:59,1,0,1
57,2023-06-05T10:59:00+10:00,2023-06-05,10:59,1,1,2
68,2023-06-05T10:59:00+10:00,2023-06-05,10:59,3,3,6
72,2023-06-05T10:59:00+10:00,2023-06-05,10:59,2,2,4
76,2023-06-05T10:59:00+10:00,2023-06-05,10:59,1,1,2
3,2023-06-05T10:59:00+10:00,2023-06-05,10:59,9,10,19
4,2023-06-05T10:59:00+10:00,2023-06-05,10:59,19,11,30
6,2023-06-05T10:59:00+10:00,2023-06-05,10:59,6,4,10
31,2023-06-05T10:59:00+10:00,2023-06-05,10:59,0,5,5
36,2023-06-05T10:59:00+10:00,2023-06-05,10:59,0,2,2
42,2023-06-05T10:59:00+10:00,2023-06-05,10:59,0,1,1
47,2023-06-05T10:59:00+10:00,2023-06-05,10:59,4,10,14
50,2023-06-05T10:59:00+10:00,2023-06-05,10:59,0,2,2
55,2023-06-05T10:59:00+10:00,2023-06-05,10:59,5,6,11
70,2023-06-05T10:59:00+10:00,2023-06-05,10:59,3,2,5
108,2023-06-05T10:59:00+10:00,2023-06-05,10:59,3,4,7
10,2023-06-05T10:59:00+10:00,2023-06-05,10:59,1,4,5
51,2023-06-05T10:59:00+10:00,2023-06-05,10:59,1,2,3
52,2023-06-05T10:59:00+10:00,2023-06-05,10:59,7,1,8
58,2023-06-05T10:59:00+10:00,2023-06-05,10:59,2,2,4
79,2023-06-05T10:59:00+10:00,2023-06-05,10:59,12,1,13
85,2023-06-05T10:59:00+10:00,2023-06-05,10:59,0,4,4
86,2023-06-05T10:59:00+10:00,2023-06-05,10:59,0,2,2
4,2023-06-05T10:58:00+10:00,2023-06-05,10:58,17,6,23
28,2023-06-05T10:58:00+10:00,2023-06-05,10:58,4,1,5
37,2023-06-05T10:58:00+10:00,2023-06-05,10:58,0,2,2
40,2023-06-05T10:58:00+10:00,2023-06-05,10:58,5,1,6
50,2023-06-05T10:58:00+10:00,2023-06-05,10:58,1,4,5
55,2023-06-05T10:58:00+10:00,2023-06-05,10:58,11,9,20
61,2023-06-05T10:58:00+10:00,2023-06-05,10:58,0,6,6
65,2023-06-05T10:58:00+10:00,2023-06-05,10:58,2,3,5
70,2023-06-05T10:58:00+10:00,2023-06-05,10:58,1,0,1
77,2023-06-05T10:58:00+10:00,2023-06-05,10:58,5,3,8
87,2023-06-05T10:58:00+10:00,2023-06-05,10:58,0,2,2
108,2023-06-05T10:58:00+10:00,2023-06-05,10:58,4,5,9
1,2023-06-05T10:58:00+10:00,2023-06-05,10:58,6,12,18
9,2023-06-05T10:58:00+10:00,2023-06-05,10:58,8,1,9
17,2023-06-05T10:58:00+10:00,2023-06-05,10:58,4,5,9
52,2023-06-05T10:58:00+10:00,2023-06-05,10:58,3,2,5
57,2023-06-05T10:58:00+10:00,2023-06-05,10:58,4,3,7
62,2023-06-05T10:58:00+10:00,2023-06-05,10:58,3,0,3
63,2023-06-05T10:58:00+10:00,2023-06-05,10:58,0,1,1
72,2023-06-05T10:58:00+10:00,2023-06-05,10:58,3,1,4
86,2023-06-05T10:58:00+10:00,2023-06-05,10:58,0,1,1
8,2023-06-05T10:58:00+10:00,2023-06-05,10:58,0,3,3
21,2023-06-05T10:58:00+10:00,2023-06-05,10:58,2,1,3
29,2023-06-05T10:58:00+10:00,2023-06-05,10:58,1,0,1
36,2023-06-05T10:58:00+10:00,2023-06-05,10:58,2,0,2
41,2023-06-05T10:58:00+10:00,2023-06-05,10:58,34,3,37
42,2023-06-05T10:58:00+10:00,2023-06-05,10:58,1,0,1
45,2023-06-05T10:58:00+10:00,2023-06-05,10:58,6,1,7
47,2023-06-05T10:58:00+10:00,2023-06-05,10:58,17,9,26
71,2023-06-05T10:58:00+10:00,2023-06-05,10:58,0,1,1
78,2023-06-05T10:58:00+10:00,2023-06-05,10:58,0,1,1
18,2023-06-05T10:58:00+10:00,2023-06-05,10:58,2,3,5
23,2023-06-05T10:58:00+10:00,2023-06-05,10:58,1,0,1
30,2023-06-05T10:58:00+10:00,2023-06-05,10:58,2,6,8
35,2023-06-05T10:58:00+10:00,2023-06-05,10:58,9,3,12
51,2023-06-05T10:58:00+10:00,2023-06-05,10:58,3,0,3
53,2023-06-05T10:58:00+10:00,2023-06-05,10:58,7,7,14
58,2023-06-05T10:58:00+10:00,2023-06-05,10:58,10,2,12
67,2023-06-05T10:58:00+10:00,2023-06-05,10:58,1,5,6
68,2023-06-05T10:58:00+10:00,2023-06-05,10:58,7,2,9
76,2023-06-05T10:58:00+10:00,2023-06-05,10:58,1,0,1
79,2023-06-05T10:58:00+10:00,2023-06-05,10:58,5,9,14
3,2023-06-05T10:58:00+10:00,2023-06-05,10:58,1,1,2
5,2023-06-05T10:58:00+10:00,2023-06-05,10:58,5,11,16
6,2023-06-05T10:58:00+10:00,2023-06-05,10:58,10,10,20
26,2023-06-05T10:58:00+10:00,2023-06-05,10:58,2,5,7
31,2023-06-05T10:58:00+10:00,2023-06-05,10:58,1,3,4
44,2023-06-05T10:58:00+10:00,2023-06-05,10:58,0,1,1
54,2023-06-05T10:58:00+10:00,2023-06-05,10:58,2,1,3
66,2023-06-05T10:58:00+10:00,2023-06-05,10:58,4,3,7
69,2023-06-05T10:58:00+10:00,2023-06-05,10:58,3,4,7
75,2023-06-05T10:58:00+10:00,2023-06-05,10:58,1,0,1
2,2023-06-05T10:58:00+10:00,2023-06-05,10:58,7,8,15
10,2023-06-05T10:58:00+10:00,2023-06-05,10:58,5,0,5
11,2023-06-05T10:58:00+10:00,2023-06-05,10:58,0,1,1
12,2023-06-05T10:58:00+10:00,2023-06-05,10:58,3,0,3
19,2023-06-05T10:58:00+10:00,2023-06-05,10:58,5,1,6
20,2023-06-05T10:58:00+10:00,2023-06-05,10:58,2,6,8
24,2023-06-05T10:58:00+10:00,2023-06-05,10:58,19,5,24
46,2023-06-05T10:58:00+10:00,2023-06-05,10:58,0,3,3
56,2023-06-05T10:58:00+10:00,2023-06-05,10:58,1,0,1
85,2023-06-05T10:58:00+10:00,2023-06-05,10:58,3,1,4
8,2023-06-05T10:57:00+10:00,2023-06-05,10:57,2,2,4
21,2023-06-05T10:57:00+10:00,2023-06-05,10:57,2,4,6
42,2023-06-05T10:57:00+10:00,2023-06-05,10:57,0,1,1
44,2023-06-05T10:57:00+10:00,2023-06-05,10:57,0,1,1
47,2023-06-05T10:57:00+10:00,2023-06-05,10:57,9,9,18
66,2023-06-05T10:57:00+10:00,2023-06-05,10:57,7,20,27
70,2023-06-05T10:57:00+10:00,2023-06-05,10:57,1,3,4
77,2023-06-05T10:57:00+10:00,2023-06-05,10:57,0,1,1
78,2023-06-05T10:57:00+10:00,2023-06-05,10:57,0,1,1
11,2023-06-05T10:57:00+10:00,2023-06-05,10:57,0,1,1
12,2023-06-05T10:57:00+10:00,2023-06-05,10:57,2,4,6
19,2023-06-05T10:57:00+10:00,2023-06-05,10:57,3,1,4
23,2023-06-05T10:57:00+10:00,2023-06-05,10:57,1,4,5
24,2023-06-05T10:57:00+10:00,2023-06-05,10:57,4,7,11
56,2023-06-05T10:57:00+10:00,2023-06-05,10:57,3,4,7
68,2023-06-05T10:57:00+10:00,2023-06-05,10:57,8,4,12
4,2023-06-05T10:57:00+10:00,2023-06-05,10:57,21,13,34
6,2023-06-05T10:57:00+10:00,2023-06-05,10:57,6,4,10
26,2023-06-05T10:57:00+10:00,2023-06-05,10:57,1,5,6
50,2023-06-05T10:57:00+10:00,2023-06-05,10:57,2,4,6
65,2023-06-05T10:57:00+10:00,2023-06-05,10:57,13,9,22
69,2023-06-05T10:57:00+10:00,2023-06-05,10:57,1,1,2
9,2023-06-05T10:57:00+10:00,2023-06-05,10:57,3,7,10
18,2023-06-05T10:57:00+10:00,2023-06-05,10:57,3,3,6
20,2023-06-05T10:57:00+10:00,2023-06-05,10:57,2,0,2
35,2023-06-05T10:57:00+10:00,2023-06-05,10:57,8,7,15
52,2023-06-05T10:57:00+10:00,2023-06-05,10:57,2,5,7
53,2023-06-05T10:57:00+10:00,2023-06-05,10:57,7,7,14
58,2023-06-05T10:57:00+10:00,2023-06-05,10:57,13,0,13
62,2023-06-05T10:57:00+10:00,2023-06-05,10:57,3,2,5
67,2023-06-05T10:57:00+10:00,2023-06-05,10:57,5,9,14
72,2023-06-05T10:57:00+10:00,2023-06-05,10:57,1,16,17
76,2023-06-05T10:57:00+10:00,2023-06-05,10:57,0,1,1
79,2023-06-05T10:57:00+10:00,2023-06-05,10:57,6,4,10
85,2023-06-05T10:57:00+10:00,2023-06-05,10:57,5,0,5
3,2023-06-05T10:57:00+10:00,2023-06-05,10:57,5,9,14
5,2023-06-05T10:57:00+10:00,2023-06-05,10:57,4,6,10
14,2023-06-05T10:57:00+10:00,2023-06-05,10:57,5,0,5
28,2023-06-05T10:57:00+10:00,2023-06-05,10:57,5,4,9
29,2023-06-05T10:57:00+10:00,2023-06-05,10:57,1,1,2
36,2023-06-05T10:57:00+10:00,2023-06-05,10:57,1,0,1
37,2023-06-05T10:57:00+10:00,2023-06-05,10:57,2,3,5
39,2023-06-05T10:57:00+10:00,2023-06-05,10:57,2,1,3
40,2023-06-05T10:57:00+10:00,2023-06-05,10:57,1,8,9
41,2023-06-05T10:57:00+10:00,2023-06-05,10:57,30,13,43
45,2023-06-05T10:57:00+10:00,2023-06-05,10:57,4,1,5
55,2023-06-05T10:57:00+10:00,2023-06-05,10:57,14,7,21
61,2023-06-05T10:57:00+10:00,2023-06-05,10:57,4,5,9
75,2023-06-05T10:57:00+10:00,2023-06-05,10:57,3,3,6
108,2023-06-05T10:57:00+10:00,2023-06-05,10:57,3,4,7
1,2023-06-05T10:57:00+10:00,2023-06-05,10:57,7,10,17
2,2023-06-05T10:57:00+10:00,2023-06-05,10:57,1,8,9
10,2023-06-05T10:57:00+10:00,2023-06-05,10:57,1,0,1
17,2023-06-05T10:57:00+10:00,2023-06-05,10:57,1,0,1
27,2023-06-05T10:57:00+10:00,2023-06-05,10:57,0,6,6
30,2023-06-05T10:57:00+10:00,2023-06-05,10:57,0,3,3
46,2023-06-05T10:57:00+10:00,2023-06-05,10:57,1,3,4
48,2023-06-05T10:57:00+10:00,2023-06-05,10:57,6,0,6
49,2023-06-05T10:57:00+10:00,2023-06-05,10:57,0,2,2
57,2023-06-05T10:57:00+10:00,2023-06-05,10:57,3,2,5
63,2023-06-05T10:57:00+10:00,2023-06-05,10:57,7,3,10
86,2023-06-05T10:57:00+10:00,2023-06-05,10:57,1,2,3
3,2023-06-05T10:56:00+10:00,2023-06-05,10:56,4,7,11
6,2023-06-05T10:56:00+10:00,2023-06-05,10:56,3,2,5
21,2023-06-05T10:56:00+10:00,2023-06-05,10:56,1,1,2
28,2023-06-05T10:56:00+10:00,2023-06-05,10:56,4,1,5
44,2023-06-05T10:56:00+10:00,2023-06-05,10:56,1,0,1
45,2023-06-05T10:56:00+10:00,2023-06-05,10:56,6,6,12
50,2023-06-05T10:56:00+10:00,2023-06-05,10:56,1,3,4
54,2023-06-05T10:56:00+10:00,2023-06-05,10:56,1,0,1
55,2023-06-05T10:56:00+10:00,2023-06-05,10:56,6,4,10
61,2023-06-05T10:56:00+10:00,2023-06-05,10:56,1,5,6
65,2023-06-05T10:56:00+10:00,2023-06-05,10:56,1,8,9
78,2023-06-05T10:56:00+10:00,2023-06-05,10:56,0,5,5
87,2023-06-05T10:56:00+10:00,2023-06-05,10:56,2,0,2
12,2023-06-05T10:56:00+10:00,2023-06-05,10:56,3,0,3
27,2023-06-05T10:56:00+10:00,2023-06-05,10:56,1,1,2
30,2023-06-05T10:56:00+10:00,2023-06-05,10:56,2,0,2
35,2023-06-05T10:56:00+10:00,2023-06-05,10:56,8,5,13
46,2023-06-05T10:56:00+10:00,2023-06-05,10:56,0,3,3
52,2023-06-05T10:56:00+10:00,2023-06-05,10:56,5,4,9
57,2023-06-05T10:56:00+10:00,2023-06-05,10:56,2,6,8
63,2023-06-05T10:56:00+10:00,2023-06-05,10:56,9,3,12
79,2023-06-05T10:56:00+10:00,2023-06-05,10:56,13,5,18
85,2023-06-05T10:56:00+10:00,2023-06-05,10:56,2,0,2
8,2023-06-05T10:56:00+10:00,2023-06-05,10:56,1,3,4
31,2023-06-05T10:56:00+10:00,2023-06-05,10:56,3,1,4
37,2023-06-05T10:56:00+10:00,2023-06-05,10:56,0,4,4
40,2023-06-05T10:56:00+10:00,2023-06-05,10:56,2,2,4
47,2023-06-05T10:56:00+10:00,2023-06-05,10:56,7,8,15
66,2023-06-05T10:56:00+10:00,2023-06-05,10:56,2,15,17
1,2023-06-05T10:56:00+10:00,2023-06-05,10:56,12,7,19
2,2023-06-05T10:56:00+10:00,2023-06-05,10:56,2,1,3
11,2023-06-05T10:56:00+10:00,2023-06-05,10:56,4,0,4
17,2023-06-05T10:56:00+10:00,2023-06-05,10:56,6,3,9
18,2023-06-05T10:56:00+10:00,2023-06-05,10:56,0,2,2
23,2023-06-05T10:56:00+10:00,2023-06-05,10:56,5,2,7
49,2023-06-05T10:56:00+10:00,2023-06-05,10:56,4,1,5
53,2023-06-05T10:56:00+10:00,2023-06-05,10:56,10,3,13
67,2023-06-05T10:56:00+10:00,2023-06-05,10:56,10,5,15
68,2023-06-05T10:56:00+10:00,2023-06-05,10:56,5,3,8
72,2023-06-05T10:56:00+10:00,2023-06-05,10:56,3,2,5
4,2023-06-05T10:56:00+10:00,2023-06-05,10:56,14,8,22
5,2023-06-05T10:56:00+10:00,2023-06-05,10:56,7,6,13
14,2023-06-05T10:56:00+10:00,2023-06-05,10:56,0,1,1
26,2023-06-05T10:56:00+10:00,2023-06-05,10:56,4,4,8
29,2023-06-05T10:56:00+10:00,2023-06-05,10:56,3,1,4
36,2023-06-05T10:56:00+10:00,2023-06-05,10:56,3,2,5
39,2023-06-05T10:56:00+10:00,2023-06-05,10:56,2,1,3
41,2023-06-05T10:56:00+10:00,2023-06-05,10:56,17,14,31
42,2023-06-05T10:56:00+10:00,2023-06-05,10:56,4,1,5
69,2023-06-05T10:56:00+10:00,2023-06-05,10:56,1,1,2
75,2023-06-05T10:56:00+10:00,2023-06-05,10:56,1,0,1
77,2023-06-05T10:56:00+10:00,2023-06-05,10:56,2,0,2
108,2023-06-05T10:56:00+10:00,2023-06-05,10:56,3,3,6
9,2023-06-05T10:56:00+10:00,2023-06-05,10:56,1,11,12
10,2023-06-05T10:56:00+10:00,2023-06-05,10:56,2,1,3
19,2023-06-05T10:56:00+10:00,2023-06-05,10:56,4,4,8
20,2023-06-05T10:56:00+10:00,2023-06-05,10:56,0,11,11
24,2023-06-05T10:56:00+10:00,2023-06-05,10:56,14,2,16
48,2023-06-05T10:56:00+10:00,2023-06-05,10:56,6,2,8
51,2023-06-05T10:56:00+10:00,2023-06-05,10:56,2,0,2
56,2023-06-05T10:56:00+10:00,2023-06-05,10:56,1,1,2
58,2023-06-05T10:56:00+10:00,2023-06-05,10:56,14,2,16
62,2023-06-05T10:56:00+10:00,2023-06-05,10:56,3,0,3
76,2023-06-05T10:56:00+10:00,2023-06-05,10:56,2,0,2
86,2023-06-05T10:56:00+10:00,2023-06-05,10:56,2,0,2
14,2023-06-05T10:55:00+10:00,2023-06-05,10:55,1,1,2
26,2023-06-05T10:55:00+10:00,2023-06-05,10:55,2,2,4
31,2023-06-05T10:55:00+10:00,2023-06-05,10:55,4,0,4
40,2023-06-05T10:55:00+10:00,2023-06-05,10:55,1,2,3
42,2023-06-05T10:55:00+10:00,2023-06-05,10:55,2,1,3
59,2023-06-05T10:55:00+10:00,2023-06-05,10:55,32,24,56
65,2023-06-05T10:55:00+10:00,2023-06-05,10:55,3,1,4
71,2023-06-05T10:55:00+10:00,2023-06-05,10:55,1,1,2
77,2023-06-05T10:55:00+10:00,2023-06-05,10:55,4,2,6
78,2023-06-05T10:55:00+10:00,2023-06-05,10:55,1,0,1
107,2023-06-05T10:55:00+10:00,2023-06-05,10:55,20,6,26
9,2023-06-05T10:55:00+10:00,2023-06-05,10:55,9,0,9
12,2023-06-05T10:55:00+10:00,2023-06-05,10:55,0,6,6
27,2023-06-05T10:55:00+10:00,2023-06-05,10:55,0,1,1
35,2023-06-05T10:55:00+10:00,2023-06-05,10:55,6,5,11
48,2023-06-05T10:55:00+10:00,2023-06-05,10:55,1,0,1
51,2023-06-05T10:55:00+10:00,2023-06-05,10:55,4,3,7
53,2023-06-05T10:55:00+10:00,2023-06-05,10:55,7,4,11
62,2023-06-05T10:55:00+10:00,2023-06-05,10:55,1,1,2
67,2023-06-05T10:55:00+10:00,2023-06-05,10:55,3,10,13
72,2023-06-05T10:55:00+10:00,2023-06-05,10:55,1,4,5
4,2023-06-05T10:55:00+10:00,2023-06-05,10:55,23,6,29
6,2023-06-05T10:55:00+10:00,2023-06-05,10:55,2,2,4
28,2023-06-05T10:55:00+10:00,2023-06-05,10:55,9,2,11
37,2023-06-05T10:55:00+10:00,2023-06-05,10:55,1,0,1
39,2023-06-05T10:55:00+10:00,2023-06-05,10:55,2,0,2
47,2023-06-05T10:55:00+10:00,2023-06-05,10:55,10,7,17
50,2023-06-05T10:55:00+10:00,2023-06-05,10:55,1,3,4
55,2023-06-05T10:55:00+10:00,2023-06-05,10:55,7,11,18
61,2023-06-05T10:55:00+10:00,2023-06-05,10:55,8,4,12
66,2023-06-05T10:55:00+10:00,2023-06-05,10:55,10,10,20
70,2023-06-05T10:55:00+10:00,2023-06-05,10:55,5,1,6
87,2023-06-05T10:55:00+10:00,2023-06-05,10:55,0,2,2
108,2023-06-05T10:55:00+10:00,2023-06-05,10:55,7,6,13
118,2023-06-05T10:55:00+10:00,2023-06-05,10:55,4,0,4
2,2023-06-05T10:55:00+10:00,2023-06-05,10:55,3,3,6
10,2023-06-05T10:55:00+10:00,2023-06-05,10:55,0,1,1
11,2023-06-05T10:55:00+10:00,2023-06-05,10:55,1,1,2
17,2023-06-05T10:55:00+10:00,2023-06-05,10:55,2,3,5
18,2023-06-05T10:55:00+10:00,2023-06-05,10:55,5,10,15
30,2023-06-05T10:55:00+10:00,2023-06-05,10:55,4,6,10
52,2023-06-05T10:55:00+10:00,2023-06-05,10:55,2,3,5
63,2023-06-05T10:55:00+10:00,2023-06-05,10:55,2,3,5
68,2023-06-05T10:55:00+10:00,2023-06-05,10:55,0,1,1
79,2023-06-05T10:55:00+10:00,2023-06-05,10:55,2,6,8
86,2023-06-05T10:55:00+10:00,2023-06-05,10:55,1,2,3
109,2023-06-05T10:55:00+10:00,2023-06-05,10:55,6,13,19
3,2023-06-05T10:55:00+10:00,2023-06-05,10:55,3,11,14
5,2023-06-05T10:55:00+10:00,2023-06-05,10:55,10,9,19
8,2023-06-05T10:55:00+10:00,2023-06-05,10:55,2,0,2
21,2023-06-05T10:55:00+10:00,2023-06-05,10:55,1,6,7
29,2023-06-05T10:55:00+10:00,2023-06-05,10:55,0,2,2
36,2023-06-05T10:55:00+10:00,2023-06-05,10:55,3,4,7
41,2023-06-05T10:55:00+10:00,2023-06-05,10:55,19,13,32
44,2023-06-05T10:55:00+10:00,2023-06-05,10:55,0,4,4
45,2023-06-05T10:55:00+10:00,2023-06-05,10:55,3,8,11
54,2023-06-05T10:55:00+10:00,2023-06-05,10:55,1,0,1
69,2023-06-05T10:55:00+10:00,2023-06-05,10:55,1,0,1
84,2023-06-05T10:55:00+10:00,2023-06-05,10:55,46,42,88
1,2023-06-05T10:55:00+10:00,2023-06-05,10:55,6,9,15
19,2023-06-05T10:55:00+10:00,2023-06-05,10:55,8,0,8
20,2023-06-05T10:55:00+10:00,2023-06-05,10:55,5,2,7
23,2023-06-05T10:55:00+10:00,2023-06-05,10:55,1,3,4
24,2023-06-05T10:55:00+10:00,2023-06-05,10:55,10,1,11
49,2023-06-05T10:55:00+10:00,2023-06-05,10:55,1,1,2
56,2023-06-05T10:55:00+10:00,2023-06-05,10:55,1,2,3
57,2023-06-05T10:55:00+10:00,2023-06-05,10:55,1,3,4
58,2023-06-05T10:55:00+10:00,2023-06-05,10:55,27,2,29
76,2023-06-05T10:55:00+10:00,2023-06-05,10:55,1,0,1
117,2023-06-05T10:55:00+10:00,2023-06-05,10:55,9,7,16
6,2023-06-05T10:54:00+10:00,2023-06-05,10:54,7,3,10
8,2023-06-05T10:54:00+10:00,2023-06-05,10:54,0,2,2
21,2023-06-05T10:54:00+10:00,2023-06-05,10:54,0,2,2
36,2023-06-05T10:54:00+10:00,2023-06-05,10:54,5,1,6
65,2023-06-05T10:54:00+10:00,2023-06-05,10:54,14,1,15
70,2023-06-05T10:54:00+10:00,2023-06-05,10:54,0,1,1
75,2023-06-05T10:54:00+10:00,2023-06-05,10:54,0,2,2
87,2023-06-05T10:54:00+10:00,2023-06-05,10:54,1,2,3
1,2023-06-05T10:54:00+10:00,2023-06-05,10:54,6,8,14
17,2023-06-05T10:54:00+10:00,2023-06-05,10:54,3,6,9
27,2023-06-05T10:54:00+10:00,2023-06-05,10:54,2,3,5
53,2023-06-05T10:54:00+10:00,2023-06-05,10:54,8,3,11
62,2023-06-05T10:54:00+10:00,2023-06-05,10:54,1,0,1
3,2023-06-05T10:54:00+10:00,2023-06-05,10:54,7,7,14
14,2023-06-05T10:54:00+10:00,2023-06-05,10:54,2,0,2
31,2023-06-05T10:54:00+10:00,2023-06-05,10:54,1,1,2
39,2023-06-05T10:54:00+10:00,2023-06-05,10:54,4,2,6
42,2023-06-05T10:54:00+10:00,2023-06-05,10:54,2,5,7
45,2023-06-05T10:54:00+10:00,2023-06-05,10:54,2,6,8
69,2023-06-05T10:54:00+10:00,2023-06-05,10:54,2,0,2
71,2023-06-05T10:54:00+10:00,2023-06-05,10:54,1,0,1
77,2023-06-05T10:54:00+10:00,2023-06-05,10:54,0,1,1
108,2023-06-05T10:54:00+10:00,2023-06-05,10:54,2,7,9
9,2023-06-05T10:54:00+10:00,2023-06-05,10:54,2,1,3
18,2023-06-05T10:54:00+10:00,2023-06-05,10:54,2,4,6
19,2023-06-05T10:54:00+10:00,2023-06-05,10:54,7,3,10
30,2023-06-05T10:54:00+10:00,2023-06-05,10:54,4,3,7
35,2023-06-05T10:54:00+10:00,2023-06-05,10:54,10,4,14
46,2023-06-05T10:54:00+10:00,2023-06-05,10:54,2,4,6
58,2023-06-05T10:54:00+10:00,2023-06-05,10:54,2,7,9
67,2023-06-05T10:54:00+10:00,2023-06-05,10:54,6,6,12
72,2023-06-05T10:54:00+10:00,2023-06-05,10:54,1,0,1
79,2023-06-05T10:54:00+10:00,2023-06-05,10:54,1,5,6
85,2023-06-05T10:54:00+10:00,2023-06-05,10:54,0,2,2
4,2023-06-05T10:54:00+10:00,2023-06-05,10:54,17,19,36
5,2023-06-05T10:54:00+10:00,2023-06-05,10:54,2,6,8
26,2023-06-05T10:54:00+10:00,2023-06-05,10:54,5,2,7
28,2023-06-05T10:54:00+10:00,2023-06-05,10:54,15,3,18
40,2023-06-05T10:54:00+10:00,2023-06-05,10:54,1,9,10
41,2023-06-05T10:54:00+10:00,2023-06-05,10:54,16,12,28
47,2023-06-05T10:54:00+10:00,2023-06-05,10:54,8,10,18
50,2023-06-05T10:54:00+10:00,2023-06-05,10:54,2,2,4
55,2023-06-05T10:54:00+10:00,2023-06-05,10:54,1,15,16
61,2023-06-05T10:54:00+10:00,2023-06-05,10:54,0,6,6
66,2023-06-05T10:54:00+10:00,2023-06-05,10:54,6,8,14
2,2023-06-05T10:54:00+10:00,2023-06-05,10:54,13,14,27
11,2023-06-05T10:54:00+10:00,2023-06-05,10:54,1,0,1
20,2023-06-05T10:54:00+10:00,2023-06-05,10:54,5,2,7
23,2023-06-05T10:54:00+10:00,2023-06-05,10:54,3,2,5
24,2023-06-05T10:54:00+10:00,2023-06-05,10:54,8,7,15
52,2023-06-05T10:54:00+10:00,2023-06-05,10:54,2,4,6
56,2023-06-05T10:54:00+10:00,2023-06-05,10:54,6,2,8
57,2023-06-05T10:54:00+10:00,2023-06-05,10:54,1,3,4
63,2023-06-05T10:54:00+10:00,2023-06-05,10:54,1,1,2
68,2023-06-05T10:54:00+10:00,2023-06-05,10:54,1,2,3
76,2023-06-05T10:54:00+10:00,2023-06-05,10:54,3,1,4
86,2023-06-05T10:54:00+10:00,2023-06-05,10:54,3,1,4
3,2023-06-05T10:53:00+10:00,2023-06-05,10:53,8,13,21
21,2023-06-05T10:53:00+10:00,2023-06-05,10:53,10,6,16
36,2023-06-05T10:53:00+10:00,2023-06-05,10:53,1,3,4
41,2023-06-05T10:53:00+10:00,2023-06-05,10:53,13,19,32
50,2023-06-05T10:53:00+10:00,2023-06-05,10:53,0,1,1
65,2023-06-05T10:53:00+10:00,2023-06-05,10:53,0,4,4
69,2023-06-05T10:53:00+10:00,2023-06-05,10:53,0,2,2
17,2023-06-05T10:53:00+10:00,2023-06-05,10:53,7,7,14
27,2023-06-05T10:53:00+10:00,2023-06-05,10:53,1,0,1
30,2023-06-05T10:53:00+10:00,2023-06-05,10:53,6,1,7
51,2023-06-05T10:53:00+10:00,2023-06-05,10:53,0,1,1
62,2023-06-05T10:53:00+10:00,2023-06-05,10:53,2,1,3
79,2023-06-05T10:53:00+10:00,2023-06-05,10:53,6,3,9
6,2023-06-05T10:53:00+10:00,2023-06-05,10:53,4,2,6
8,2023-06-05T10:53:00+10:00,2023-06-05,10:53,1,0,1
14,2023-06-05T10:53:00+10:00,2023-06-05,10:53,4,1,5
26,2023-06-05T10:53:00+10:00,2023-06-05,10:53,1,2,3
28,2023-06-05T10:53:00+10:00,2023-06-05,10:53,12,1,13
40,2023-06-05T10:53:00+10:00,2023-06-05,10:53,3,0,3
42,2023-06-05T10:53:00+10:00,2023-06-05,10:53,0,2,2
45,2023-06-05T10:53:00+10:00,2023-06-05,10:53,9,9,18
47,2023-06-05T10:53:00+10:00,2023-06-05,10:53,5,10,15
54,2023-06-05T10:53:00+10:00,2023-06-05,10:53,3,2,5
70,2023-06-05T10:53:00+10:00,2023-06-05,10:53,1,2,3
75,2023-06-05T10:53:00+10:00,2023-06-05,10:53,0,1,1
87,2023-06-05T10:53:00+10:00,2023-06-05,10:53,1,0,1
1,2023-06-05T10:53:00+10:00,2023-06-05,10:53,4,10,14
11,2023-06-05T10:53:00+10:00,2023-06-05,10:53,1,3,4
19,2023-06-05T10:53:00+10:00,2023-06-05,10:53,2,3,5
23,2023-06-05T10:53:00+10:00,2023-06-05,10:53,3,4,7
24,2023-06-05T10:53:00+10:00,2023-06-05,10:53,12,4,16
46,2023-06-05T10:53:00+10:00,2023-06-05,10:53,0,1,1
48,2023-06-05T10:53:00+10:00,2023-06-05,10:53,5,2,7
52,2023-06-05T10:53:00+10:00,2023-06-05,10:53,3,3,6
53,2023-06-05T10:53:00+10:00,2023-06-05,10:53,15,6,21
58,2023-06-05T10:53:00+10:00,2023-06-05,10:53,12,4,16
67,2023-06-05T10:53:00+10:00,2023-06-05,10:53,2,7,9
68,2023-06-05T10:53:00+10:00,2023-06-05,10:53,2,3,5
85,2023-06-05T10:53:00+10:00,2023-06-05,10:53,3,1,4
4,2023-06-05T10:53:00+10:00,2023-06-05,10:53,15,7,22
5,2023-06-05T10:53:00+10:00,2023-06-05,10:53,4,4,8
29,2023-06-05T10:53:00+10:00,2023-06-05,10:53,0,3,3
31,2023-06-05T10:53:00+10:00,2023-06-05,10:53,3,1,4
37,2023-06-05T10:53:00+10:00,2023-06-05,10:53,1,0,1
39,2023-06-05T10:53:00+10:00,2023-06-05,10:53,1,0,1
44,2023-06-05T10:53:00+10:00,2023-06-05,10:53,0,1,1
55,2023-06-05T10:53:00+10:00,2023-06-05,10:53,7,7,14
61,2023-06-05T10:53:00+10:00,2023-06-05,10:53,1,0,1
66,2023-06-05T10:53:00+10:00,2023-06-05,10:53,2,6,8
77,2023-06-05T10:53:00+10:00,2023-06-05,10:53,1,0,1
108,2023-06-05T10:53:00+10:00,2023-06-05,10:53,3,3,6
2,2023-06-05T10:53:00+10:00,2023-06-05,10:53,4,6,10
9,2023-06-05T10:53:00+10:00,2023-06-05,10:53,4,6,10
10,2023-06-05T10:53:00+10:00,2023-06-05,10:53,1,0,1
18,2023-06-05T10:53:00+10:00,2023-06-05,10:53,4,4,8
35,2023-06-05T10:53:00+10:00,2023-06-05,10:53,7,6,13
49,2023-06-05T10:53:00+10:00,2023-06-05,10:53,1,1,2
56,2023-06-05T10:53:00+10:00,2023-06-05,10:53,11,3,14
57,2023-06-05T10:53:00+10:00,2023-06-05,10:53,2,2,4
63,2023-06-05T10:53:00+10:00,2023-06-05,10:53,1,8,9
72,2023-06-05T10:53:00+10:00,2023-06-05,10:53,3,6,9
76,2023-06-05T10:53:00+10:00,2023-06-05,10:53,1,0,1
5,2023-06-05T10:52:00+10:00,2023-06-05,10:52,3,12,15
21,2023-06-05T10:52:00+10:00,2023-06-05,10:52,4,3,7
31,2023-06-05T10:52:00+10:00,2023-06-05,10:52,1,0,1
36,2023-06-05T10:52:00+10:00,2023-06-05,10:52,5,1,6
42,2023-06-05T10:52:00+10:00,2023-06-05,10:52,2,6,8
50,2023-06-05T10:52:00+10:00,2023-06-05,10:52,4,0,4
54,2023-06-05T10:52:00+10:00,2023-06-05,10:52,1,3,4
61,2023-06-05T10:52:00+10:00,2023-06-05,10:52,3,3,6
65,2023-06-05T10:52:00+10:00,2023-06-05,10:52,4,0,4
70,2023-06-05T10:52:00+10:00,2023-06-05,10:52,5,4,9
78,2023-06-05T10:52:00+10:00,2023-06-05,10:52,0,1,1
1,2023-06-05T10:52:00+10:00,2023-06-05,10:52,13,13,26
11,2023-06-05T10:52:00+10:00,2023-06-05,10:52,3,1,4
12,2023-06-05T10:52:00+10:00,2023-06-05,10:52,0,2,2
23,2023-06-05T10:52:00+10:00,2023-06-05,10:52,1,2,3
35,2023-06-05T10:52:00+10:00,2023-06-05,10:52,6,5,11
51,2023-06-05T10:52:00+10:00,2023-06-05,10:52,1,0,1
56,2023-06-05T10:52:00+10:00,2023-06-05,10:52,16,0,16
79,2023-06-05T10:52:00+10:00,2023-06-05,10:52,4,3,7
86,2023-06-05T10:52:00+10:00,2023-06-05,10:52,2,1,3
6,2023-06-05T10:52:00+10:00,2023-06-05,10:52,0,7,7
29,2023-06-05T10:52:00+10:00,2023-06-05,10:52,0,2,2
40,2023-06-05T10:52:00+10:00,2023-06-05,10:52,2,1,3
44,2023-06-05T10:52:00+10:00,2023-06-05,10:52,0,1,1
66,2023-06-05T10:52:00+10:00,2023-06-05,10:52,5,6,11
71,2023-06-05T10:52:00+10:00,2023-06-05,10:52,1,1,2
108,2023-06-05T10:52:00+10:00,2023-06-05,10:52,5,5,10
2,2023-06-05T10:52:00+10:00,2023-06-05,10:52,5,6,11
10,2023-06-05T10:52:00+10:00,2023-06-05,10:52,4,0,4
18,2023-06-05T10:52:00+10:00,2023-06-05,10:52,4,3,7
27,2023-06-05T10:52:00+10:00,2023-06-05,10:52,3,2,5
30,2023-06-05T10:52:00+10:00,2023-06-05,10:52,6,3,9
46,2023-06-05T10:52:00+10:00,2023-06-05,10:52,1,1,2
49,2023-06-05T10:52:00+10:00,2023-06-05,10:52,2,0,2
52,2023-06-05T10:52:00+10:00,2023-06-05,10:52,5,1,6
53,2023-06-05T10:52:00+10:00,2023-06-05,10:52,7,7,14
62,2023-06-05T10:52:00+10:00,2023-06-05,10:52,2,0,2
3,2023-06-05T10:52:00+10:00,2023-06-05,10:52,6,24,30
4,2023-06-05T10:52:00+10:00,2023-06-05,10:52,19,9,28
26,2023-06-05T10:52:00+10:00,2023-06-05,10:52,4,2,6
28,2023-06-05T10:52:00+10:00,2023-06-05,10:52,2,4,6
37,2023-06-05T10:52:00+10:00,2023-06-05,10:52,2,1,3
39,2023-06-05T10:52:00+10:00,2023-06-05,10:52,0,2,2
41,2023-06-05T10:52:00+10:00,2023-06-05,10:52,9,11,20
45,2023-06-05T10:52:00+10:00,2023-06-05,10:52,2,6,8
47,2023-06-05T10:52:00+10:00,2023-06-05,10:52,11,19,30
55,2023-06-05T10:52:00+10:00,2023-06-05,10:52,4,16,20
75,2023-06-05T10:52:00+10:00,2023-06-05,10:52,2,0,2
77,2023-06-05T10:52:00+10:00,2023-06-05,10:52,5,0,5
87,2023-06-05T10:52:00+10:00,2023-06-05,10:52,1,0,1
9,2023-06-05T10:52:00+10:00,2023-06-05,10:52,3,2,5
17,2023-06-05T10:52:00+10:00,2023-06-05,10:52,2,1,3
19,2023-06-05T10:52:00+10:00,2023-06-05,10:52,3,2,5
20,2023-06-05T10:52:00+10:00,2023-06-05,10:52,5,0,5
24,2023-06-05T10:52:00+10:00,2023-06-05,10:52,4,43,47
57,2023-06-05T10:52:00+10:00,2023-06-05,10:52,0,3,3
58,2023-06-05T10:52:00+10:00,2023-06-05,10:52,3,1,4
63,2023-06-05T10:52:00+10:00,2023-06-05,10:52,7,1,8
67,2023-06-05T10:52:00+10:00,2023-06-05,10:52,2,9,11
68,2023-06-05T10:52:00+10:00,2023-06-05,10:52,4,0,4
72,2023-06-05T10:52:00+10:00,2023-06-05,10:52,3,0,3
76,2023-06-05T10:52:00+10:00,2023-06-05,10:52,0,3,3
85,2023-06-05T10:52:00+10:00,2023-06-05,10:52,0,2,2
31,2023-06-05T10:51:00+10:00,2023-06-05,10:51,0,1,1
36,2023-06-05T10:51:00+10:00,2023-06-05,10:51,5,3,8
37,2023-06-05T10:51:00+10:00,2023-06-05,10:51,4,3,7
39,2023-06-05T10:51:00+10:00,2023-06-05,10:51,5,0,5
55,2023-06-05T10:51:00+10:00,2023-06-05,10:51,9,8,17
66,2023-06-05T10:51:00+10:00,2023-06-05,10:51,7,20,27
75,2023-06-05T10:51:00+10:00,2023-06-05,10:51,2,1,3
77,2023-06-05T10:51:00+10:00,2023-06-05,10:51,4,2,6
1,2023-06-05T10:51:00+10:00,2023-06-05,10:51,3,6,9
9,2023-06-05T10:51:00+10:00,2023-06-05,10:51,4,7,11
17,2023-06-05T10:51:00+10:00,2023-06-05,10:51,4,3,7
18,2023-06-05T10:51:00+10:00,2023-06-05,10:51,2,4,6
24,2023-06-05T10:51:00+10:00,2023-06-05,10:51,14,3,17
27,2023-06-05T10:51:00+10:00,2023-06-05,10:51,0,2,2
30,2023-06-05T10:51:00+10:00,2023-06-05,10:51,5,1,6
53,2023-06-05T10:51:00+10:00,2023-06-05,10:51,18,12,30
57,2023-06-05T10:51:00+10:00,2023-06-05,10:51,5,5,10
68,2023-06-05T10:51:00+10:00,2023-06-05,10:51,1,5,6
72,2023-06-05T10:51:00+10:00,2023-06-05,10:51,8,1,9
79,2023-06-05T10:51:00+10:00,2023-06-05,10:51,0,3,3
85,2023-06-05T10:51:00+10:00,2023-06-05,10:51,0,3,3
3,2023-06-05T10:51:00+10:00,2023-06-05,10:51,4,4,8
8,2023-06-05T10:51:00+10:00,2023-06-05,10:51,2,4,6
14,2023-06-05T10:51:00+10:00,2023-06-05,10:51,3,1,4
41,2023-06-05T10:51:00+10:00,2023-06-05,10:51,25,11,36
45,2023-06-05T10:51:00+10:00,2023-06-05,10:51,2,4,6
47,2023-06-05T10:51:00+10:00,2023-06-05,10:51,6,5,11
50,2023-06-05T10:51:00+10:00,2023-06-05,10:51,2,3,5
61,2023-06-05T10:51:00+10:00,2023-06-05,10:51,2,3,5
65,2023-06-05T10:51:00+10:00,2023-06-05,10:51,3,9,12
70,2023-06-05T10:51:00+10:00,2023-06-05,10:51,0,4,4
87,2023-06-05T10:51:00+10:00,2023-06-05,10:51,2,0,2
108,2023-06-05T10:51:00+10:00,2023-06-05,10:51,2,9,11
12,2023-06-05T10:51:00+10:00,2023-06-05,10:51,0,2,2
19,2023-06-05T10:51:00+10:00,2023-06-05,10:51,7,6,13
35,2023-06-05T10:51:00+10:00,2023-06-05,10:51,15,5,20
48,2023-06-05T10:51:00+10:00,2023-06-05,10:51,4,5,9
51,2023-06-05T10:51:00+10:00,2023-06-05,10:51,0,1,1
63,2023-06-05T10:51:00+10:00,2023-06-05,10:51,1,7,8
76,2023-06-05T10:51:00+10:00,2023-06-05,10:51,0,1,1
86,2023-06-05T10:51:00+10:00,2023-06-05,10:51,0,2,2
4,2023-06-05T10:51:00+10:00,2023-06-05,10:51,12,6,18
5,2023-06-05T10:51:00+10:00,2023-06-05,10:51,2,11,13
6,2023-06-05T10:51:00+10:00,2023-06-05,10:51,3,2,5
21,2023-06-05T10:51:00+10:00,2023-06-05,10:51,4,9,13
26,2023-06-05T10:51:00+10:00,2023-06-05,10:51,6,9,15
28,2023-06-05T10:51:00+10:00,2023-06-05,10:51,9,4,13
29,2023-06-05T10:51:00+10:00,2023-06-05,10:51,0,2,2
40,2023-06-05T10:51:00+10:00,2023-06-05,10:51,2,2,4
42,2023-06-05T10:51:00+10:00,2023-06-05,10:51,3,5,8
54,2023-06-05T10:51:00+10:00,2023-06-05,10:51,0,4,4
69,2023-06-05T10:51:00+10:00,2023-06-05,10:51,2,2,4
2,2023-06-05T10:51:00+10:00,2023-06-05,10:51,1,9,10
23,2023-06-05T10:51:00+10:00,2023-06-05,10:51,3,2,5
52,2023-06-05T10:51:00+10:00,2023-06-05,10:51,1,4,5
56,2023-06-05T10:51:00+10:00,2023-06-05,10:51,1,0,1
58,2023-06-05T10:51:00+10:00,2023-06-05,10:51,5,3,8
62,2023-06-05T10:51:00+10:00,2023-06-05,10:51,3,2,5
67,2023-06-05T10:51:00+10:00,2023-06-05,10:51,3,3,6
21,2023-06-05T10:50:00+10:00,2023-06-05,10:50,5,6,11
28,2023-06-05T10:50:00+10:00,2023-06-05,10:50,5,2,7
37,2023-06-05T10:50:00+10:00,2023-06-05,10:50,0,2,2
40,2023-06-05T10:50:00+10:00,2023-06-05,10:50,0,4,4
42,2023-06-05T10:50:00+10:00,2023-06-05,10:50,2,0,2
50,2023-06-05T10:50:00+10:00,2023-06-05,10:50,1,0,1
59,2023-06-05T10:50:00+10:00,2023-06-05,10:50,42,22,64
61,2023-06-05T10:50:00+10:00,2023-06-05,10:50,2,5,7
65,2023-06-05T10:50:00+10:00,2023-06-05,10:50,3,2,5
77,2023-06-05T10:50:00+10:00,2023-06-05,10:50,0,2,2
1,2023-06-05T10:50:00+10:00,2023-06-05,10:50,2,14,16
2,2023-06-05T10:50:00+10:00,2023-06-05,10:50,2,4,6
20,2023-06-05T10:50:00+10:00,2023-06-05,10:50,0,1,1
27,2023-06-05T10:50:00+10:00,2023-06-05,10:50,3,3,6
62,2023-06-05T10:50:00+10:00,2023-06-05,10:50,0,1,1
63,2023-06-05T10:50:00+10:00,2023-06-05,10:50,0,2,2
85,2023-06-05T10:50:00+10:00,2023-06-05,10:50,0,1,1
109,2023-06-05T10:50:00+10:00,2023-06-05,10:50,6,15,21
4,2023-06-05T10:50:00+10:00,2023-06-05,10:50,6,10,16
5,2023-06-05T10:50:00+10:00,2023-06-05,10:50,5,15,20
8,2023-06-05T10:50:00+10:00,2023-06-05,10:50,0,2,2
36,2023-06-05T10:50:00+10:00,2023-06-05,10:50,3,3,6
39,2023-06-05T10:50:00+10:00,2023-06-05,10:50,0,2,2
45,2023-06-05T10:50:00+10:00,2023-06-05,10:50,1,2,3
47,2023-06-05T10:50:00+10:00,2023-06-05,10:50,2,7,9
54,2023-06-05T10:50:00+10:00,2023-06-05,10:50,1,0,1
69,2023-06-05T10:50:00+10:00,2023-06-05,10:50,3,1,4
71,2023-06-05T10:50:00+10:00,2023-06-05,10:50,0,1,1
107,2023-06-05T10:50:00+10:00,2023-06-05,10:50,5,10,15
108,2023-06-05T10:50:00+10:00,2023-06-05,10:50,2,4,6
24,2023-06-05T10:50:00+10:00,2023-06-05,10:50,10,5,15
46,2023-06-05T10:50:00+10:00,2023-06-05,10:50,0,2,2
52,2023-06-05T10:50:00+10:00,2023-06-05,10:50,4,0,4
53,2023-06-05T10:50:00+10:00,2023-06-05,10:50,10,7,17
57,2023-06-05T10:50:00+10:00,2023-06-05,10:50,1,3,4
67,2023-06-05T10:50:00+10:00,2023-06-05,10:50,6,4,10
68,2023-06-05T10:50:00+10:00,2023-06-05,10:50,3,0,3
76,2023-06-05T10:50:00+10:00,2023-06-05,10:50,0,2,2
79,2023-06-05T10:50:00+10:00,2023-06-05,10:50,8,3,11
86,2023-06-05T10:50:00+10:00,2023-06-05,10:50,1,2,3
3,2023-06-05T10:50:00+10:00,2023-06-05,10:50,11,10,21
6,2023-06-05T10:50:00+10:00,2023-06-05,10:50,7,5,12
14,2023-06-05T10:50:00+10:00,2023-06-05,10:50,3,2,5
26,2023-06-05T10:50:00+10:00,2023-06-05,10:50,0,4,4
29,2023-06-05T10:50:00+10:00,2023-06-05,10:50,5,2,7
31,2023-06-05T10:50:00+10:00,2023-06-05,10:50,0,1,1
41,2023-06-05T10:50:00+10:00,2023-06-05,10:50,20,12,32
44,2023-06-05T10:50:00+10:00,2023-06-05,10:50,0,1,1
55,2023-06-05T10:50:00+10:00,2023-06-05,10:50,7,6,13
66,2023-06-05T10:50:00+10:00,2023-06-05,10:50,6,5,11
70,2023-06-05T10:50:00+10:00,2023-06-05,10:50,1,3,4
84,2023-06-05T10:50:00+10:00,2023-06-05,10:50,34,54,88
87,2023-06-05T10:50:00+10:00,2023-06-05,10:50,4,0,4
118,2023-06-05T10:50:00+10:00,2023-06-05,10:50,4,2,6
9,2023-06-05T10:50:00+10:00,2023-06-05,10:50,4,4,8
10,2023-06-05T10:50:00+10:00,2023-06-05,10:50,0,1,1
11,2023-06-05T10:50:00+10:00,2023-06-05,10:50,3,0,3
17,2023-06-05T10:50:00+10:00,2023-06-05,10:50,6,4,10
18,2023-06-05T10:50:00+10:00,2023-06-05,10:50,4,2,6
19,2023-06-05T10:50:00+10:00,2023-06-05,10:50,1,3,4
23,2023-06-05T10:50:00+10:00,2023-06-05,10:50,1,1,2
30,2023-06-05T10:50:00+10:00,2023-06-05,10:50,5,2,7
35,2023-06-05T10:50:00+10:00,2023-06-05,10:50,2,3,5
48,2023-06-05T10:50:00+10:00,2023-06-05,10:50,2,3,5
51,2023-06-05T10:50:00+10:00,2023-06-05,10:50,1,1,2
56,2023-06-05T10:50:00+10:00,2023-06-05,10:50,3,1,4
58,2023-06-05T10:50:00+10:00,2023-06-05,10:50,6,3,9
72,2023-06-05T10:50:00+10:00,2023-06-05,10:50,1,0,1
117,2023-06-05T10:50:00+10:00,2023-06-05,10:50,13,8,21
8,2023-06-05T10:49:00+10:00,2023-06-05,10:49,2,0,2
26,2023-06-05T10:49:00+10:00,2023-06-05,10:49,6,5,11
44,2023-06-05T10:49:00+10:00,2023-06-05,10:49,0,1,1
65,2023-06-05T10:49:00+10:00,2023-06-05,10:49,10,0,10
70,2023-06-05T10:49:00+10:00,2023-06-05,10:49,2,0,2
2,2023-06-05T10:49:00+10:00,2023-06-05,10:49,4,7,11
10,2023-06-05T10:49:00+10:00,2023-06-05,10:49,1,3,4
20,2023-06-05T10:49:00+10:00,2023-06-05,10:49,1,0,1
24,2023-06-05T10:49:00+10:00,2023-06-05,10:49,4,4,8
30,2023-06-05T10:49:00+10:00,2023-06-05,10:49,5,3,8
51,2023-06-05T10:49:00+10:00,2023-06-05,10:49,1,0,1
56,2023-06-05T10:49:00+10:00,2023-06-05,10:49,3,2,5
67,2023-06-05T10:49:00+10:00,2023-06-05,10:49,7,11,18
68,2023-06-05T10:49:00+10:00,2023-06-05,10:49,3,0,3
72,2023-06-05T10:49:00+10:00,2023-06-05,10:49,1,3,4
3,2023-06-05T10:49:00+10:00,2023-06-05,10:49,3,9,12
5,2023-06-05T10:49:00+10:00,2023-06-05,10:49,7,13,20
6,2023-06-05T10:49:00+10:00,2023-06-05,10:49,5,10,15
21,2023-06-05T10:49:00+10:00,2023-06-05,10:49,1,3,4
28,2023-06-05T10:49:00+10:00,2023-06-05,10:49,9,2,11
36,2023-06-05T10:49:00+10:00,2023-06-05,10:49,3,0,3
37,2023-06-05T10:49:00+10:00,2023-06-05,10:49,0,1,1
39,2023-06-05T10:49:00+10:00,2023-06-05,10:49,1,2,3
40,2023-06-05T10:49:00+10:00,2023-06-05,10:49,1,1,2
42,2023-06-05T10:49:00+10:00,2023-06-05,10:49,0,1,1
45,2023-06-05T10:49:00+10:00,2023-06-05,10:49,5,6,11
47,2023-06-05T10:49:00+10:00,2023-06-05,10:49,5,13,18
61,2023-06-05T10:49:00+10:00,2023-06-05,10:49,3,2,5
75,2023-06-05T10:49:00+10:00,2023-06-05,10:49,2,0,2
77,2023-06-05T10:49:00+10:00,2023-06-05,10:49,0,1,1
11,2023-06-05T10:49:00+10:00,2023-06-05,10:49,0,1,1
19,2023-06-05T10:49:00+10:00,2023-06-05,10:49,4,2,6
23,2023-06-05T10:49:00+10:00,2023-06-05,10:49,0,1,1
35,2023-06-05T10:49:00+10:00,2023-06-05,10:49,3,6,9
48,2023-06-05T10:49:00+10:00,2023-06-05,10:49,1,4,5
52,2023-06-05T10:49:00+10:00,2023-06-05,10:49,2,2,4
62,2023-06-05T10:49:00+10:00,2023-06-05,10:49,1,1,2
4,2023-06-05T10:49:00+10:00,2023-06-05,10:49,9,12,21
29,2023-06-05T10:49:00+10:00,2023-06-05,10:49,5,1,6
31,2023-06-05T10:49:00+10:00,2023-06-05,10:49,1,3,4
41,2023-06-05T10:49:00+10:00,2023-06-05,10:49,30,6,36
50,2023-06-05T10:49:00+10:00,2023-06-05,10:49,0,2,2
55,2023-06-05T10:49:00+10:00,2023-06-05,10:49,3,10,13
66,2023-06-05T10:49:00+10:00,2023-06-05,10:49,4,10,14
69,2023-06-05T10:49:00+10:00,2023-06-05,10:49,8,4,12
87,2023-06-05T10:49:00+10:00,2023-06-05,10:49,1,2,3
108,2023-06-05T10:49:00+10:00,2023-06-05,10:49,7,7,14
1,2023-06-05T10:49:00+10:00,2023-06-05,10:49,6,12,18
9,2023-06-05T10:49:00+10:00,2023-06-05,10:49,4,2,6
12,2023-06-05T10:49:00+10:00,2023-06-05,10:49,0,1,1
17,2023-06-05T10:49:00+10:00,2023-06-05,10:49,9,7,16
18,2023-06-05T10:49:00+10:00,2023-06-05,10:49,1,2,3
27,2023-06-05T10:49:00+10:00,2023-06-05,10:49,1,1,2
46,2023-06-05T10:49:00+10:00,2023-06-05,10:49,0,8,8
53,2023-06-05T10:49:00+10:00,2023-06-05,10:49,2,10,12
57,2023-06-05T10:49:00+10:00,2023-06-05,10:49,0,5,5
58,2023-06-05T10:49:00+10:00,2023-06-05,10:49,4,2,6
63,2023-06-05T10:49:00+10:00,2023-06-05,10:49,3,4,7
79,2023-06-05T10:49:00+10:00,2023-06-05,10:49,15,9,24
85,2023-06-05T10:49:00+10:00,2023-06-05,10:49,2,0,2
4,2023-06-05T10:48:00+10:00,2023-06-05,10:48,8,4,12
21,2023-06-05T10:48:00+10:00,2023-06-05,10:48,4,8,12
29,2023-06-05T10:48:00+10:00,2023-06-05,10:48,1,1,2
31,2023-06-05T10:48:00+10:00,2023-06-05,10:48,2,0,2
37,2023-06-05T10:48:00+10:00,2023-06-05,10:48,0,4,4
41,2023-06-05T10:48:00+10:00,2023-06-05,10:48,22,8,30
45,2023-06-05T10:48:00+10:00,2023-06-05,10:48,2,5,7
47,2023-06-05T10:48:00+10:00,2023-06-05,10:48,4,7,11
2,2023-06-05T10:48:00+10:00,2023-06-05,10:48,7,4,11
23,2023-06-05T10:48:00+10:00,2023-06-05,10:48,3,0,3
27,2023-06-05T10:48:00+10:00,2023-06-05,10:48,1,2,3
35,2023-06-05T10:48:00+10:00,2023-06-05,10:48,4,5,9
46,2023-06-05T10:48:00+10:00,2023-06-05,10:48,0,1,1
52,2023-06-05T10:48:00+10:00,2023-06-05,10:48,4,3,7
56,2023-06-05T10:48:00+10:00,2023-06-05,10:48,5,3,8
57,2023-06-05T10:48:00+10:00,2023-06-05,10:48,2,2,4
63,2023-06-05T10:48:00+10:00,2023-06-05,10:48,3,9,12
72,2023-06-05T10:48:00+10:00,2023-06-05,10:48,4,0,4
79,2023-06-05T10:48:00+10:00,2023-06-05,10:48,6,2,8
3,2023-06-05T10:48:00+10:00,2023-06-05,10:48,5,8,13
5,2023-06-05T10:48:00+10:00,2023-06-05,10:48,4,8,12
14,2023-06-05T10:48:00+10:00,2023-06-05,10:48,3,1,4
26,2023-06-05T10:48:00+10:00,2023-06-05,10:48,1,3,4
28,2023-06-05T10:48:00+10:00,2023-06-05,10:48,8,3,11
36,2023-06-05T10:48:00+10:00,2023-06-05,10:48,1,3,4
44,2023-06-05T10:48:00+10:00,2023-06-05,10:48,1,1,2
50,2023-06-05T10:48:00+10:00,2023-06-05,10:48,1,0,1
54,2023-06-05T10:48:00+10:00,2023-06-05,10:48,1,0,1
61,2023-06-05T10:48:00+10:00,2023-06-05,10:48,2,2,4
65,2023-06-05T10:48:00+10:00,2023-06-05,10:48,9,7,16
69,2023-06-05T10:48:00+10:00,2023-06-05,10:48,1,3,4
70,2023-06-05T10:48:00+10:00,2023-06-05,10:48,4,2,6
75,2023-06-05T10:48:00+10:00,2023-06-05,10:48,3,2,5
77,2023-06-05T10:48:00+10:00,2023-06-05,10:48,0,1,1
18,2023-06-05T10:48:00+10:00,2023-06-05,10:48,2,1,3
19,2023-06-05T10:48:00+10:00,2023-06-05,10:48,4,2,6
20,2023-06-05T10:48:00+10:00,2023-06-05,10:48,0,1,1
24,2023-06-05T10:48:00+10:00,2023-06-05,10:48,37,9,46
48,2023-06-05T10:48:00+10:00,2023-06-05,10:48,3,0,3
58,2023-06-05T10:48:00+10:00,2023-06-05,10:48,12,4,16
67,2023-06-05T10:48:00+10:00,2023-06-05,10:48,11,7,18
68,2023-06-05T10:48:00+10:00,2023-06-05,10:48,7,2,9
76,2023-06-05T10:48:00+10:00,2023-06-05,10:48,0,1,1
86,2023-06-05T10:48:00+10:00,2023-06-05,10:48,2,1,3
6,2023-06-05T10:48:00+10:00,2023-06-05,10:48,7,5,12
8,2023-06-05T10:48:00+10:00,2023-06-05,10:48,4,1,5
39,2023-06-05T10:48:00+10:00,2023-06-05,10:48,3,0,3
40,2023-06-05T10:48:00+10:00,2023-06-05,10:48,3,5,8
42,2023-06-05T10:48:00+10:00,2023-06-05,10:48,2,1,3
55,2023-06-05T10:48:00+10:00,2023-06-05,10:48,4,5,9
66,2023-06-05T10:48:00+10:00,2023-06-05,10:48,4,5,9
87,2023-06-05T10:48:00+10:00,2023-06-05,10:48,1,5,6
108,2023-06-05T10:48:00+10:00,2023-06-05,10:48,2,3,5
1,2023-06-05T10:48:00+10:00,2023-06-05,10:48,7,8,15
9,2023-06-05T10:48:00+10:00,2023-06-05,10:48,4,3,7
17,2023-06-05T10:48:00+10:00,2023-06-05,10:48,4,8,12
30,2023-06-05T10:48:00+10:00,2023-06-05,10:48,3,2,5
53,2023-06-05T10:48:00+10:00,2023-06-05,10:48,11,13,24
85,2023-06-05T10:48:00+10:00,2023-06-05,10:48,4,1,5
3,2023-06-05T10:47:00+10:00,2023-06-05,10:47,5,13,18
5,2023-06-05T10:47:00+10:00,2023-06-05,10:47,5,7,12
14,2023-06-05T10:47:00+10:00,2023-06-05,10:47,5,2,7
26,2023-06-05T10:47:00+10:00,2023-06-05,10:47,4,4,8
28,2023-06-05T10:47:00+10:00,2023-06-05,10:47,10,0,10
47,2023-06-05T10:47:00+10:00,2023-06-05,10:47,3,15,18
2,2023-06-05T10:47:00+10:00,2023-06-05,10:47,6,3,9
12,2023-06-05T10:47:00+10:00,2023-06-05,10:47,0,1,1
18,2023-06-05T10:47:00+10:00,2023-06-05,10:47,0,5,5
23,2023-06-05T10:47:00+10:00,2023-06-05,10:47,2,2,4
30,2023-06-05T10:47:00+10:00,2023-06-05,10:47,1,2,3
35,2023-06-05T10:47:00+10:00,2023-06-05,10:47,7,3,10
51,2023-06-05T10:47:00+10:00,2023-06-05,10:47,0,2,2
52,2023-06-05T10:47:00+10:00,2023-06-05,10:47,2,6,8
63,2023-06-05T10:47:00+10:00,2023-06-05,10:47,3,8,11
79,2023-06-05T10:47:00+10:00,2023-06-05,10:47,6,3,9
6,2023-06-05T10:47:00+10:00,2023-06-05,10:47,9,5,14
21,2023-06-05T10:47:00+10:00,2023-06-05,10:47,7,9,16
36,2023-06-05T10:47:00+10:00,2023-06-05,10:47,4,4,8
39,2023-06-05T10:47:00+10:00,2023-06-05,10:47,2,0,2
42,2023-06-05T10:47:00+10:00,2023-06-05,10:47,4,2,6
50,2023-06-05T10:47:00+10:00,2023-06-05,10:47,0,2,2
55,2023-06-05T10:47:00+10:00,2023-06-05,10:47,4,8,12
61,2023-06-05T10:47:00+10:00,2023-06-05,10:47,1,0,1
66,2023-06-05T10:47:00+10:00,2023-06-05,10:47,4,4,8
70,2023-06-05T10:47:00+10:00,2023-06-05,10:47,2,2,4
77,2023-06-05T10:47:00+10:00,2023-06-05,10:47,5,3,8
87,2023-06-05T10:47:00+10:00,2023-06-05,10:47,2,0,2
1,2023-06-05T10:47:00+10:00,2023-06-05,10:47,9,10,19
10,2023-06-05T10:47:00+10:00,2023-06-05,10:47,2,2,4
24,2023-06-05T10:47:00+10:00,2023-06-05,10:47,6,8,14
27,2023-06-05T10:47:00+10:00,2023-06-05,10:47,0,2,2
53,2023-06-05T10:47:00+10:00,2023-06-05,10:47,8,15,23
56,2023-06-05T10:47:00+10:00,2023-06-05,10:47,2,0,2
57,2023-06-05T10:47:00+10:00,2023-06-05,10:47,2,0,2
58,2023-06-05T10:47:00+10:00,2023-06-05,10:47,4,8,12
72,2023-06-05T10:47:00+10:00,2023-06-05,10:47,3,1,4
76,2023-06-05T10:47:00+10:00,2023-06-05,10:47,0,2,2
85,2023-06-05T10:47:00+10:00,2023-06-05,10:47,0,2,2
86,2023-06-05T10:47:00+10:00,2023-06-05,10:47,0,2,2
4,2023-06-05T10:47:00+10:00,2023-06-05,10:47,14,5,19
8,2023-06-05T10:47:00+10:00,2023-06-05,10:47,1,3,4
29,2023-06-05T10:47:00+10:00,2023-06-05,10:47,2,1,3
31,2023-06-05T10:47:00+10:00,2023-06-05,10:47,2,1,3
37,2023-06-05T10:47:00+10:00,2023-06-05,10:47,1,0,1
40,2023-06-05T10:47:00+10:00,2023-06-05,10:47,0,1,1
41,2023-06-05T10:47:00+10:00,2023-06-05,10:47,17,9,26
44,2023-06-05T10:47:00+10:00,2023-06-05,10:47,0,1,1
45,2023-06-05T10:47:00+10:00,2023-06-05,10:47,2,1,3
54,2023-06-05T10:47:00+10:00,2023-06-05,10:47,3,1,4
65,2023-06-05T10:47:00+10:00,2023-06-05,10:47,5,1,6
69,2023-06-05T10:47:00+10:00,2023-06-05,10:47,3,5,8
108,2023-06-05T10:47:00+10:00,2023-06-05,10:47,6,2,8
9,2023-06-05T10:47:00+10:00,2023-06-05,10:47,3,9,12
17,2023-06-05T10:47:00+10:00,2023-06-05,10:47,11,2,13
19,2023-06-05T10:47:00+10:00,2023-06-05,10:47,11,3,14
20,2023-06-05T10:47:00+10:00,2023-06-05,10:47,1,4,5
46,2023-06-05T10:47:00+10:00,2023-06-05,10:47,3,3,6
48,2023-06-05T10:47:00+10:00,2023-06-05,10:47,1,2,3
49,2023-06-05T10:47:00+10:00,2023-06-05,10:47,0,3,3
62,2023-06-05T10:47:00+10:00,2023-06-05,10:47,0,5,5
67,2023-06-05T10:47:00+10:00,2023-06-05,10:47,16,6,22
4,2023-06-05T10:46:00+10:00,2023-06-05,10:46,18,12,30
5,2023-06-05T10:46:00+10:00,2023-06-05,10:46,1,11,12
36,2023-06-05T10:46:00+10:00,2023-06-05,10:46,2,1,3
44,2023-06-05T10:46:00+10:00,2023-06-05,10:46,0,1,1
55,2023-06-05T10:46:00+10:00,2023-06-05,10:46,4,9,13
75,2023-06-05T10:46:00+10:00,2023-06-05,10:46,0,1,1
87,2023-06-05T10:46:00+10:00,2023-06-05,10:46,0,2,2
108,2023-06-05T10:46:00+10:00,2023-06-05,10:46,5,1,6
2,2023-06-05T10:46:00+10:00,2023-06-05,10:46,2,8,10
9,2023-06-05T10:46:00+10:00,2023-06-05,10:46,0,1,1
17,2023-06-05T10:46:00+10:00,2023-06-05,10:46,6,2,8
19,2023-06-05T10:46:00+10:00,2023-06-05,10:46,5,0,5
27,2023-06-05T10:46:00+10:00,2023-06-05,10:46,2,1,3
30,2023-06-05T10:46:00+10:00,2023-06-05,10:46,3,7,10
35,2023-06-05T10:46:00+10:00,2023-06-05,10:46,10,5,15
56,2023-06-05T10:46:00+10:00,2023-06-05,10:46,1,0,1
57,2023-06-05T10:46:00+10:00,2023-06-05,10:46,2,1,3
62,2023-06-05T10:46:00+10:00,2023-06-05,10:46,3,1,4
72,2023-06-05T10:46:00+10:00,2023-06-05,10:46,1,0,1
79,2023-06-05T10:46:00+10:00,2023-06-05,10:46,1,10,11
3,2023-06-05T10:46:00+10:00,2023-06-05,10:46,10,8,18
6,2023-06-05T10:46:00+10:00,2023-06-05,10:46,1,3,4
8,2023-06-05T10:46:00+10:00,2023-06-05,10:46,2,2,4
14,2023-06-05T10:46:00+10:00,2023-06-05,10:46,1,2,3
28,2023-06-05T10:46:00+10:00,2023-06-05,10:46,20,1,21
31,2023-06-05T10:46:00+10:00,2023-06-05,10:46,3,3,6
37,2023-06-05T10:46:00+10:00,2023-06-05,10:46,0,2,2
40,2023-06-05T10:46:00+10:00,2023-06-05,10:46,3,0,3
41,2023-06-05T10:46:00+10:00,2023-06-05,10:46,15,15,30
45,2023-06-05T10:46:00+10:00,2023-06-05,10:46,3,3,6
61,2023-06-05T10:46:00+10:00,2023-06-05,10:46,5,10,15
65,2023-06-05T10:46:00+10:00,2023-06-05,10:46,4,1,5
69,2023-06-05T10:46:00+10:00,2023-06-05,10:46,1,3,4
12,2023-06-05T10:46:00+10:00,2023-06-05,10:46,0,1,1
20,2023-06-05T10:46:00+10:00,2023-06-05,10:46,1,2,3
23,2023-06-05T10:46:00+10:00,2023-06-05,10:46,4,4,8
24,2023-06-05T10:46:00+10:00,2023-06-05,10:46,22,2,24
46,2023-06-05T10:46:00+10:00,2023-06-05,10:46,0,1,1
63,2023-06-05T10:46:00+10:00,2023-06-05,10:46,4,6,10
21,2023-06-05T10:46:00+10:00,2023-06-05,10:46,3,2,5
26,2023-06-05T10:46:00+10:00,2023-06-05,10:46,7,1,8
29,2023-06-05T10:46:00+10:00,2023-06-05,10:46,2,0,2
39,2023-06-05T10:46:00+10:00,2023-06-05,10:46,0,1,1
42,2023-06-05T10:46:00+10:00,2023-06-05,10:46,0,7,7
47,2023-06-05T10:46:00+10:00,2023-06-05,10:46,7,18,25
50,2023-06-05T10:46:00+10:00,2023-06-05,10:46,0,2,2
54,2023-06-05T10:46:00+10:00,2023-06-05,10:46,3,1,4
66,2023-06-05T10:46:00+10:00,2023-06-05,10:46,4,12,16
70,2023-06-05T10:46:00+10:00,2023-06-05,10:46,4,1,5
1,2023-06-05T10:46:00+10:00,2023-06-05,10:46,9,13,22
18,2023-06-05T10:46:00+10:00,2023-06-05,10:46,1,6,7
48,2023-06-05T10:46:00+10:00,2023-06-05,10:46,1,4,5
51,2023-06-05T10:46:00+10:00,2023-06-05,10:46,2,3,5
52,2023-06-05T10:46:00+10:00,2023-06-05,10:46,3,0,3
53,2023-06-05T10:46:00+10:00,2023-06-05,10:46,11,3,14
58,2023-06-05T10:46:00+10:00,2023-06-05,10:46,18,1,19
67,2023-06-05T10:46:00+10:00,2023-06-05,10:46,3,17,20
68,2023-06-05T10:46:00+10:00,2023-06-05,10:46,8,5,13
76,2023-06-05T10:46:00+10:00,2023-06-05,10:46,3,4,7
4,2023-06-05T10:45:00+10:00,2023-06-05,10:45,14,9,23
6,2023-06-05T10:45:00+10:00,2023-06-05,10:45,9,4,13
8,2023-06-05T10:45:00+10:00,2023-06-05,10:45,1,3,4
28,2023-06-05T10:45:00+10:00,2023-06-05,10:45,6,2,8
37,2023-06-05T10:45:00+10:00,2023-06-05,10:45,1,2,3
39,2023-06-05T10:45:00+10:00,2023-06-05,10:45,1,3,4
41,2023-06-05T10:45:00+10:00,2023-06-05,10:45,25,19,44
47,2023-06-05T10:45:00+10:00,2023-06-05,10:45,3,2,5
59,2023-06-05T10:45:00+10:00,2023-06-05,10:45,33,29,62
69,2023-06-05T10:45:00+10:00,2023-06-05,10:45,5,1,6
84,2023-06-05T10:45:00+10:00,2023-06-05,10:45,61,73,134
87,2023-06-05T10:45:00+10:00,2023-06-05,10:45,3,2,5
118,2023-06-05T10:45:00+10:00,2023-06-05,10:45,0,2,2
9,2023-06-05T10:45:00+10:00,2023-06-05,10:45,5,5,10
35,2023-06-05T10:45:00+10:00,2023-06-05,10:45,7,5,12
56,2023-06-05T10:45:00+10:00,2023-06-05,10:45,4,0,4
57,2023-06-05T10:45:00+10:00,2023-06-05,10:45,5,0,5
68,2023-06-05T10:45:00+10:00,2023-06-05,10:45,4,2,6
76,2023-06-05T10:45:00+10:00,2023-06-05,10:45,1,1,2
79,2023-06-05T10:45:00+10:00,2023-06-05,10:45,3,4,7
117,2023-06-05T10:45:00+10:00,2023-06-05,10:45,7,3,10
5,2023-06-05T10:45:00+10:00,2023-06-05,10:45,6,8,14
14,2023-06-05T10:45:00+10:00,2023-06-05,10:45,10,3,13
21,2023-06-05T10:45:00+10:00,2023-06-05,10:45,4,3,7
55,2023-06-05T10:45:00+10:00,2023-06-05,10:45,3,6,9
70,2023-06-05T10:45:00+10:00,2023-06-05,10:45,2,3,5
75,2023-06-05T10:45:00+10:00,2023-06-05,10:45,4,0,4
107,2023-06-05T10:45:00+10:00,2023-06-05,10:45,17,5,22
108,2023-06-05T10:45:00+10:00,2023-06-05,10:45,4,6,10
1,2023-06-05T10:45:00+10:00,2023-06-05,10:45,11,19,30
11,2023-06-05T10:45:00+10:00,2023-06-05,10:45,0,7,7
17,2023-06-05T10:45:00+10:00,2023-06-05,10:45,11,10,21
18,2023-06-05T10:45:00+10:00,2023-06-05,10:45,1,7,8
19,2023-06-05T10:45:00+10:00,2023-06-05,10:45,1,0,1
20,2023-06-05T10:45:00+10:00,2023-06-05,10:45,2,2,4
24,2023-06-05T10:45:00+10:00,2023-06-05,10:45,11,7,18
49,2023-06-05T10:45:00+10:00,2023-06-05,10:45,0,2,2
51,2023-06-05T10:45:00+10:00,2023-06-05,10:45,2,0,2
58,2023-06-05T10:45:00+10:00,2023-06-05,10:45,12,0,12
62,2023-06-05T10:45:00+10:00,2023-06-05,10:45,1,2,3
67,2023-06-05T10:45:00+10:00,2023-06-05,10:45,4,8,12
3,2023-06-05T10:45:00+10:00,2023-06-05,10:45,3,10,13
26,2023-06-05T10:45:00+10:00,2023-06-05,10:45,2,7,9
29,2023-06-05T10:45:00+10:00,2023-06-05,10:45,2,0,2
31,2023-06-05T10:45:00+10:00,2023-06-05,10:45,0,4,4
36,2023-06-05T10:45:00+10:00,2023-06-05,10:45,0,2,2
40,2023-06-05T10:45:00+10:00,2023-06-05,10:45,2,2,4
42,2023-06-05T10:45:00+10:00,2023-06-05,10:45,3,2,5
44,2023-06-05T10:45:00+10:00,2023-06-05,10:45,2,0,2
45,2023-06-05T10:45:00+10:00,2023-06-05,10:45,5,5,10
50,2023-06-05T10:45:00+10:00,2023-06-05,10:45,1,4,5
61,2023-06-05T10:45:00+10:00,2023-06-05,10:45,2,4,6
65,2023-06-05T10:45:00+10:00,2023-06-05,10:45,0,3,3
66,2023-06-05T10:45:00+10:00,2023-06-05,10:45,7,3,10
2,2023-06-05T10:45:00+10:00,2023-06-05,10:45,8,0,8
10,2023-06-05T10:45:00+10:00,2023-06-05,10:45,2,0,2
12,2023-06-05T10:45:00+10:00,2023-06-05,10:45,2,2,4
23,2023-06-05T10:45:00+10:00,2023-06-05,10:45,3,11,14
30,2023-06-05T10:45:00+10:00,2023-06-05,10:45,1,2,3
48,2023-06-05T10:45:00+10:00,2023-06-05,10:45,2,2,4
52,2023-06-05T10:45:00+10:00,2023-06-05,10:45,2,1,3
53,2023-06-05T10:45:00+10:00,2023-06-05,10:45,12,8,20
63,2023-06-05T10:45:00+10:00,2023-06-05,10:45,3,2,5
85,2023-06-05T10:45:00+10:00,2023-06-05,10:45,0,1,1
109,2023-06-05T10:45:00+10:00,2023-06-05,10:45,14,10,24
3,2023-06-05T10:44:00+10:00,2023-06-05,10:44,7,16,23
4,2023-06-05T10:44:00+10:00,2023-06-05,10:44,8,8,16
6,2023-06-05T10:44:00+10:00,2023-06-05,10:44,9,4,13
26,2023-06-05T10:44:00+10:00,2023-06-05,10:44,0,5,5
37,2023-06-05T10:44:00+10:00,2023-06-05,10:44,1,1,2
40,2023-06-05T10:44:00+10:00,2023-06-05,10:44,0,4,4
41,2023-06-05T10:44:00+10:00,2023-06-05,10:44,6,8,14
42,2023-06-05T10:44:00+10:00,2023-06-05,10:44,1,1,2
50,2023-06-05T10:44:00+10:00,2023-06-05,10:44,1,2,3
55,2023-06-05T10:44:00+10:00,2023-06-05,10:44,4,16,20
61,2023-06-05T10:44:00+10:00,2023-06-05,10:44,1,4,5
65,2023-06-05T10:44:00+10:00,2023-06-05,10:44,3,0,3
69,2023-06-05T10:44:00+10:00,2023-06-05,10:44,3,3,6
70,2023-06-05T10:44:00+10:00,2023-06-05,10:44,1,2,3
1,2023-06-05T10:44:00+10:00,2023-06-05,10:44,9,10,19
9,2023-06-05T10:44:00+10:00,2023-06-05,10:44,3,1,4
12,2023-06-05T10:44:00+10:00,2023-06-05,10:44,2,0,2
17,2023-06-05T10:44:00+10:00,2023-06-05,10:44,3,3,6
23,2023-06-05T10:44:00+10:00,2023-06-05,10:44,2,1,3
48,2023-06-05T10:44:00+10:00,2023-06-05,10:44,1,0,1
51,2023-06-05T10:44:00+10:00,2023-06-05,10:44,2,0,2
53,2023-06-05T10:44:00+10:00,2023-06-05,10:44,5,7,12
57,2023-06-05T10:44:00+10:00,2023-06-05,10:44,4,3,7
58,2023-06-05T10:44:00+10:00,2023-06-05,10:44,2,5,7
62,2023-06-05T10:44:00+10:00,2023-06-05,10:44,1,1,2
5,2023-06-05T10:44:00+10:00,2023-06-05,10:44,1,9,10
28,2023-06-05T10:44:00+10:00,2023-06-05,10:44,4,5,9
31,2023-06-05T10:44:00+10:00,2023-06-05,10:44,0,2,2
36,2023-06-05T10:44:00+10:00,2023-06-05,10:44,2,2,4
39,2023-06-05T10:44:00+10:00,2023-06-05,10:44,1,2,3
45,2023-06-05T10:44:00+10:00,2023-06-05,10:44,12,3,15
47,2023-06-05T10:44:00+10:00,2023-06-05,10:44,8,12,20
54,2023-06-05T10:44:00+10:00,2023-06-05,10:44,2,0,2
66,2023-06-05T10:44:00+10:00,2023-06-05,10:44,3,6,9
75,2023-06-05T10:44:00+10:00,2023-06-05,10:44,1,0,1
77,2023-06-05T10:44:00+10:00,2023-06-05,10:44,2,1,3
18,2023-06-05T10:44:00+10:00,2023-06-05,10:44,5,4,9
27,2023-06-05T10:44:00+10:00,2023-06-05,10:44,2,0,2
46,2023-06-05T10:44:00+10:00,2023-06-05,10:44,0,4,4
56,2023-06-05T10:44:00+10:00,2023-06-05,10:44,2,3,5
67,2023-06-05T10:44:00+10:00,2023-06-05,10:44,3,8,11
68,2023-06-05T10:44:00+10:00,2023-06-05,10:44,3,3,6
85,2023-06-05T10:44:00+10:00,2023-06-05,10:44,1,0,1
8,2023-06-05T10:44:00+10:00,2023-06-05,10:44,2,6,8
14,2023-06-05T10:44:00+10:00,2023-06-05,10:44,8,6,14
21,2023-06-05T10:44:00+10:00,2023-06-05,10:44,2,9,11
87,2023-06-05T10:44:00+10:00,2023-06-05,10:44,0,1,1
108,2023-06-05T10:44:00+10:00,2023-06-05,10:44,3,1,4
2,2023-06-05T10:44:00+10:00,2023-06-05,10:44,5,2,7
10,2023-06-05T10:44:00+10:00,2023-06-05,10:44,1,0,1
19,2023-06-05T10:44:00+10:00,2023-06-05,10:44,1,0,1
24,2023-06-05T10:44:00+10:00,2023-06-05,10:44,7,6,13
30,2023-06-05T10:44:00+10:00,2023-06-05,10:44,0,2,2
35,2023-06-05T10:44:00+10:00,2023-06-05,10:44,2,7,9
49,2023-06-05T10:44:00+10:00,2023-06-05,10:44,1,0,1
52,2023-06-05T10:44:00+10:00,2023-06-05,10:44,2,1,3
63,2023-06-05T10:44:00+10:00,2023-06-05,10:44,0,7,7
72,2023-06-05T10:44:00+10:00,2023-06-05,10:44,4,5,9
76,2023-06-05T10:44:00+10:00,2023-06-05,10:44,0,1,1
79,2023-06-05T10:44:00+10:00,2023-06-05,10:44,9,3,12
86,2023-06-05T10:44:00+10:00,2023-06-05,10:44,1,1,2
8,2023-06-05T10:43:00+10:00,2023-06-05,10:43,1,2,3
26,2023-06-05T10:43:00+10:00,2023-06-05,10:43,0,2,2
31,2023-06-05T10:43:00+10:00,2023-06-05,10:43,1,2,3
36,2023-06-05T10:43:00+10:00,2023-06-05,10:43,1,0,1
40,2023-06-05T10:43:00+10:00,2023-06-05,10:43,2,3,5
42,2023-06-05T10:43:00+10:00,2023-06-05,10:43,1,0,1
44,2023-06-05T10:43:00+10:00,2023-06-05,10:43,2,0,2
45,2023-06-05T10:43:00+10:00,2023-06-05,10:43,5,3,8
61,2023-06-05T10:43:00+10:00,2023-06-05,10:43,2,4,6
65,2023-06-05T10:43:00+10:00,2023-06-05,10:43,3,18,21
66,2023-06-05T10:43:00+10:00,2023-06-05,10:43,4,2,6
78,2023-06-05T10:43:00+10:00,2023-06-05,10:43,1,1,2
1,2023-06-05T10:43:00+10:00,2023-06-05,10:43,7,13,20
9,2023-06-05T10:43:00+10:00,2023-06-05,10:43,2,2,4
12,2023-06-05T10:43:00+10:00,2023-06-05,10:43,0,1,1
20,2023-06-05T10:43:00+10:00,2023-06-05,10:43,4,2,6
46,2023-06-05T10:43:00+10:00,2023-06-05,10:43,0,1,1
48,2023-06-05T10:43:00+10:00,2023-06-05,10:43,3,1,4
52,2023-06-05T10:43:00+10:00,2023-06-05,10:43,6,0,6
56,2023-06-05T10:43:00+10:00,2023-06-05,10:43,2,5,7
57,2023-06-05T10:43:00+10:00,2023-06-05,10:43,4,0,4
67,2023-06-05T10:43:00+10:00,2023-06-05,10:43,8,5,13
85,2023-06-05T10:43:00+10:00,2023-06-05,10:43,4,0,4
3,2023-06-05T10:43:00+10:00,2023-06-05,10:43,3,8,11
4,2023-06-05T10:43:00+10:00,2023-06-05,10:43,23,7,30
6,2023-06-05T10:43:00+10:00,2023-06-05,10:43,6,8,14
14,2023-06-05T10:43:00+10:00,2023-06-05,10:43,4,4,8
21,2023-06-05T10:43:00+10:00,2023-06-05,10:43,11,3,14
55,2023-06-05T10:43:00+10:00,2023-06-05,10:43,6,12,18
75,2023-06-05T10:43:00+10:00,2023-06-05,10:43,1,0,1
2,2023-06-05T10:43:00+10:00,2023-06-05,10:43,5,5,10
11,2023-06-05T10:43:00+10:00,2023-06-05,10:43,0,2,2
19,2023-06-05T10:43:00+10:00,2023-06-05,10:43,3,1,4
24,2023-06-05T10:43:00+10:00,2023-06-05,10:43,11,7,18
30,2023-06-05T10:43:00+10:00,2023-06-05,10:43,2,1,3
35,2023-06-05T10:43:00+10:00,2023-06-05,10:43,13,3,16
62,2023-06-05T10:43:00+10:00,2023-06-05,10:43,1,2,3
68,2023-06-05T10:43:00+10:00,2023-06-05,10:43,0,2,2
76,2023-06-05T10:43:00+10:00,2023-06-05,10:43,0,2,2
5,2023-06-05T10:43:00+10:00,2023-06-05,10:43,6,6,12
28,2023-06-05T10:43:00+10:00,2023-06-05,10:43,8,2,10
37,2023-06-05T10:43:00+10:00,2023-06-05,10:43,0,1,1
39,2023-06-05T10:43:00+10:00,2023-06-05,10:43,2,4,6
41,2023-06-05T10:43:00+10:00,2023-06-05,10:43,19,10,29
47,2023-06-05T10:43:00+10:00,2023-06-05,10:43,0,4,4
50,2023-06-05T10:43:00+10:00,2023-06-05,10:43,0,2,2
69,2023-06-05T10:43:00+10:00,2023-06-05,10:43,5,1,6
70,2023-06-05T10:43:00+10:00,2023-06-05,10:43,1,2,3
71,2023-06-05T10:43:00+10:00,2023-06-05,10:43,2,1,3
77,2023-06-05T10:43:00+10:00,2023-06-05,10:43,1,1,2
108,2023-06-05T10:43:00+10:00,2023-06-05,10:43,6,5,11
10,2023-06-05T10:43:00+10:00,2023-06-05,10:43,0,3,3
17,2023-06-05T10:43:00+10:00,2023-06-05,10:43,8,8,16
18,2023-06-05T10:43:00+10:00,2023-06-05,10:43,0,4,4
23,2023-06-05T10:43:00+10:00,2023-06-05,10:43,1,9,10
51,2023-06-05T10:43:00+10:00,2023-06-05,10:43,2,2,4
53,2023-06-05T10:43:00+10:00,2023-06-05,10:43,7,12,19
58,2023-06-05T10:43:00+10:00,2023-06-05,10:43,4,2,6
63,2023-06-05T10:43:00+10:00,2023-06-05,10:43,2,3,5
72,2023-06-05T10:43:00+10:00,2023-06-05,10:43,2,7,9
79,2023-06-05T10:43:00+10:00,2023-06-05,10:43,2,3,5
4,2023-06-05T10:42:00+10:00,2023-06-05,10:42,11,14,25
6,2023-06-05T10:42:00+10:00,2023-06-05,10:42,8,0,8
31,2023-06-05T10:42:00+10:00,2023-06-05,10:42,1,1,2
36,2023-06-05T10:42:00+10:00,2023-06-05,10:42,6,3,9
37,2023-06-05T10:42:00+10:00,2023-06-05,10:42,1,0,1
54,2023-06-05T10:42:00+10:00,2023-06-05,10:42,0,1,1
69,2023-06-05T10:42:00+10:00,2023-06-05,10:42,10,3,13
70,2023-06-05T10:42:00+10:00,2023-06-05,10:42,2,0,2
108,2023-06-05T10:42:00+10:00,2023-06-05,10:42,2,10,12
10,2023-06-05T10:42:00+10:00,2023-06-05,10:42,1,0,1
12,2023-06-05T10:42:00+10:00,2023-06-05,10:42,1,3,4
17,2023-06-05T10:42:00+10:00,2023-06-05,10:42,11,9,20
19,2023-06-05T10:42:00+10:00,2023-06-05,10:42,1,0,1
27,2023-06-05T10:42:00+10:00,2023-06-05,10:42,3,2,5
35,2023-06-05T10:42:00+10:00,2023-06-05,10:42,10,2,12
49,2023-06-05T10:42:00+10:00,2023-06-05,10:42,2,0,2
53,2023-06-05T10:42:00+10:00,2023-06-05,10:42,7,8,15
57,2023-06-05T10:42:00+10:00,2023-06-05,10:42,0,2,2
62,2023-06-05T10:42:00+10:00,2023-06-05,10:42,1,0,1
67,2023-06-05T10:42:00+10:00,2023-06-05,10:42,2,8,10
68,2023-06-05T10:42:00+10:00,2023-06-05,10:42,2,1,3
85,2023-06-05T10:42:00+10:00,2023-06-05,10:42,0,1,1
14,2023-06-05T10:42:00+10:00,2023-06-05,10:42,0,1,1
21,2023-06-05T10:42:00+10:00,2023-06-05,10:42,1,6,7
26,2023-06-05T10:42:00+10:00,2023-06-05,10:42,1,3,4
40,2023-06-05T10:42:00+10:00,2023-06-05,10:42,7,2,9
44,2023-06-05T10:42:00+10:00,2023-06-05,10:42,0,5,5
55,2023-06-05T10:42:00+10:00,2023-06-05,10:42,5,11,16
65,2023-06-05T10:42:00+10:00,2023-06-05,10:42,6,7,13
87,2023-06-05T10:42:00+10:00,2023-06-05,10:42,1,4,5
1,2023-06-05T10:42:00+10:00,2023-06-05,10:42,9,3,12
2,2023-06-05T10:42:00+10:00,2023-06-05,10:42,5,6,11
18,2023-06-05T10:42:00+10:00,2023-06-05,10:42,2,3,5
23,2023-06-05T10:42:00+10:00,2023-06-05,10:42,3,4,7
46,2023-06-05T10:42:00+10:00,2023-06-05,10:42,1,2,3
48,2023-06-05T10:42:00+10:00,2023-06-05,10:42,4,1,5
51,2023-06-05T10:42:00+10:00,2023-06-05,10:42,0,2,2
52,2023-06-05T10:42:00+10:00,2023-06-05,10:42,6,5,11
56,2023-06-05T10:42:00+10:00,2023-06-05,10:42,2,0,2
58,2023-06-05T10:42:00+10:00,2023-06-05,10:42,10,3,13
63,2023-06-05T10:42:00+10:00,2023-06-05,10:42,1,5,6
72,2023-06-05T10:42:00+10:00,2023-06-05,10:42,5,2,7
3,2023-06-05T10:42:00+10:00,2023-06-05,10:42,10,5,15
5,2023-06-05T10:42:00+10:00,2023-06-05,10:42,4,11,15
8,2023-06-05T10:42:00+10:00,2023-06-05,10:42,3,3,6
28,2023-06-05T10:42:00+10:00,2023-06-05,10:42,5,1,6
41,2023-06-05T10:42:00+10:00,2023-06-05,10:42,15,8,23
42,2023-06-05T10:42:00+10:00,2023-06-05,10:42,1,6,7
45,2023-06-05T10:42:00+10:00,2023-06-05,10:42,3,10,13
47,2023-06-05T10:42:00+10:00,2023-06-05,10:42,9,4,13
50,2023-06-05T10:42:00+10:00,2023-06-05,10:42,2,1,3
61,2023-06-05T10:42:00+10:00,2023-06-05,10:42,5,2,7
66,2023-06-05T10:42:00+10:00,2023-06-05,10:42,10,5,15
9,2023-06-05T10:42:00+10:00,2023-06-05,10:42,2,7,9
24,2023-06-05T10:42:00+10:00,2023-06-05,10:42,7,5,12
30,2023-06-05T10:42:00+10:00,2023-06-05,10:42,2,0,2
76,2023-06-05T10:42:00+10:00,2023-06-05,10:42,1,3,4
79,2023-06-05T10:42:00+10:00,2023-06-05,10:42,3,5,8
4,2023-06-05T10:41:00+10:00,2023-06-05,10:41,19,7,26
14,2023-06-05T10:41:00+10:00,2023-06-05,10:41,4,0,4
26,2023-06-05T10:41:00+10:00,2023-06-05,10:41,4,1,5
31,2023-06-05T10:41:00+10:00,2023-06-05,10:41,7,6,13
40,2023-06-05T10:41:00+10:00,2023-06-05,10:41,8,1,9
44,2023-06-05T10:41:00+10:00,2023-06-05,10:41,1,0,1
47,2023-06-05T10:41:00+10:00,2023-06-05,10:41,6,9,15
65,2023-06-05T10:41:00+10:00,2023-06-05,10:41,4,1,5
87,2023-06-05T10:41:00+10:00,2023-06-05,10:41,0,2,2
2,2023-06-05T10:41:00+10:00,2023-06-05,10:41,5,8,13
19,2023-06-05T10:41:00+10:00,2023-06-05,10:41,2,1,3
30,2023-06-05T10:41:00+10:00,2023-06-05,10:41,2,1,3
57,2023-06-05T10:41:00+10:00,2023-06-05,10:41,1,3,4
29,2023-06-05T10:41:00+10:00,2023-06-05,10:41,1,1,2
55,2023-06-05T10:41:00+10:00,2023-06-05,10:41,3,7,10
61,2023-06-05T10:41:00+10:00,2023-06-05,10:41,12,4,16
66,2023-06-05T10:41:00+10:00,2023-06-05,10:41,4,7,11
70,2023-06-05T10:41:00+10:00,2023-06-05,10:41,5,2,7
75,2023-06-05T10:41:00+10:00,2023-06-05,10:41,3,0,3
17,2023-06-05T10:41:00+10:00,2023-06-05,10:41,3,6,9
20,2023-06-05T10:41:00+10:00,2023-06-05,10:41,3,0,3
23,2023-06-05T10:41:00+10:00,2023-06-05,10:41,1,2,3
27,2023-06-05T10:41:00+10:00,2023-06-05,10:41,1,0,1
35,2023-06-05T10:41:00+10:00,2023-06-05,10:41,5,9,14
46,2023-06-05T10:41:00+10:00,2023-06-05,10:41,0,3,3
48,2023-06-05T10:41:00+10:00,2023-06-05,10:41,3,1,4
51,2023-06-05T10:41:00+10:00,2023-06-05,10:41,2,0,2
62,2023-06-05T10:41:00+10:00,2023-06-05,10:41,1,0,1
67,2023-06-05T10:41:00+10:00,2023-06-05,10:41,8,5,13
68,2023-06-05T10:41:00+10:00,2023-06-05,10:41,5,2,7
79,2023-06-05T10:41:00+10:00,2023-06-05,10:41,6,8,14
86,2023-06-05T10:41:00+10:00,2023-06-05,10:41,0,1,1
3,2023-06-05T10:41:00+10:00,2023-06-05,10:41,7,3,10
5,2023-06-05T10:41:00+10:00,2023-06-05,10:41,4,8,12
6,2023-06-05T10:41:00+10:00,2023-06-05,10:41,6,2,8
8,2023-06-05T10:41:00+10:00,2023-06-05,10:41,3,2,5
21,2023-06-05T10:41:00+10:00,2023-06-05,10:41,4,3,7
28,2023-06-05T10:41:00+10:00,2023-06-05,10:41,11,0,11
36,2023-06-05T10:41:00+10:00,2023-06-05,10:41,3,1,4
37,2023-06-05T10:41:00+10:00,2023-06-05,10:41,1,0,1
39,2023-06-05T10:41:00+10:00,2023-06-05,10:41,5,1,6
41,2023-06-05T10:41:00+10:00,2023-06-05,10:41,10,8,18
42,2023-06-05T10:41:00+10:00,2023-06-05,10:41,0,4,4
45,2023-06-05T10:41:00+10:00,2023-06-05,10:41,2,8,10
69,2023-06-05T10:41:00+10:00,2023-06-05,10:41,3,3,6
108,2023-06-05T10:41:00+10:00,2023-06-05,10:41,5,2,7
1,2023-06-05T10:41:00+10:00,2023-06-05,10:41,4,6,10
9,2023-06-05T10:41:00+10:00,2023-06-05,10:41,2,3,5
11,2023-06-05T10:41:00+10:00,2023-06-05,10:41,0,1,1
12,2023-06-05T10:41:00+10:00,2023-06-05,10:41,1,2,3
18,2023-06-05T10:41:00+10:00,2023-06-05,10:41,4,4,8
24,2023-06-05T10:41:00+10:00,2023-06-05,10:41,11,3,14
52,2023-06-05T10:41:00+10:00,2023-06-05,10:41,1,6,7
53,2023-06-05T10:41:00+10:00,2023-06-05,10:41,6,10,16
56,2023-06-05T10:41:00+10:00,2023-06-05,10:41,2,2,4
58,2023-06-05T10:41:00+10:00,2023-06-05,10:41,4,2,6
63,2023-06-05T10:41:00+10:00,2023-06-05,10:41,2,4,6
72,2023-06-05T10:41:00+10:00,2023-06-05,10:41,1,2,3
76,2023-06-05T10:41:00+10:00,2023-06-05,10:41,2,1,3
4,2023-06-05T10:40:00+10:00,2023-06-05,10:40,16,6,22
6,2023-06-05T10:40:00+10:00,2023-06-05,10:40,3,2,5
36,2023-06-05T10:40:00+10:00,2023-06-05,10:40,1,1,2
55,2023-06-05T10:40:00+10:00,2023-06-05,10:40,10,5,15
59,2023-06-05T10:40:00+10:00,2023-06-05,10:40,39,29,68
18,2023-06-05T10:40:00+10:00,2023-06-05,10:40,1,7,8
23,2023-06-05T10:40:00+10:00,2023-06-05,10:40,4,1,5
24,2023-06-05T10:40:00+10:00,2023-06-05,10:40,7,6,13
53,2023-06-05T10:40:00+10:00,2023-06-05,10:40,6,8,14
56,2023-06-05T10:40:00+10:00,2023-06-05,10:40,1,0,1
57,2023-06-05T10:40:00+10:00,2023-06-05,10:40,2,1,3
58,2023-06-05T10:40:00+10:00,2023-06-05,10:40,10,3,13
62,2023-06-05T10:40:00+10:00,2023-06-05,10:40,1,0,1
79,2023-06-05T10:40:00+10:00,2023-06-05,10:40,4,4,8
109,2023-06-05T10:40:00+10:00,2023-06-05,10:40,10,26,36
117,2023-06-05T10:40:00+10:00,2023-06-05,10:40,9,14,23
3,2023-06-05T10:40:00+10:00,2023-06-05,10:40,8,8,16
5,2023-06-05T10:40:00+10:00,2023-06-05,10:40,3,14,17
8,2023-06-05T10:40:00+10:00,2023-06-05,10:40,1,4,5
21,2023-06-05T10:40:00+10:00,2023-06-05,10:40,3,3,6
28,2023-06-05T10:40:00+10:00,2023-06-05,10:40,8,2,10
37,2023-06-05T10:40:00+10:00,2023-06-05,10:40,1,2,3
41,2023-06-05T10:40:00+10:00,2023-06-05,10:40,19,10,29
42,2023-06-05T10:40:00+10:00,2023-06-05,10:40,0,3,3
47,2023-06-05T10:40:00+10:00,2023-06-05,10:40,8,6,14
54,2023-06-05T10:40:00+10:00,2023-06-05,10:40,2,0,2
61,2023-06-05T10:40:00+10:00,2023-06-05,10:40,3,4,7
65,2023-06-05T10:40:00+10:00,2023-06-05,10:40,1,5,6
66,2023-06-05T10:40:00+10:00,2023-06-05,10:40,5,5,10
69,2023-06-05T10:40:00+10:00,2023-06-05,10:40,1,0,1
75,2023-06-05T10:40:00+10:00,2023-06-05,10:40,0,1,1
84,2023-06-05T10:40:00+10:00,2023-06-05,10:40,42,48,90
87,2023-06-05T10:40:00+10:00,2023-06-05,10:40,1,0,1
11,2023-06-05T10:40:00+10:00,2023-06-05,10:40,0,1,1
12,2023-06-05T10:40:00+10:00,2023-06-05,10:40,2,0,2
27,2023-06-05T10:40:00+10:00,2023-06-05,10:40,0,1,1
30,2023-06-05T10:40:00+10:00,2023-06-05,10:40,2,1,3
35,2023-06-05T10:40:00+10:00,2023-06-05,10:40,9,5,14
51,2023-06-05T10:40:00+10:00,2023-06-05,10:40,0,2,2
76,2023-06-05T10:40:00+10:00,2023-06-05,10:40,3,3,6
14,2023-06-05T10:40:00+10:00,2023-06-05,10:40,4,3,7
26,2023-06-05T10:40:00+10:00,2023-06-05,10:40,4,3,7
29,2023-06-05T10:40:00+10:00,2023-06-05,10:40,0,6,6
31,2023-06-05T10:40:00+10:00,2023-06-05,10:40,5,8,13
40,2023-06-05T10:40:00+10:00,2023-06-05,10:40,5,3,8
45,2023-06-05T10:40:00+10:00,2023-06-05,10:40,4,1,5
50,2023-06-05T10:40:00+10:00,2023-06-05,10:40,4,3,7
70,2023-06-05T10:40:00+10:00,2023-06-05,10:40,2,2,4
77,2023-06-05T10:40:00+10:00,2023-06-05,10:40,2,1,3
107,2023-06-05T10:40:00+10:00,2023-06-05,10:40,11,13,24
108,2023-06-05T10:40:00+10:00,2023-06-05,10:40,2,1,3
118,2023-06-05T10:40:00+10:00,2023-06-05,10:40,0,1,1
1,2023-06-05T10:40:00+10:00,2023-06-05,10:40,12,10,22
2,2023-06-05T10:40:00+10:00,2023-06-05,10:40,5,3,8
9,2023-06-05T10:40:00+10:00,2023-06-05,10:40,6,1,7
10,2023-06-05T10:40:00+10:00,2023-06-05,10:40,1,3,4
17,2023-06-05T10:40:00+10:00,2023-06-05,10:40,6,7,13
19,2023-06-05T10:40:00+10:00,2023-06-05,10:40,6,1,7
20,2023-06-05T10:40:00+10:00,2023-06-05,10:40,3,1,4
46,2023-06-05T10:40:00+10:00,2023-06-05,10:40,0,6,6
52,2023-06-05T10:40:00+10:00,2023-06-05,10:40,5,1,6
63,2023-06-05T10:40:00+10:00,2023-06-05,10:40,1,0,1
67,2023-06-05T10:40:00+10:00,2023-06-05,10:40,5,5,10
68,2023-06-05T10:40:00+10:00,2023-06-05,10:40,4,2,6
86,2023-06-05T10:40:00+10:00,2023-06-05,10:40,0,1,1
4,2023-06-05T10:39:00+10:00,2023-06-05,10:39,23,9,32
14,2023-06-05T10:39:00+10:00,2023-06-05,10:39,1,0,1
29,2023-06-05T10:39:00+10:00,2023-06-05,10:39,2,47,49
36,2023-06-05T10:39:00+10:00,2023-06-05,10:39,5,0,5
37,2023-06-05T10:39:00+10:00,2023-06-05,10:39,1,0,1
42,2023-06-05T10:39:00+10:00,2023-06-05,10:39,4,0,4
65,2023-06-05T10:39:00+10:00,2023-06-05,10:39,1,6,7
66,2023-06-05T10:39:00+10:00,2023-06-05,10:39,13,2,15
71,2023-06-05T10:39:00+10:00,2023-06-05,10:39,0,1,1
77,2023-06-05T10:39:00+10:00,2023-06-05,10:39,0,1,1
1,2023-06-05T10:39:00+10:00,2023-06-05,10:39,10,11,21
9,2023-06-05T10:39:00+10:00,2023-06-05,10:39,0,5,5
19,2023-06-05T10:39:00+10:00,2023-06-05,10:39,2,2,4
20,2023-06-05T10:39:00+10:00,2023-06-05,10:39,0,2,2
46,2023-06-05T10:39:00+10:00,2023-06-05,10:39,1,1,2
48,2023-06-05T10:39:00+10:00,2023-06-05,10:39,1,7,8
85,2023-06-05T10:39:00+10:00,2023-06-05,10:39,1,0,1
6,2023-06-05T10:39:00+10:00,2023-06-05,10:39,2,8,10
8,2023-06-05T10:39:00+10:00,2023-06-05,10:39,0,3,3
21,2023-06-05T10:39:00+10:00,2023-06-05,10:39,3,0,3
28,2023-06-05T10:39:00+10:00,2023-06-05,10:39,8,5,13
40,2023-06-05T10:39:00+10:00,2023-06-05,10:39,2,7,9
41,2023-06-05T10:39:00+10:00,2023-06-05,10:39,23,14,37
61,2023-06-05T10:39:00+10:00,2023-06-05,10:39,3,10,13
69,2023-06-05T10:39:00+10:00,2023-06-05,10:39,3,1,4
87,2023-06-05T10:39:00+10:00,2023-06-05,10:39,2,2,4
108,2023-06-05T10:39:00+10:00,2023-06-05,10:39,3,8,11
2,2023-06-05T10:39:00+10:00,2023-06-05,10:39,6,2,8
23,2023-06-05T10:39:00+10:00,2023-06-05,10:39,2,8,10
35,2023-06-05T10:39:00+10:00,2023-06-05,10:39,5,4,9
52,2023-06-05T10:39:00+10:00,2023-06-05,10:39,4,0,4
58,2023-06-05T10:39:00+10:00,2023-06-05,10:39,8,1,9
62,2023-06-05T10:39:00+10:00,2023-06-05,10:39,3,6,9
67,2023-06-05T10:39:00+10:00,2023-06-05,10:39,7,11,18
68,2023-06-05T10:39:00+10:00,2023-06-05,10:39,5,0,5
3,2023-06-05T10:39:00+10:00,2023-06-05,10:39,7,9,16
5,2023-06-05T10:39:00+10:00,2023-06-05,10:39,2,7,9
26,2023-06-05T10:39:00+10:00,2023-06-05,10:39,3,2,5
31,2023-06-05T10:39:00+10:00,2023-06-05,10:39,3,1,4
44,2023-06-05T10:39:00+10:00,2023-06-05,10:39,0,1,1
45,2023-06-05T10:39:00+10:00,2023-06-05,10:39,3,4,7
47,2023-06-05T10:39:00+10:00,2023-06-05,10:39,3,7,10
50,2023-06-05T10:39:00+10:00,2023-06-05,10:39,2,2,4
55,2023-06-05T10:39:00+10:00,2023-06-05,10:39,3,9,12
70,2023-06-05T10:39:00+10:00,2023-06-05,10:39,1,2,3
10,2023-06-05T10:39:00+10:00,2023-06-05,10:39,1,1,2
12,2023-06-05T10:39:00+10:00,2023-06-05,10:39,0,2,2
17,2023-06-05T10:39:00+10:00,2023-06-05,10:39,8,12,20
18,2023-06-05T10:39:00+10:00,2023-06-05,10:39,1,6,7
24,2023-06-05T10:39:00+10:00,2023-06-05,10:39,9,8,17
27,2023-06-05T10:39:00+10:00,2023-06-05,10:39,2,2,4
30,2023-06-05T10:39:00+10:00,2023-06-05,10:39,3,5,8
53,2023-06-05T10:39:00+10:00,2023-06-05,10:39,13,6,19
56,2023-06-05T10:39:00+10:00,2023-06-05,10:39,7,0,7
63,2023-06-05T10:39:00+10:00,2023-06-05,10:39,5,4,9
72,2023-06-05T10:39:00+10:00,2023-06-05,10:39,1,17,18
76,2023-06-05T10:39:00+10:00,2023-06-05,10:39,3,0,3
79,2023-06-05T10:39:00+10:00,2023-06-05,10:39,12,8,20
86,2023-06-05T10:39:00+10:00,2023-06-05,10:39,1,2,3
3,2023-06-05T10:38:00+10:00,2023-06-05,10:38,9,15,24
47,2023-06-05T10:38:00+10:00,2023-06-05,10:38,14,12,26
66,2023-06-05T10:38:00+10:00,2023-06-05,10:38,5,5,10
71,2023-06-05T10:38:00+10:00,2023-06-05,10:38,1,0,1
87,2023-06-05T10:38:00+10:00,2023-06-05,10:38,0,5,5
108,2023-06-05T10:38:00+10:00,2023-06-05,10:38,4,2,6
2,2023-06-05T10:38:00+10:00,2023-06-05,10:38,1,5,6
17,2023-06-05T10:38:00+10:00,2023-06-05,10:38,17,7,24
23,2023-06-05T10:38:00+10:00,2023-06-05,10:38,1,0,1
24,2023-06-05T10:38:00+10:00,2023-06-05,10:38,12,6,18
27,2023-06-05T10:38:00+10:00,2023-06-05,10:38,1,1,2
35,2023-06-05T10:38:00+10:00,2023-06-05,10:38,7,9,16
46,2023-06-05T10:38:00+10:00,2023-06-05,10:38,1,2,3
48,2023-06-05T10:38:00+10:00,2023-06-05,10:38,2,5,7
58,2023-06-05T10:38:00+10:00,2023-06-05,10:38,22,10,32
63,2023-06-05T10:38:00+10:00,2023-06-05,10:38,4,4,8
72,2023-06-05T10:38:00+10:00,2023-06-05,10:38,1,0,1
76,2023-06-05T10:38:00+10:00,2023-06-05,10:38,0,1,1
5,2023-06-05T10:38:00+10:00,2023-06-05,10:38,7,16,23
8,2023-06-05T10:38:00+10:00,2023-06-05,10:38,0,1,1
28,2023-06-05T10:38:00+10:00,2023-06-05,10:38,4,0,4
31,2023-06-05T10:38:00+10:00,2023-06-05,10:38,1,5,6
37,2023-06-05T10:38:00+10:00,2023-06-05,10:38,2,0,2
41,2023-06-05T10:38:00+10:00,2023-06-05,10:38,12,17,29
42,2023-06-05T10:38:00+10:00,2023-06-05,10:38,1,5,6
61,2023-06-05T10:38:00+10:00,2023-06-05,10:38,2,4,6
65,2023-06-05T10:38:00+10:00,2023-06-05,10:38,8,4,12
69,2023-06-05T10:38:00+10:00,2023-06-05,10:38,3,2,5
70,2023-06-05T10:38:00+10:00,2023-06-05,10:38,2,3,5
77,2023-06-05T10:38:00+10:00,2023-06-05,10:38,2,0,2
9,2023-06-05T10:38:00+10:00,2023-06-05,10:38,2,7,9
10,2023-06-05T10:38:00+10:00,2023-06-05,10:38,0,1,1
18,2023-06-05T10:38:00+10:00,2023-06-05,10:38,1,4,5
52,2023-06-05T10:38:00+10:00,2023-06-05,10:38,1,0,1
56,2023-06-05T10:38:00+10:00,2023-06-05,10:38,1,0,1
67,2023-06-05T10:38:00+10:00,2023-06-05,10:38,7,20,27
68,2023-06-05T10:38:00+10:00,2023-06-05,10:38,2,2,4
4,2023-06-05T10:38:00+10:00,2023-06-05,10:38,17,11,28
6,2023-06-05T10:38:00+10:00,2023-06-05,10:38,2,3,5
14,2023-06-05T10:38:00+10:00,2023-06-05,10:38,0,1,1
21,2023-06-05T10:38:00+10:00,2023-06-05,10:38,3,4,7
26,2023-06-05T10:38:00+10:00,2023-06-05,10:38,1,1,2
29,2023-06-05T10:38:00+10:00,2023-06-05,10:38,0,2,2
39,2023-06-05T10:38:00+10:00,2023-06-05,10:38,0,3,3
40,2023-06-05T10:38:00+10:00,2023-06-05,10:38,1,2,3
44,2023-06-05T10:38:00+10:00,2023-06-05,10:38,1,2,3
45,2023-06-05T10:38:00+10:00,2023-06-05,10:38,2,3,5
50,2023-06-05T10:38:00+10:00,2023-06-05,10:38,0,4,4
54,2023-06-05T10:38:00+10:00,2023-06-05,10:38,1,1,2
55,2023-06-05T10:38:00+10:00,2023-06-05,10:38,7,9,16
1,2023-06-05T10:38:00+10:00,2023-06-05,10:38,0,7,7
12,2023-06-05T10:38:00+10:00,2023-06-05,10:38,0,11,11
19,2023-06-05T10:38:00+10:00,2023-06-05,10:38,1,2,3
20,2023-06-05T10:38:00+10:00,2023-06-05,10:38,2,0,2
30,2023-06-05T10:38:00+10:00,2023-06-05,10:38,2,0,2
49,2023-06-05T10:38:00+10:00,2023-06-05,10:38,0,1,1
51,2023-06-05T10:38:00+10:00,2023-06-05,10:38,0,1,1
53,2023-06-05T10:38:00+10:00,2023-06-05,10:38,11,7,18
57,2023-06-05T10:38:00+10:00,2023-06-05,10:38,1,2,3
62,2023-06-05T10:38:00+10:00,2023-06-05,10:38,0,2,2
79,2023-06-05T10:38:00+10:00,2023-06-05,10:38,7,5,12
5,2023-06-05T10:37:00+10:00,2023-06-05,10:37,2,8,10
21,2023-06-05T10:37:00+10:00,2023-06-05,10:37,0,2,2
31,2023-06-05T10:37:00+10:00,2023-06-05,10:37,1,4,5
41,2023-06-05T10:37:00+10:00,2023-06-05,10:37,13,17,30
42,2023-06-05T10:37:00+10:00,2023-06-05,10:37,1,2,3
45,2023-06-05T10:37:00+10:00,2023-06-05,10:37,5,8,13
47,2023-06-05T10:37:00+10:00,2023-06-05,10:37,4,14,18
50,2023-06-05T10:37:00+10:00,2023-06-05,10:37,0,1,1
55,2023-06-05T10:37:00+10:00,2023-06-05,10:37,7,3,10
61,2023-06-05T10:37:00+10:00,2023-06-05,10:37,5,8,13
65,2023-06-05T10:37:00+10:00,2023-06-05,10:37,4,1,5
66,2023-06-05T10:37:00+10:00,2023-06-05,10:37,6,7,13
69,2023-06-05T10:37:00+10:00,2023-06-05,10:37,3,0,3
71,2023-06-05T10:37:00+10:00,2023-06-05,10:37,1,0,1
87,2023-06-05T10:37:00+10:00,2023-06-05,10:37,1,1,2
108,2023-06-05T10:37:00+10:00,2023-06-05,10:37,2,1,3
2,2023-06-05T10:37:00+10:00,2023-06-05,10:37,5,2,7
17,2023-06-05T10:37:00+10:00,2023-06-05,10:37,5,5,10
18,2023-06-05T10:37:00+10:00,2023-06-05,10:37,2,3,5
24,2023-06-05T10:37:00+10:00,2023-06-05,10:37,6,13,19
46,2023-06-05T10:37:00+10:00,2023-06-05,10:37,1,1,2
53,2023-06-05T10:37:00+10:00,2023-06-05,10:37,15,4,19
57,2023-06-05T10:37:00+10:00,2023-06-05,10:37,4,3,7
62,2023-06-05T10:37:00+10:00,2023-06-05,10:37,1,1,2
63,2023-06-05T10:37:00+10:00,2023-06-05,10:37,0,8,8
72,2023-06-05T10:37:00+10:00,2023-06-05,10:37,1,1,2
76,2023-06-05T10:37:00+10:00,2023-06-05,10:37,0,2,2
85,2023-06-05T10:37:00+10:00,2023-06-05,10:37,0,2,2
3,2023-06-05T10:37:00+10:00,2023-06-05,10:37,7,5,12
4,2023-06-05T10:37:00+10:00,2023-06-05,10:37,12,7,19
6,2023-06-05T10:37:00+10:00,2023-06-05,10:37,3,3,6
8,2023-06-05T10:37:00+10:00,2023-06-05,10:37,2,3,5
26,2023-06-05T10:37:00+10:00,2023-06-05,10:37,1,2,3
28,2023-06-05T10:37:00+10:00,2023-06-05,10:37,16,6,22
36,2023-06-05T10:37:00+10:00,2023-06-05,10:37,3,5,8
70,2023-06-05T10:37:00+10:00,2023-06-05,10:37,1,2,3
1,2023-06-05T10:37:00+10:00,2023-06-05,10:37,6,2,8
9,2023-06-05T10:37:00+10:00,2023-06-05,10:37,4,7,11
11,2023-06-05T10:37:00+10:00,2023-06-05,10:37,0,1,1
12,2023-06-05T10:37:00+10:00,2023-06-05,10:37,1,1,2
23,2023-06-05T10:37:00+10:00,2023-06-05,10:37,2,1,3
30,2023-06-05T10:37:00+10:00,2023-06-05,10:37,1,0,1
48,2023-06-05T10:37:00+10:00,2023-06-05,10:37,1,1,2
51,2023-06-05T10:37:00+10:00,2023-06-05,10:37,1,1,2
67,2023-06-05T10:37:00+10:00,2023-06-05,10:37,9,9,18
68,2023-06-05T10:37:00+10:00,2023-06-05,10:37,10,1,11
79,2023-06-05T10:37:00+10:00,2023-06-05,10:37,3,4,7
86,2023-06-05T10:37:00+10:00,2023-06-05,10:37,1,2,3
14,2023-06-05T10:37:00+10:00,2023-06-05,10:37,2,7,9
39,2023-06-05T10:37:00+10:00,2023-06-05,10:37,2,0,2
40,2023-06-05T10:37:00+10:00,2023-06-05,10:37,2,7,9
54,2023-06-05T10:37:00+10:00,2023-06-05,10:37,2,0,2
75,2023-06-05T10:37:00+10:00,2023-06-05,10:37,1,0,1
77,2023-06-05T10:37:00+10:00,2023-06-05,10:37,1,1,2
10,2023-06-05T10:37:00+10:00,2023-06-05,10:37,4,3,7
20,2023-06-05T10:37:00+10:00,2023-06-05,10:37,1,0,1
35,2023-06-05T10:37:00+10:00,2023-06-05,10:37,7,4,11
52,2023-06-05T10:37:00+10:00,2023-06-05,10:37,2,5,7
56,2023-06-05T10:37:00+10:00,2023-06-05,10:37,4,2,6
58,2023-06-05T10:37:00+10:00,2023-06-05,10:37,5,3,8
3,2023-06-05T10:36:00+10:00,2023-06-05,10:36,10,5,15
8,2023-06-05T10:36:00+10:00,2023-06-05,10:36,3,2,5
21,2023-06-05T10:36:00+10:00,2023-06-05,10:36,2,3,5
66,2023-06-05T10:36:00+10:00,2023-06-05,10:36,4,4,8
69,2023-06-05T10:36:00+10:00,2023-06-05,10:36,4,0,4
71,2023-06-05T10:36:00+10:00,2023-06-05,10:36,1,0,1
78,2023-06-05T10:36:00+10:00,2023-06-05,10:36,1,0,1
87,2023-06-05T10:36:00+10:00,2023-06-05,10:36,4,4,8
2,2023-06-05T10:36:00+10:00,2023-06-05,10:36,9,8,17
19,2023-06-05T10:36:00+10:00,2023-06-05,10:36,2,3,5
23,2023-06-05T10:36:00+10:00,2023-06-05,10:36,3,1,4
27,2023-06-05T10:36:00+10:00,2023-06-05,10:36,1,0,1
35,2023-06-05T10:36:00+10:00,2023-06-05,10:36,3,4,7
52,2023-06-05T10:36:00+10:00,2023-06-05,10:36,1,1,2
53,2023-06-05T10:36:00+10:00,2023-06-05,10:36,4,9,13
57,2023-06-05T10:36:00+10:00,2023-06-05,10:36,7,3,10
72,2023-06-05T10:36:00+10:00,2023-06-05,10:36,4,2,6
86,2023-06-05T10:36:00+10:00,2023-06-05,10:36,1,2,3
5,2023-06-05T10:36:00+10:00,2023-06-05,10:36,9,4,13
26,2023-06-05T10:36:00+10:00,2023-06-05,10:36,4,1,5
28,2023-06-05T10:36:00+10:00,2023-06-05,10:36,6,1,7
36,2023-06-05T10:36:00+10:00,2023-06-05,10:36,2,3,5
42,2023-06-05T10:36:00+10:00,2023-06-05,10:36,5,1,6
45,2023-06-05T10:36:00+10:00,2023-06-05,10:36,7,1,8
47,2023-06-05T10:36:00+10:00,2023-06-05,10:36,3,7,10
50,2023-06-05T10:36:00+10:00,2023-06-05,10:36,4,1,5
55,2023-06-05T10:36:00+10:00,2023-06-05,10:36,3,14,17
70,2023-06-05T10:36:00+10:00,2023-06-05,10:36,0,5,5
77,2023-06-05T10:36:00+10:00,2023-06-05,10:36,2,1,3
108,2023-06-05T10:36:00+10:00,2023-06-05,10:36,8,4,12
1,2023-06-05T10:36:00+10:00,2023-06-05,10:36,9,12,21
9,2023-06-05T10:36:00+10:00,2023-06-05,10:36,2,5,7
17,2023-06-05T10:36:00+10:00,2023-06-05,10:36,6,9,15
24,2023-06-05T10:36:00+10:00,2023-06-05,10:36,12,1,13
49,2023-06-05T10:36:00+10:00,2023-06-05,10:36,4,2,6
63,2023-06-05T10:36:00+10:00,2023-06-05,10:36,4,0,4
68,2023-06-05T10:36:00+10:00,2023-06-05,10:36,6,2,8
4,2023-06-05T10:36:00+10:00,2023-06-05,10:36,17,10,27
6,2023-06-05T10:36:00+10:00,2023-06-05,10:36,3,2,5
14,2023-06-05T10:36:00+10:00,2023-06-05,10:36,3,9,12
29,2023-06-05T10:36:00+10:00,2023-06-05,10:36,0,1,1
31,2023-06-05T10:36:00+10:00,2023-06-05,10:36,1,6,7
39,2023-06-05T10:36:00+10:00,2023-06-05,10:36,1,2,3
40,2023-06-05T10:36:00+10:00,2023-06-05,10:36,4,3,7
41,2023-06-05T10:36:00+10:00,2023-06-05,10:36,42,9,51
54,2023-06-05T10:36:00+10:00,2023-06-05,10:36,3,1,4
61,2023-06-05T10:36:00+10:00,2023-06-05,10:36,2,7,9
65,2023-06-05T10:36:00+10:00,2023-06-05,10:36,15,2,17
10,2023-06-05T10:36:00+10:00,2023-06-05,10:36,3,1,4
18,2023-06-05T10:36:00+10:00,2023-06-05,10:36,5,6,11
20,2023-06-05T10:36:00+10:00,2023-06-05,10:36,5,4,9
51,2023-06-05T10:36:00+10:00,2023-06-05,10:36,1,1,2
56,2023-06-05T10:36:00+10:00,2023-06-05,10:36,2,1,3
58,2023-06-05T10:36:00+10:00,2023-06-05,10:36,11,0,11
62,2023-06-05T10:36:00+10:00,2023-06-05,10:36,0,6,6
67,2023-06-05T10:36:00+10:00,2023-06-05,10:36,9,3,12
76,2023-06-05T10:36:00+10:00,2023-06-05,10:36,0,2,2
79,2023-06-05T10:36:00+10:00,2023-06-05,10:36,4,7,11
85,2023-06-05T10:36:00+10:00,2023-06-05,10:36,2,2,4
3,2023-06-05T10:35:00+10:00,2023-06-05,10:35,6,3,9
5,2023-06-05T10:35:00+10:00,2023-06-05,10:35,2,8,10
21,2023-06-05T10:35:00+10:00,2023-06-05,10:35,3,3,6
41,2023-06-05T10:35:00+10:00,2023-06-05,10:35,20,13,33
54,2023-06-05T10:35:00+10:00,2023-06-05,10:35,1,2,3
59,2023-06-05T10:35:00+10:00,2023-06-05,10:35,39,22,61
61,2023-06-05T10:35:00+10:00,2023-06-05,10:35,5,5,10
66,2023-06-05T10:35:00+10:00,2023-06-05,10:35,4,2,6
78,2023-06-05T10:35:00+10:00,2023-06-05,10:35,0,2,2
84,2023-06-05T10:35:00+10:00,2023-06-05,10:35,47,39,86
108,2023-06-05T10:35:00+10:00,2023-06-05,10:35,9,1,10
9,2023-06-05T10:35:00+10:00,2023-06-05,10:35,1,4,5
11,2023-06-05T10:35:00+10:00,2023-06-05,10:35,1,1,2
12,2023-06-05T10:35:00+10:00,2023-06-05,10:35,1,0,1
17,2023-06-05T10:35:00+10:00,2023-06-05,10:35,6,9,15
18,2023-06-05T10:35:00+10:00,2023-06-05,10:35,5,2,7
27,2023-06-05T10:35:00+10:00,2023-06-05,10:35,1,0,1
30,2023-06-05T10:35:00+10:00,2023-06-05,10:35,3,3,6
49,2023-06-05T10:35:00+10:00,2023-06-05,10:35,0,5,5
52,2023-06-05T10:35:00+10:00,2023-06-05,10:35,2,2,4
53,2023-06-05T10:35:00+10:00,2023-06-05,10:35,10,10,20
56,2023-06-05T10:35:00+10:00,2023-06-05,10:35,3,3,6
58,2023-06-05T10:35:00+10:00,2023-06-05,10:35,10,3,13
63,2023-06-05T10:35:00+10:00,2023-06-05,10:35,2,4,6
72,2023-06-05T10:35:00+10:00,2023-06-05,10:35,5,2,7
85,2023-06-05T10:35:00+10:00,2023-06-05,10:35,2,0,2
117,2023-06-05T10:35:00+10:00,2023-06-05,10:35,10,5,15
4,2023-06-05T10:35:00+10:00,2023-06-05,10:35,9,11,20
6,2023-06-05T10:35:00+10:00,2023-06-05,10:35,8,2,10
8,2023-06-05T10:35:00+10:00,2023-06-05,10:35,1,2,3
14,2023-06-05T10:35:00+10:00,2023-06-05,10:35,5,2,7
28,2023-06-05T10:35:00+10:00,2023-06-05,10:35,5,3,8
29,2023-06-05T10:35:00+10:00,2023-06-05,10:35,0,2,2
36,2023-06-05T10:35:00+10:00,2023-06-05,10:35,1,2,3
42,2023-06-05T10:35:00+10:00,2023-06-05,10:35,3,1,4
45,2023-06-05T10:35:00+10:00,2023-06-05,10:35,3,5,8
47,2023-06-05T10:35:00+10:00,2023-06-05,10:35,3,3,6
50,2023-06-05T10:35:00+10:00,2023-06-05,10:35,2,2,4
71,2023-06-05T10:35:00+10:00,2023-06-05,10:35,1,2,3
75,2023-06-05T10:35:00+10:00,2023-06-05,10:35,0,1,1
77,2023-06-05T10:35:00+10:00,2023-06-05,10:35,2,0,2
87,2023-06-05T10:35:00+10:00,2023-06-05,10:35,0,6,6
107,2023-06-05T10:35:00+10:00,2023-06-05,10:35,2,12,14
2,2023-06-05T10:35:00+10:00,2023-06-05,10:35,4,3,7
24,2023-06-05T10:35:00+10:00,2023-06-05,10:35,9,2,11
35,2023-06-05T10:35:00+10:00,2023-06-05,10:35,5,6,11
51,2023-06-05T10:35:00+10:00,2023-06-05,10:35,2,2,4
57,2023-06-05T10:35:00+10:00,2023-06-05,10:35,5,7,12
67,2023-06-05T10:35:00+10:00,2023-06-05,10:35,7,6,13
68,2023-06-05T10:35:00+10:00,2023-06-05,10:35,3,1,4
79,2023-06-05T10:35:00+10:00,2023-06-05,10:35,6,4,10
109,2023-06-05T10:35:00+10:00,2023-06-05,10:35,11,22,33
26,2023-06-05T10:35:00+10:00,2023-06-05,10:35,5,1,6
31,2023-06-05T10:35:00+10:00,2023-06-05,10:35,1,3,4
39,2023-06-05T10:35:00+10:00,2023-06-05,10:35,1,3,4
40,2023-06-05T10:35:00+10:00,2023-06-05,10:35,2,5,7
44,2023-06-05T10:35:00+10:00,2023-06-05,10:35,1,0,1
55,2023-06-05T10:35:00+10:00,2023-06-05,10:35,5,2,7
65,2023-06-05T10:35:00+10:00,2023-06-05,10:35,5,3,8
69,2023-06-05T10:35:00+10:00,2023-06-05,10:35,5,2,7
70,2023-06-05T10:35:00+10:00,2023-06-05,10:35,2,1,3
118,2023-06-05T10:35:00+10:00,2023-06-05,10:35,2,1,3
1,2023-06-05T10:35:00+10:00,2023-06-05,10:35,7,8,15
10,2023-06-05T10:35:00+10:00,2023-06-05,10:35,1,0,1
19,2023-06-05T10:35:00+10:00,2023-06-05,10:35,1,3,4
23,2023-06-05T10:35:00+10:00,2023-06-05,10:35,2,0,2
46,2023-06-05T10:35:00+10:00,2023-06-05,10:35,0,2,2
48,2023-06-05T10:35:00+10:00,2023-06-05,10:35,0,1,1
62,2023-06-05T10:35:00+10:00,2023-06-05,10:35,2,0,2
14,2023-06-05T10:34:00+10:00,2023-06-05,10:34,7,28,35
36,2023-06-05T10:34:00+10:00,2023-06-05,10:34,4,4,8
37,2023-06-05T10:34:00+10:00,2023-06-05,10:34,0,2,2
45,2023-06-05T10:34:00+10:00,2023-06-05,10:34,6,4,10
50,2023-06-05T10:34:00+10:00,2023-06-05,10:34,2,4,6
55,2023-06-05T10:34:00+10:00,2023-06-05,10:34,0,5,5
65,2023-06-05T10:34:00+10:00,2023-06-05,10:34,1,2,3
70,2023-06-05T10:34:00+10:00,2023-06-05,10:34,2,5,7
75,2023-06-05T10:34:00+10:00,2023-06-05,10:34,3,0,3
77,2023-06-05T10:34:00+10:00,2023-06-05,10:34,2,3,5
1,2023-06-05T10:34:00+10:00,2023-06-05,10:34,9,7,16
9,2023-06-05T10:34:00+10:00,2023-06-05,10:34,0,8,8
17,2023-06-05T10:34:00+10:00,2023-06-05,10:34,2,2,4
19,2023-06-05T10:34:00+10:00,2023-06-05,10:34,0,2,2
46,2023-06-05T10:34:00+10:00,2023-06-05,10:34,0,1,1
49,2023-06-05T10:34:00+10:00,2023-06-05,10:34,0,1,1
52,2023-06-05T10:34:00+10:00,2023-06-05,10:34,7,3,10
53,2023-06-05T10:34:00+10:00,2023-06-05,10:34,13,2,15
56,2023-06-05T10:34:00+10:00,2023-06-05,10:34,2,1,3
76,2023-06-05T10:34:00+10:00,2023-06-05,10:34,1,1,2
86,2023-06-05T10:34:00+10:00,2023-06-05,10:34,1,0,1
3,2023-06-05T10:34:00+10:00,2023-06-05,10:34,5,2,7
6,2023-06-05T10:34:00+10:00,2023-06-05,10:34,7,5,12
8,2023-06-05T10:34:00+10:00,2023-06-05,10:34,1,1,2
21,2023-06-05T10:34:00+10:00,2023-06-05,10:34,2,1,3
26,2023-06-05T10:34:00+10:00,2023-06-05,10:34,3,5,8
31,2023-06-05T10:34:00+10:00,2023-06-05,10:34,0,2,2
39,2023-06-05T10:34:00+10:00,2023-06-05,10:34,6,0,6
40,2023-06-05T10:34:00+10:00,2023-06-05,10:34,3,4,7
47,2023-06-05T10:34:00+10:00,2023-06-05,10:34,4,12,16
54,2023-06-05T10:34:00+10:00,2023-06-05,10:34,1,1,2
61,2023-06-05T10:34:00+10:00,2023-06-05,10:34,1,9,10
69,2023-06-05T10:34:00+10:00,2023-06-05,10:34,4,0,4
10,2023-06-05T10:34:00+10:00,2023-06-05,10:34,1,1,2
18,2023-06-05T10:34:00+10:00,2023-06-05,10:34,2,3,5
20,2023-06-05T10:34:00+10:00,2023-06-05,10:34,4,2,6
23,2023-06-05T10:34:00+10:00,2023-06-05,10:34,1,3,4
30,2023-06-05T10:34:00+10:00,2023-06-05,10:34,1,2,3
35,2023-06-05T10:34:00+10:00,2023-06-05,10:34,6,3,9
58,2023-06-05T10:34:00+10:00,2023-06-05,10:34,10,4,14
62,2023-06-05T10:34:00+10:00,2023-06-05,10:34,2,1,3
63,2023-06-05T10:34:00+10:00,2023-06-05,10:34,1,3,4
67,2023-06-05T10:34:00+10:00,2023-06-05,10:34,5,7,12
85,2023-06-05T10:34:00+10:00,2023-06-05,10:34,0,1,1
4,2023-06-05T10:34:00+10:00,2023-06-05,10:34,3,10,13
5,2023-06-05T10:34:00+10:00,2023-06-05,10:34,10,16,26
28,2023-06-05T10:34:00+10:00,2023-06-05,10:34,5,6,11
29,2023-06-05T10:34:00+10:00,2023-06-05,10:34,4,1,5
41,2023-06-05T10:34:00+10:00,2023-06-05,10:34,18,10,28
42,2023-06-05T10:34:00+10:00,2023-06-05,10:34,1,1,2
44,2023-06-05T10:34:00+10:00,2023-06-05,10:34,0,1,1
66,2023-06-05T10:34:00+10:00,2023-06-05,10:34,1,5,6
108,2023-06-05T10:34:00+10:00,2023-06-05,10:34,2,3,5
2,2023-06-05T10:34:00+10:00,2023-06-05,10:34,4,3,7
12,2023-06-05T10:34:00+10:00,2023-06-05,10:34,3,4,7
24,2023-06-05T10:34:00+10:00,2023-06-05,10:34,4,0,4
48,2023-06-05T10:34:00+10:00,2023-06-05,10:34,1,0,1
51,2023-06-05T10:34:00+10:00,2023-06-05,10:34,2,1,3
57,2023-06-05T10:34:00+10:00,2023-06-05,10:34,0,1,1
68,2023-06-05T10:34:00+10:00,2023-06-05,10:34,2,3,5
72,2023-06-05T10:34:00+10:00,2023-06-05,10:34,1,1,2
79,2023-06-05T10:34:00+10:00,2023-06-05,10:34,5,3,8
3,2023-06-05T10:33:00+10:00,2023-06-05,10:33,1,8,9
5,2023-06-05T10:33:00+10:00,2023-06-05,10:33,5,13,18
14,2023-06-05T10:33:00+10:00,2023-06-05,10:33,0,4,4
26,2023-06-05T10:33:00+10:00,2023-06-05,10:33,6,0,6
28,2023-06-05T10:33:00+10:00,2023-06-05,10:33,4,2,6
37,2023-06-05T10:33:00+10:00,2023-06-05,10:33,2,3,5
39,2023-06-05T10:33:00+10:00,2023-06-05,10:33,1,1,2
40,2023-06-05T10:33:00+10:00,2023-06-05,10:33,3,1,4
55,2023-06-05T10:33:00+10:00,2023-06-05,10:33,4,6,10
66,2023-06-05T10:33:00+10:00,2023-06-05,10:33,4,3,7
78,2023-06-05T10:33:00+10:00,2023-06-05,10:33,1,0,1
1,2023-06-05T10:33:00+10:00,2023-06-05,10:33,12,14,26
2,2023-06-05T10:33:00+10:00,2023-06-05,10:33,3,9,12
9,2023-06-05T10:33:00+10:00,2023-06-05,10:33,1,4,5
10,2023-06-05T10:33:00+10:00,2023-06-05,10:33,1,1,2
20,2023-06-05T10:33:00+10:00,2023-06-05,10:33,0,1,1
23,2023-06-05T10:33:00+10:00,2023-06-05,10:33,0,1,1
24,2023-06-05T10:33:00+10:00,2023-06-05,10:33,5,0,5
46,2023-06-05T10:33:00+10:00,2023-06-05,10:33,0,1,1
62,2023-06-05T10:33:00+10:00,2023-06-05,10:33,0,3,3
63,2023-06-05T10:33:00+10:00,2023-06-05,10:33,1,8,9
76,2023-06-05T10:33:00+10:00,2023-06-05,10:33,2,1,3
79,2023-06-05T10:33:00+10:00,2023-06-05,10:33,4,1,5
6,2023-06-05T10:33:00+10:00,2023-06-05,10:33,8,4,12
21,2023-06-05T10:33:00+10:00,2023-06-05,10:33,4,0,4
29,2023-06-05T10:33:00+10:00,2023-06-05,10:33,2,1,3
31,2023-06-05T10:33:00+10:00,2023-06-05,10:33,1,1,2
36,2023-06-05T10:33:00+10:00,2023-06-05,10:33,3,2,5
42,2023-06-05T10:33:00+10:00,2023-06-05,10:33,1,0,1
61,2023-06-05T10:33:00+10:00,2023-06-05,10:33,6,2,8
77,2023-06-05T10:33:00+10:00,2023-06-05,10:33,0,1,1
87,2023-06-05T10:33:00+10:00,2023-06-05,10:33,1,0,1
17,2023-06-05T10:33:00+10:00,2023-06-05,10:33,6,1,7
27,2023-06-05T10:33:00+10:00,2023-06-05,10:33,3,0,3
35,2023-06-05T10:33:00+10:00,2023-06-05,10:33,3,2,5
52,2023-06-05T10:33:00+10:00,2023-06-05,10:33,3,1,4
53,2023-06-05T10:33:00+10:00,2023-06-05,10:33,12,12,24
57,2023-06-05T10:33:00+10:00,2023-06-05,10:33,4,8,12
58,2023-06-05T10:33:00+10:00,2023-06-05,10:33,12,3,15
67,2023-06-05T10:33:00+10:00,2023-06-05,10:33,4,3,7
68,2023-06-05T10:33:00+10:00,2023-06-05,10:33,6,0,6
85,2023-06-05T10:33:00+10:00,2023-06-05,10:33,2,2,4
4,2023-06-05T10:33:00+10:00,2023-06-05,10:33,8,8,16
8,2023-06-05T10:33:00+10:00,2023-06-05,10:33,1,0,1
41,2023-06-05T10:33:00+10:00,2023-06-05,10:33,18,15,33
45,2023-06-05T10:33:00+10:00,2023-06-05,10:33,5,7,12
47,2023-06-05T10:33:00+10:00,2023-06-05,10:33,19,8,27
50,2023-06-05T10:33:00+10:00,2023-06-05,10:33,0,3,3
65,2023-06-05T10:33:00+10:00,2023-06-05,10:33,0,2,2
69,2023-06-05T10:33:00+10:00,2023-06-05,10:33,2,0,2
70,2023-06-05T10:33:00+10:00,2023-06-05,10:33,3,1,4
108,2023-06-05T10:33:00+10:00,2023-06-05,10:33,7,4,11
12,2023-06-05T10:33:00+10:00,2023-06-05,10:33,1,0,1
18,2023-06-05T10:33:00+10:00,2023-06-05,10:33,6,1,7
19,2023-06-05T10:33:00+10:00,2023-06-05,10:33,2,2,4
30,2023-06-05T10:33:00+10:00,2023-06-05,10:33,2,5,7
48,2023-06-05T10:33:00+10:00,2023-06-05,10:33,0,1,1
51,2023-06-05T10:33:00+10:00,2023-06-05,10:33,1,1,2
56,2023-06-05T10:33:00+10:00,2023-06-05,10:33,4,2,6
72,2023-06-05T10:33:00+10:00,2023-06-05,10:33,1,5,6
3,2023-06-05T10:32:00+10:00,2023-06-05,10:32,5,9,14
28,2023-06-05T10:32:00+10:00,2023-06-05,10:32,4,2,6
29,2023-06-05T10:32:00+10:00,2023-06-05,10:32,2,0,2
47,2023-06-05T10:32:00+10:00,2023-06-05,10:32,6,7,13
61,2023-06-05T10:32:00+10:00,2023-06-05,10:32,0,4,4
66,2023-06-05T10:32:00+10:00,2023-06-05,10:32,6,11,17
70,2023-06-05T10:32:00+10:00,2023-06-05,10:32,1,6,7
87,2023-06-05T10:32:00+10:00,2023-06-05,10:32,0,2,2
35,2023-06-05T10:32:00+10:00,2023-06-05,10:32,9,6,15
48,2023-06-05T10:32:00+10:00,2023-06-05,10:32,6,2,8
49,2023-06-05T10:32:00+10:00,2023-06-05,10:32,2,0,2
53,2023-06-05T10:32:00+10:00,2023-06-05,10:32,6,9,15
57,2023-06-05T10:32:00+10:00,2023-06-05,10:32,1,0,1
63,2023-06-05T10:32:00+10:00,2023-06-05,10:32,3,0,3
72,2023-06-05T10:32:00+10:00,2023-06-05,10:32,1,3,4
4,2023-06-05T10:32:00+10:00,2023-06-05,10:32,21,4,25
5,2023-06-05T10:32:00+10:00,2023-06-05,10:32,1,5,6
8,2023-06-05T10:32:00+10:00,2023-06-05,10:32,0,1,1
14,2023-06-05T10:32:00+10:00,2023-06-05,10:32,2,7,9
31,2023-06-05T10:32:00+10:00,2023-06-05,10:32,0,1,1
40,2023-06-05T10:32:00+10:00,2023-06-05,10:32,1,4,5
41,2023-06-05T10:32:00+10:00,2023-06-05,10:32,29,11,40
42,2023-06-05T10:32:00+10:00,2023-06-05,10:32,0,1,1
50,2023-06-05T10:32:00+10:00,2023-06-05,10:32,5,2,7
69,2023-06-05T10:32:00+10:00,2023-06-05,10:32,1,0,1
108,2023-06-05T10:32:00+10:00,2023-06-05,10:32,3,0,3
9,2023-06-05T10:32:00+10:00,2023-06-05,10:32,4,1,5
20,2023-06-05T10:32:00+10:00,2023-06-05,10:32,1,1,2
23,2023-06-05T10:32:00+10:00,2023-06-05,10:32,6,3,9
24,2023-06-05T10:32:00+10:00,2023-06-05,10:32,4,3,7
46,2023-06-05T10:32:00+10:00,2023-06-05,10:32,1,3,4
52,2023-06-05T10:32:00+10:00,2023-06-05,10:32,4,2,6
58,2023-06-05T10:32:00+10:00,2023-06-05,10:32,4,9,13
62,2023-06-05T10:32:00+10:00,2023-06-05,10:32,2,4,6
67,2023-06-05T10:32:00+10:00,2023-06-05,10:32,2,3,5
79,2023-06-05T10:32:00+10:00,2023-06-05,10:32,18,4,22
6,2023-06-05T10:32:00+10:00,2023-06-05,10:32,3,1,4
21,2023-06-05T10:32:00+10:00,2023-06-05,10:32,3,0,3
26,2023-06-05T10:32:00+10:00,2023-06-05,10:32,2,5,7
36,2023-06-05T10:32:00+10:00,2023-06-05,10:32,3,1,4
37,2023-06-05T10:32:00+10:00,2023-06-05,10:32,1,2,3
39,2023-06-05T10:32:00+10:00,2023-06-05,10:32,2,1,3
44,2023-06-05T10:32:00+10:00,2023-06-05,10:32,0,1,1
45,2023-06-05T10:32:00+10:00,2023-06-05,10:32,0,6,6
54,2023-06-05T10:32:00+10:00,2023-06-05,10:32,1,1,2
55,2023-06-05T10:32:00+10:00,2023-06-05,10:32,7,10,17
65,2023-06-05T10:32:00+10:00,2023-06-05,10:32,1,4,5
71,2023-06-05T10:32:00+10:00,2023-06-05,10:32,1,0,1
77,2023-06-05T10:32:00+10:00,2023-06-05,10:32,2,4,6
1,2023-06-05T10:32:00+10:00,2023-06-05,10:32,6,3,9
2,2023-06-05T10:32:00+10:00,2023-06-05,10:32,3,3,6
10,2023-06-05T10:32:00+10:00,2023-06-05,10:32,1,0,1
17,2023-06-05T10:32:00+10:00,2023-06-05,10:32,6,3,9
18,2023-06-05T10:32:00+10:00,2023-06-05,10:32,5,1,6
19,2023-06-05T10:32:00+10:00,2023-06-05,10:32,0,3,3
27,2023-06-05T10:32:00+10:00,2023-06-05,10:32,0,1,1
30,2023-06-05T10:32:00+10:00,2023-06-05,10:32,0,3,3
51,2023-06-05T10:32:00+10:00,2023-06-05,10:32,0,4,4
56,2023-06-05T10:32:00+10:00,2023-06-05,10:32,2,7,9
68,2023-06-05T10:32:00+10:00,2023-06-05,10:32,4,2,6
76,2023-06-05T10:32:00+10:00,2023-06-05,10:32,0,1,1
85,2023-06-05T10:32:00+10:00,2023-06-05,10:32,1,2,3
5,2023-06-05T10:31:00+10:00,2023-06-05,10:31,3,4,7
8,2023-06-05T10:31:00+10:00,2023-06-05,10:31,3,2,5
14,2023-06-05T10:31:00+10:00,2023-06-05,10:31,3,0,3
65,2023-06-05T10:31:00+10:00,2023-06-05,10:31,5,11,16
66,2023-06-05T10:31:00+10:00,2023-06-05,10:31,7,7,14
9,2023-06-05T10:31:00+10:00,2023-06-05,10:31,0,5,5
17,2023-06-05T10:31:00+10:00,2023-06-05,10:31,4,0,4
18,2023-06-05T10:31:00+10:00,2023-06-05,10:31,2,1,3
19,2023-06-05T10:31:00+10:00,2023-06-05,10:31,6,3,9
23,2023-06-05T10:31:00+10:00,2023-06-05,10:31,4,7,11
48,2023-06-05T10:31:00+10:00,2023-06-05,10:31,0,6,6
51,2023-06-05T10:31:00+10:00,2023-06-05,10:31,1,1,2
57,2023-06-05T10:31:00+10:00,2023-06-05,10:31,4,2,6
63,2023-06-05T10:31:00+10:00,2023-06-05,10:31,5,1,6
68,2023-06-05T10:31:00+10:00,2023-06-05,10:31,6,4,10
3,2023-06-05T10:31:00+10:00,2023-06-05,10:31,5,6,11
4,2023-06-05T10:31:00+10:00,2023-06-05,10:31,23,2,25
21,2023-06-05T10:31:00+10:00,2023-06-05,10:31,2,0,2
31,2023-06-05T10:31:00+10:00,2023-06-05,10:31,3,5,8
40,2023-06-05T10:31:00+10:00,2023-06-05,10:31,5,1,6
42,2023-06-05T10:31:00+10:00,2023-06-05,10:31,0,1,1
45,2023-06-05T10:31:00+10:00,2023-06-05,10:31,0,4,4
47,2023-06-05T10:31:00+10:00,2023-06-05,10:31,6,12,18
50,2023-06-05T10:31:00+10:00,2023-06-05,10:31,3,1,4
55,2023-06-05T10:31:00+10:00,2023-06-05,10:31,8,2,10
69,2023-06-05T10:31:00+10:00,2023-06-05,10:31,5,1,6
87,2023-06-05T10:31:00+10:00,2023-06-05,10:31,0,2,2
108,2023-06-05T10:31:00+10:00,2023-06-05,10:31,7,2,9
2,2023-06-05T10:31:00+10:00,2023-06-05,10:31,9,0,9
10,2023-06-05T10:31:00+10:00,2023-06-05,10:31,4,0,4
24,2023-06-05T10:31:00+10:00,2023-06-05,10:31,6,4,10
46,2023-06-05T10:31:00+10:00,2023-06-05,10:31,0,2,2
49,2023-06-05T10:31:00+10:00,2023-06-05,10:31,2,0,2
52,2023-06-05T10:31:00+10:00,2023-06-05,10:31,1,2,3
56,2023-06-05T10:31:00+10:00,2023-06-05,10:31,3,3,6
67,2023-06-05T10:31:00+10:00,2023-06-05,10:31,5,3,8
86,2023-06-05T10:31:00+10:00,2023-06-05,10:31,0,1,1
6,2023-06-05T10:31:00+10:00,2023-06-05,10:31,4,1,5
26,2023-06-05T10:31:00+10:00,2023-06-05,10:31,2,2,4
28,2023-06-05T10:31:00+10:00,2023-06-05,10:31,2,6,8
29,2023-06-05T10:31:00+10:00,2023-06-05,10:31,2,4,6
36,2023-06-05T10:31:00+10:00,2023-06-05,10:31,1,1,2
41,2023-06-05T10:31:00+10:00,2023-06-05,10:31,10,10,20
54,2023-06-05T10:31:00+10:00,2023-06-05,10:31,2,1,3
61,2023-06-05T10:31:00+10:00,2023-06-05,10:31,8,4,12
70,2023-06-05T10:31:00+10:00,2023-06-05,10:31,1,4,5
71,2023-06-05T10:31:00+10:00,2023-06-05,10:31,2,0,2
77,2023-06-05T10:31:00+10:00,2023-06-05,10:31,1,0,1
1,2023-06-05T10:31:00+10:00,2023-06-05,10:31,20,10,30
20,2023-06-05T10:31:00+10:00,2023-06-05,10:31,1,1,2
30,2023-06-05T10:31:00+10:00,2023-06-05,10:31,4,0,4
35,2023-06-05T10:31:00+10:00,2023-06-05,10:31,10,9,19
53,2023-06-05T10:31:00+10:00,2023-06-05,10:31,15,8,23
58,2023-06-05T10:31:00+10:00,2023-06-05,10:31,2,0,2
62,2023-06-05T10:31:00+10:00,2023-06-05,10:31,2,0,2
72,2023-06-05T10:31:00+10:00,2023-06-05,10:31,0,2,2
79,2023-06-05T10:31:00+10:00,2023-06-05,10:31,2,2,4
85,2023-06-05T10:31:00+10:00,2023-06-05,10:31,3,1,4
3,2023-06-05T10:30:00+10:00,2023-06-05,10:30,1,11,12
4,2023-06-05T10:30:00+10:00,2023-06-05,10:30,13,12,25
8,2023-06-05T10:30:00+10:00,2023-06-05,10:30,0,2,2
26,2023-06-05T10:30:00+10:00,2023-06-05,10:30,2,0,2
37,2023-06-05T10:30:00+10:00,2023-06-05,10:30,3,3,6
41,2023-06-05T10:30:00+10:00,2023-06-05,10:30,24,17,41
42,2023-06-05T10:30:00+10:00,2023-06-05,10:30,3,1,4
50,2023-06-05T10:30:00+10:00,2023-06-05,10:30,3,3,6
55,2023-06-05T10:30:00+10:00,2023-06-05,10:30,1,14,15
59,2023-06-05T10:30:00+10:00,2023-06-05,10:30,23,21,44
66,2023-06-05T10:30:00+10:00,2023-06-05,10:30,5,6,11
35,2023-06-05T10:30:00+10:00,2023-06-05,10:30,4,5,9
53,2023-06-05T10:30:00+10:00,2023-06-05,10:30,2,10,12
58,2023-06-05T10:30:00+10:00,2023-06-05,10:30,9,4,13
63,2023-06-05T10:30:00+10:00,2023-06-05,10:30,0,4,4
67,2023-06-05T10:30:00+10:00,2023-06-05,10:30,12,9,21
68,2023-06-05T10:30:00+10:00,2023-06-05,10:30,3,2,5
117,2023-06-05T10:30:00+10:00,2023-06-05,10:30,3,17,20
5,2023-06-05T10:30:00+10:00,2023-06-05,10:30,5,7,12
6,2023-06-05T10:30:00+10:00,2023-06-05,10:30,5,4,9
14,2023-06-05T10:30:00+10:00,2023-06-05,10:30,2,0,2
21,2023-06-05T10:30:00+10:00,2023-06-05,10:30,2,0,2
31,2023-06-05T10:30:00+10:00,2023-06-05,10:30,1,3,4
36,2023-06-05T10:30:00+10:00,2023-06-05,10:30,1,2,3
47,2023-06-05T10:30:00+10:00,2023-06-05,10:30,2,15,17
54,2023-06-05T10:30:00+10:00,2023-06-05,10:30,4,1,5
65,2023-06-05T10:30:00+10:00,2023-06-05,10:30,0,2,2
70,2023-06-05T10:30:00+10:00,2023-06-05,10:30,1,1,2
84,2023-06-05T10:30:00+10:00,2023-06-05,10:30,52,36,88
87,2023-06-05T10:30:00+10:00,2023-06-05,10:30,2,1,3
2,2023-06-05T10:30:00+10:00,2023-06-05,10:30,2,4,6
10,2023-06-05T10:30:00+10:00,2023-06-05,10:30,0,1,1
12,2023-06-05T10:30:00+10:00,2023-06-05,10:30,2,2,4
17,2023-06-05T10:30:00+10:00,2023-06-05,10:30,6,1,7
18,2023-06-05T10:30:00+10:00,2023-06-05,10:30,3,2,5
24,2023-06-05T10:30:00+10:00,2023-06-05,10:30,13,5,18
30,2023-06-05T10:30:00+10:00,2023-06-05,10:30,1,2,3
51,2023-06-05T10:30:00+10:00,2023-06-05,10:30,2,0,2
57,2023-06-05T10:30:00+10:00,2023-06-05,10:30,0,3,3
62,2023-06-05T10:30:00+10:00,2023-06-05,10:30,3,0,3
79,2023-06-05T10:30:00+10:00,2023-06-05,10:30,3,4,7
85,2023-06-05T10:30:00+10:00,2023-06-05,10:30,0,2,2
86,2023-06-05T10:30:00+10:00,2023-06-05,10:30,1,0,1
28,2023-06-05T10:30:00+10:00,2023-06-05,10:30,6,3,9
29,2023-06-05T10:30:00+10:00,2023-06-05,10:30,2,2,4
39,2023-06-05T10:30:00+10:00,2023-06-05,10:30,1,2,3
40,2023-06-05T10:30:00+10:00,2023-06-05,10:30,4,2,6
45,2023-06-05T10:30:00+10:00,2023-06-05,10:30,8,5,13
61,2023-06-05T10:30:00+10:00,2023-06-05,10:30,4,0,4
107,2023-06-05T10:30:00+10:00,2023-06-05,10:30,4,7,11
108,2023-06-05T10:30:00+10:00,2023-06-05,10:30,2,5,7
1,2023-06-05T10:30:00+10:00,2023-06-05,10:30,6,1,7
9,2023-06-05T10:30:00+10:00,2023-06-05,10:30,1,0,1
11,2023-06-05T10:30:00+10:00,2023-06-05,10:30,2,0,2
19,2023-06-05T10:30:00+10:00,2023-06-05,10:30,1,0,1
23,2023-06-05T10:30:00+10:00,2023-06-05,10:30,2,4,6
27,2023-06-05T10:30:00+10:00,2023-06-05,10:30,1,0,1
48,2023-06-05T10:30:00+10:00,2023-06-05,10:30,1,3,4
52,2023-06-05T10:30:00+10:00,2023-06-05,10:30,2,1,3
56,2023-06-05T10:30:00+10:00,2023-06-05,10:30,2,1,3
72,2023-06-05T10:30:00+10:00,2023-06-05,10:30,3,3,6
109,2023-06-05T10:30:00+10:00,2023-06-05,10:30,5,12,17
3,2023-06-05T10:29:00+10:00,2023-06-05,10:29,2,8,10
5,2023-06-05T10:29:00+10:00,2023-06-05,10:29,2,4,6
26,2023-06-05T10:29:00+10:00,2023-06-05,10:29,1,3,4
41,2023-06-05T10:29:00+10:00,2023-06-05,10:29,21,12,33
45,2023-06-05T10:29:00+10:00,2023-06-05,10:29,4,5,9
75,2023-06-05T10:29:00+10:00,2023-06-05,10:29,0,1,1
12,2023-06-05T10:29:00+10:00,2023-06-05,10:29,0,2,2
23,2023-06-05T10:29:00+10:00,2023-06-05,10:29,1,6,7
27,2023-06-05T10:29:00+10:00,2023-06-05,10:29,2,1,3
30,2023-06-05T10:29:00+10:00,2023-06-05,10:29,4,6,10
35,2023-06-05T10:29:00+10:00,2023-06-05,10:29,4,4,8
56,2023-06-05T10:29:00+10:00,2023-06-05,10:29,4,5,9
68,2023-06-05T10:29:00+10:00,2023-06-05,10:29,1,1,2
6,2023-06-05T10:29:00+10:00,2023-06-05,10:29,12,4,16
14,2023-06-05T10:29:00+10:00,2023-06-05,10:29,3,0,3
29,2023-06-05T10:29:00+10:00,2023-06-05,10:29,3,3,6
36,2023-06-05T10:29:00+10:00,2023-06-05,10:29,4,3,7
39,2023-06-05T10:29:00+10:00,2023-06-05,10:29,2,0,2
40,2023-06-05T10:29:00+10:00,2023-06-05,10:29,1,1,2
47,2023-06-05T10:29:00+10:00,2023-06-05,10:29,7,4,11
50,2023-06-05T10:29:00+10:00,2023-06-05,10:29,2,0,2
55,2023-06-05T10:29:00+10:00,2023-06-05,10:29,4,7,11
61,2023-06-05T10:29:00+10:00,2023-06-05,10:29,9,11,20
65,2023-06-05T10:29:00+10:00,2023-06-05,10:29,7,6,13
66,2023-06-05T10:29:00+10:00,2023-06-05,10:29,2,4,6
69,2023-06-05T10:29:00+10:00,2023-06-05,10:29,0,1,1
87,2023-06-05T10:29:00+10:00,2023-06-05,10:29,1,0,1
1,2023-06-05T10:29:00+10:00,2023-06-05,10:29,6,3,9
10,2023-06-05T10:29:00+10:00,2023-06-05,10:29,2,1,3
18,2023-06-05T10:29:00+10:00,2023-06-05,10:29,1,5,6
85,2023-06-05T10:29:00+10:00,2023-06-05,10:29,1,0,1
4,2023-06-05T10:29:00+10:00,2023-06-05,10:29,12,9,21
21,2023-06-05T10:29:00+10:00,2023-06-05,10:29,1,0,1
28,2023-06-05T10:29:00+10:00,2023-06-05,10:29,4,6,10
31,2023-06-05T10:29:00+10:00,2023-06-05,10:29,1,1,2
37,2023-06-05T10:29:00+10:00,2023-06-05,10:29,2,0,2
42,2023-06-05T10:29:00+10:00,2023-06-05,10:29,2,2,4
70,2023-06-05T10:29:00+10:00,2023-06-05,10:29,0,3,3
108,2023-06-05T10:29:00+10:00,2023-06-05,10:29,8,3,11
2,2023-06-05T10:29:00+10:00,2023-06-05,10:29,4,10,14
9,2023-06-05T10:29:00+10:00,2023-06-05,10:29,0,4,4
11,2023-06-05T10:29:00+10:00,2023-06-05,10:29,0,1,1
17,2023-06-05T10:29:00+10:00,2023-06-05,10:29,3,8,11
19,2023-06-05T10:29:00+10:00,2023-06-05,10:29,6,2,8
24,2023-06-05T10:29:00+10:00,2023-06-05,10:29,5,4,9
48,2023-06-05T10:29:00+10:00,2023-06-05,10:29,2,0,2
51,2023-06-05T10:29:00+10:00,2023-06-05,10:29,6,1,7
52,2023-06-05T10:29:00+10:00,2023-06-05,10:29,1,1,2
53,2023-06-05T10:29:00+10:00,2023-06-05,10:29,6,3,9
57,2023-06-05T10:29:00+10:00,2023-06-05,10:29,3,2,5
58,2023-06-05T10:29:00+10:00,2023-06-05,10:29,3,3,6
62,2023-06-05T10:29:00+10:00,2023-06-05,10:29,1,0,1
63,2023-06-05T10:29:00+10:00,2023-06-05,10:29,3,1,4
67,2023-06-05T10:29:00+10:00,2023-06-05,10:29,1,11,12
72,2023-06-05T10:29:00+10:00,2023-06-05,10:29,2,1,3
79,2023-06-05T10:29:00+10:00,2023-06-05,10:29,6,3,9
3,2023-06-05T10:28:00+10:00,2023-06-05,10:28,3,9,12
4,2023-06-05T10:28:00+10:00,2023-06-05,10:28,5,7,12
6,2023-06-05T10:28:00+10:00,2023-06-05,10:28,3,1,4
40,2023-06-05T10:28:00+10:00,2023-06-05,10:28,2,2,4
41,2023-06-05T10:28:00+10:00,2023-06-05,10:28,19,9,28
47,2023-06-05T10:28:00+10:00,2023-06-05,10:28,1,9,10
55,2023-06-05T10:28:00+10:00,2023-06-05,10:28,5,7,12
61,2023-06-05T10:28:00+10:00,2023-06-05,10:28,1,2,3
66,2023-06-05T10:28:00+10:00,2023-06-05,10:28,5,7,12
70,2023-06-05T10:28:00+10:00,2023-06-05,10:28,0,2,2
77,2023-06-05T10:28:00+10:00,2023-06-05,10:28,9,3,12
87,2023-06-05T10:28:00+10:00,2023-06-05,10:28,0,1,1
108,2023-06-05T10:28:00+10:00,2023-06-05,10:28,4,5,9
1,2023-06-05T10:28:00+10:00,2023-06-05,10:28,9,13,22
2,2023-06-05T10:28:00+10:00,2023-06-05,10:28,2,9,11
9,2023-06-05T10:28:00+10:00,2023-06-05,10:28,2,2,4
19,2023-06-05T10:28:00+10:00,2023-06-05,10:28,2,3,5
51,2023-06-05T10:28:00+10:00,2023-06-05,10:28,2,3,5
53,2023-06-05T10:28:00+10:00,2023-06-05,10:28,7,6,13
62,2023-06-05T10:28:00+10:00,2023-06-05,10:28,1,0,1
67,2023-06-05T10:28:00+10:00,2023-06-05,10:28,2,6,8
76,2023-06-05T10:28:00+10:00,2023-06-05,10:28,0,3,3
5,2023-06-05T10:28:00+10:00,2023-06-05,10:28,2,3,5
8,2023-06-05T10:28:00+10:00,2023-06-05,10:28,2,1,3
14,2023-06-05T10:28:00+10:00,2023-06-05,10:28,2,0,2
21,2023-06-05T10:28:00+10:00,2023-06-05,10:28,5,3,8
28,2023-06-05T10:28:00+10:00,2023-06-05,10:28,9,2,11
29,2023-06-05T10:28:00+10:00,2023-06-05,10:28,1,2,3
31,2023-06-05T10:28:00+10:00,2023-06-05,10:28,1,0,1
36,2023-06-05T10:28:00+10:00,2023-06-05,10:28,2,2,4
42,2023-06-05T10:28:00+10:00,2023-06-05,10:28,2,2,4
45,2023-06-05T10:28:00+10:00,2023-06-05,10:28,4,11,15
50,2023-06-05T10:28:00+10:00,2023-06-05,10:28,2,1,3
65,2023-06-05T10:28:00+10:00,2023-06-05,10:28,9,6,15
71,2023-06-05T10:28:00+10:00,2023-06-05,10:28,0,1,1
10,2023-06-05T10:28:00+10:00,2023-06-05,10:28,2,0,2
12,2023-06-05T10:28:00+10:00,2023-06-05,10:28,3,1,4
18,2023-06-05T10:28:00+10:00,2023-06-05,10:28,1,1,2
30,2023-06-05T10:28:00+10:00,2023-06-05,10:28,6,0,6
49,2023-06-05T10:28:00+10:00,2023-06-05,10:28,1,0,1
52,2023-06-05T10:28:00+10:00,2023-06-05,10:28,3,6,9
56,2023-06-05T10:28:00+10:00,2023-06-05,10:28,1,2,3
57,2023-06-05T10:28:00+10:00,2023-06-05,10:28,1,4,5
68,2023-06-05T10:28:00+10:00,2023-06-05,10:28,2,0,2
85,2023-06-05T10:28:00+10:00,2023-06-05,10:28,0,1,1
26,2023-06-05T10:28:00+10:00,2023-06-05,10:28,5,0,5
37,2023-06-05T10:28:00+10:00,2023-06-05,10:28,0,4,4
39,2023-06-05T10:28:00+10:00,2023-06-05,10:28,5,3,8
54,2023-06-05T10:28:00+10:00,2023-06-05,10:28,1,2,3
69,2023-06-05T10:28:00+10:00,2023-06-05,10:28,4,0,4
11,2023-06-05T10:28:00+10:00,2023-06-05,10:28,1,0,1
17,2023-06-05T10:28:00+10:00,2023-06-05,10:28,5,1,6
24,2023-06-05T10:28:00+10:00,2023-06-05,10:28,9,3,12
27,2023-06-05T10:28:00+10:00,2023-06-05,10:28,1,1,2
35,2023-06-05T10:28:00+10:00,2023-06-05,10:28,6,4,10
46,2023-06-05T10:28:00+10:00,2023-06-05,10:28,2,3,5
48,2023-06-05T10:28:00+10:00,2023-06-05,10:28,0,1,1
58,2023-06-05T10:28:00+10:00,2023-06-05,10:28,15,1,16
63,2023-06-05T10:28:00+10:00,2023-06-05,10:28,8,3,11
79,2023-06-05T10:28:00+10:00,2023-06-05,10:28,5,5,10
3,2023-06-05T10:27:00+10:00,2023-06-05,10:27,5,20,25
4,2023-06-05T10:27:00+10:00,2023-06-05,10:27,6,6,12
6,2023-06-05T10:27:00+10:00,2023-06-05,10:27,8,1,9
26,2023-06-05T10:27:00+10:00,2023-06-05,10:27,4,8,12
29,2023-06-05T10:27:00+10:00,2023-06-05,10:27,5,0,5
31,2023-06-05T10:27:00+10:00,2023-06-05,10:27,4,5,9
36,2023-06-05T10:27:00+10:00,2023-06-05,10:27,7,0,7
45,2023-06-05T10:27:00+10:00,2023-06-05,10:27,5,2,7
50,2023-06-05T10:27:00+10:00,2023-06-05,10:27,3,2,5
71,2023-06-05T10:27:00+10:00,2023-06-05,10:27,2,3,5
2,2023-06-05T10:27:00+10:00,2023-06-05,10:27,10,3,13
18,2023-06-05T10:27:00+10:00,2023-06-05,10:27,2,2,4
19,2023-06-05T10:27:00+10:00,2023-06-05,10:27,1,7,8
35,2023-06-05T10:27:00+10:00,2023-06-05,10:27,7,4,11
52,2023-06-05T10:27:00+10:00,2023-06-05,10:27,5,2,7
57,2023-06-05T10:27:00+10:00,2023-06-05,10:27,1,3,4
58,2023-06-05T10:27:00+10:00,2023-06-05,10:27,0,2,2
63,2023-06-05T10:27:00+10:00,2023-06-05,10:27,0,5,5
68,2023-06-05T10:27:00+10:00,2023-06-05,10:27,4,1,5
72,2023-06-05T10:27:00+10:00,2023-06-05,10:27,6,8,14
76,2023-06-05T10:27:00+10:00,2023-06-05,10:27,2,1,3
8,2023-06-05T10:27:00+10:00,2023-06-05,10:27,5,2,7
14,2023-06-05T10:27:00+10:00,2023-06-05,10:27,6,6,12
28,2023-06-05T10:27:00+10:00,2023-06-05,10:27,5,5,10
40,2023-06-05T10:27:00+10:00,2023-06-05,10:27,0,2,2
41,2023-06-05T10:27:00+10:00,2023-06-05,10:27,5,7,12
47,2023-06-05T10:27:00+10:00,2023-06-05,10:27,14,14,28
54,2023-06-05T10:27:00+10:00,2023-06-05,10:27,1,2,3
55,2023-06-05T10:27:00+10:00,2023-06-05,10:27,7,7,14
61,2023-06-05T10:27:00+10:00,2023-06-05,10:27,5,8,13
66,2023-06-05T10:27:00+10:00,2023-06-05,10:27,0,4,4
87,2023-06-05T10:27:00+10:00,2023-06-05,10:27,3,0,3
108,2023-06-05T10:27:00+10:00,2023-06-05,10:27,5,3,8
10,2023-06-05T10:27:00+10:00,2023-06-05,10:27,1,0,1
11,2023-06-05T10:27:00+10:00,2023-06-05,10:27,0,1,1
17,2023-06-05T10:27:00+10:00,2023-06-05,10:27,4,5,9
20,2023-06-05T10:27:00+10:00,2023-06-05,10:27,1,0,1
24,2023-06-05T10:27:00+10:00,2023-06-05,10:27,5,4,9
53,2023-06-05T10:27:00+10:00,2023-06-05,10:27,13,4,17
79,2023-06-05T10:27:00+10:00,2023-06-05,10:27,7,10,17
86,2023-06-05T10:27:00+10:00,2023-06-05,10:27,0,1,1
5,2023-06-05T10:27:00+10:00,2023-06-05,10:27,4,4,8
39,2023-06-05T10:27:00+10:00,2023-06-05,10:27,2,2,4
42,2023-06-05T10:27:00+10:00,2023-06-05,10:27,1,0,1
44,2023-06-05T10:27:00+10:00,2023-06-05,10:27,1,0,1
65,2023-06-05T10:27:00+10:00,2023-06-05,10:27,8,0,8
69,2023-06-05T10:27:00+10:00,2023-06-05,10:27,1,1,2
70,2023-06-05T10:27:00+10:00,2023-06-05,10:27,3,3,6
75,2023-06-05T10:27:00+10:00,2023-06-05,10:27,4,0,4
77,2023-06-05T10:27:00+10:00,2023-06-05,10:27,2,0,2
1,2023-06-05T10:27:00+10:00,2023-06-05,10:27,9,8,17
9,2023-06-05T10:27:00+10:00,2023-06-05,10:27,3,2,5
23,2023-06-05T10:27:00+10:00,2023-06-05,10:27,1,5,6
27,2023-06-05T10:27:00+10:00,2023-06-05,10:27,0,4,4
30,2023-06-05T10:27:00+10:00,2023-06-05,10:27,1,1,2
46,2023-06-05T10:27:00+10:00,2023-06-05,10:27,0,2,2
51,2023-06-05T10:27:00+10:00,2023-06-05,10:27,1,0,1
56,2023-06-05T10:27:00+10:00,2023-06-05,10:27,2,0,2
62,2023-06-05T10:27:00+10:00,2023-06-05,10:27,2,2,4
67,2023-06-05T10:27:00+10:00,2023-06-05,10:27,8,3,11
8,2023-06-05T10:26:00+10:00,2023-06-05,10:26,2,0,2
14,2023-06-05T10:26:00+10:00,2023-06-05,10:26,5,0,5
40,2023-06-05T10:26:00+10:00,2023-06-05,10:26,1,1,2
54,2023-06-05T10:26:00+10:00,2023-06-05,10:26,6,0,6
61,2023-06-05T10:26:00+10:00,2023-06-05,10:26,3,3,6
65,2023-06-05T10:26:00+10:00,2023-06-05,10:26,1,0,1
66,2023-06-05T10:26:00+10:00,2023-06-05,10:26,11,6,17
71,2023-06-05T10:26:00+10:00,2023-06-05,10:26,2,3,5
78,2023-06-05T10:26:00+10:00,2023-06-05,10:26,0,1,1
1,2023-06-05T10:26:00+10:00,2023-06-05,10:26,6,7,13
2,2023-06-05T10:26:00+10:00,2023-06-05,10:26,11,9,20
10,2023-06-05T10:26:00+10:00,2023-06-05,10:26,2,0,2
12,2023-06-05T10:26:00+10:00,2023-06-05,10:26,3,1,4
17,2023-06-05T10:26:00+10:00,2023-06-05,10:26,5,7,12
18,2023-06-05T10:26:00+10:00,2023-06-05,10:26,3,1,4
24,2023-06-05T10:26:00+10:00,2023-06-05,10:26,8,5,13
27,2023-06-05T10:26:00+10:00,2023-06-05,10:26,2,0,2
48,2023-06-05T10:26:00+10:00,2023-06-05,10:26,1,2,3
51,2023-06-05T10:26:00+10:00,2023-06-05,10:26,1,0,1
52,2023-06-05T10:26:00+10:00,2023-06-05,10:26,4,0,4
63,2023-06-05T10:26:00+10:00,2023-06-05,10:26,6,6,12
67,2023-06-05T10:26:00+10:00,2023-06-05,10:26,7,5,12
68,2023-06-05T10:26:00+10:00,2023-06-05,10:26,7,2,9
6,2023-06-05T10:26:00+10:00,2023-06-05,10:26,7,5,12
26,2023-06-05T10:26:00+10:00,2023-06-05,10:26,5,6,11
28,2023-06-05T10:26:00+10:00,2023-06-05,10:26,5,5,10
31,2023-06-05T10:26:00+10:00,2023-06-05,10:26,3,0,3
36,2023-06-05T10:26:00+10:00,2023-06-05,10:26,3,1,4
37,2023-06-05T10:26:00+10:00,2023-06-05,10:26,0,3,3
39,2023-06-05T10:26:00+10:00,2023-06-05,10:26,2,1,3
41,2023-06-05T10:26:00+10:00,2023-06-05,10:26,24,11,35
47,2023-06-05T10:26:00+10:00,2023-06-05,10:26,7,9,16
50,2023-06-05T10:26:00+10:00,2023-06-05,10:26,2,1,3
77,2023-06-05T10:26:00+10:00,2023-06-05,10:26,1,1,2
87,2023-06-05T10:26:00+10:00,2023-06-05,10:26,4,1,5
108,2023-06-05T10:26:00+10:00,2023-06-05,10:26,5,11,16
11,2023-06-05T10:26:00+10:00,2023-06-05,10:26,0,2,2
19,2023-06-05T10:26:00+10:00,2023-06-05,10:26,4,2,6
23,2023-06-05T10:26:00+10:00,2023-06-05,10:26,1,0,1
30,2023-06-05T10:26:00+10:00,2023-06-05,10:26,1,2,3
35,2023-06-05T10:26:00+10:00,2023-06-05,10:26,8,2,10
46,2023-06-05T10:26:00+10:00,2023-06-05,10:26,0,2,2
53,2023-06-05T10:26:00+10:00,2023-06-05,10:26,14,8,22
62,2023-06-05T10:26:00+10:00,2023-06-05,10:26,2,3,5
76,2023-06-05T10:26:00+10:00,2023-06-05,10:26,0,1,1
3,2023-06-05T10:26:00+10:00,2023-06-05,10:26,1,5,6
4,2023-06-05T10:26:00+10:00,2023-06-05,10:26,11,8,19
5,2023-06-05T10:26:00+10:00,2023-06-05,10:26,5,3,8
21,2023-06-05T10:26:00+10:00,2023-06-05,10:26,1,0,1
42,2023-06-05T10:26:00+10:00,2023-06-05,10:26,1,1,2
45,2023-06-05T10:26:00+10:00,2023-06-05,10:26,5,2,7
55,2023-06-05T10:26:00+10:00,2023-06-05,10:26,2,8,10
69,2023-06-05T10:26:00+10:00,2023-06-05,10:26,5,1,6
70,2023-06-05T10:26:00+10:00,2023-06-05,10:26,2,1,3
75,2023-06-05T10:26:00+10:00,2023-06-05,10:26,0,1,1
56,2023-06-05T10:26:00+10:00,2023-06-05,10:26,5,0,5
57,2023-06-05T10:26:00+10:00,2023-06-05,10:26,4,2,6
58,2023-06-05T10:26:00+10:00,2023-06-05,10:26,7,7,14
72,2023-06-05T10:26:00+10:00,2023-06-05,10:26,1,7,8
79,2023-06-05T10:26:00+10:00,2023-06-05,10:26,2,2,4
86,2023-06-05T10:26:00+10:00,2023-06-05,10:26,0,1,1
3,2023-06-05T10:25:00+10:00,2023-06-05,10:25,10,5,15
14,2023-06-05T10:25:00+10:00,2023-06-05,10:25,1,3,4
26,2023-06-05T10:25:00+10:00,2023-06-05,10:25,6,1,7
29,2023-06-05T10:25:00+10:00,2023-06-05,10:25,2,3,5
39,2023-06-05T10:25:00+10:00,2023-06-05,10:25,1,8,9
41,2023-06-05T10:25:00+10:00,2023-06-05,10:25,11,10,21
45,2023-06-05T10:25:00+10:00,2023-06-05,10:25,5,2,7
65,2023-06-05T10:25:00+10:00,2023-06-05,10:25,5,1,6
66,2023-06-05T10:25:00+10:00,2023-06-05,10:25,6,1,7
70,2023-06-05T10:25:00+10:00,2023-06-05,10:25,2,2,4
77,2023-06-05T10:25:00+10:00,2023-06-05,10:25,1,2,3
10,2023-06-05T10:25:00+10:00,2023-06-05,10:25,0,2,2
24,2023-06-05T10:25:00+10:00,2023-06-05,10:25,10,2,12
30,2023-06-05T10:25:00+10:00,2023-06-05,10:25,2,2,4
35,2023-06-05T10:25:00+10:00,2023-06-05,10:25,10,6,16
46,2023-06-05T10:25:00+10:00,2023-06-05,10:25,0,2,2
48,2023-06-05T10:25:00+10:00,2023-06-05,10:25,2,3,5
53,2023-06-05T10:25:00+10:00,2023-06-05,10:25,2,10,12
63,2023-06-05T10:25:00+10:00,2023-06-05,10:25,3,5,8
85,2023-06-05T10:25:00+10:00,2023-06-05,10:25,0,1,1
86,2023-06-05T10:25:00+10:00,2023-06-05,10:25,1,0,1
109,2023-06-05T10:25:00+10:00,2023-06-05,10:25,18,17,35
4,2023-06-05T10:25:00+10:00,2023-06-05,10:25,6,10,16
21,2023-06-05T10:25:00+10:00,2023-06-05,10:25,3,3,6
40,2023-06-05T10:25:00+10:00,2023-06-05,10:25,2,3,5
61,2023-06-05T10:25:00+10:00,2023-06-05,10:25,0,8,8
71,2023-06-05T10:25:00+10:00,2023-06-05,10:25,0,1,1
78,2023-06-05T10:25:00+10:00,2023-06-05,10:25,0,1,1
84,2023-06-05T10:25:00+10:00,2023-06-05,10:25,52,62,114
107,2023-06-05T10:25:00+10:00,2023-06-05,10:25,7,7,14
108,2023-06-05T10:25:00+10:00,2023-06-05,10:25,7,8,15
1,2023-06-05T10:25:00+10:00,2023-06-05,10:25,5,4,9
11,2023-06-05T10:25:00+10:00,2023-06-05,10:25,0,2,2
12,2023-06-05T10:25:00+10:00,2023-06-05,10:25,1,3,4
17,2023-06-05T10:25:00+10:00,2023-06-05,10:25,7,6,13
20,2023-06-05T10:25:00+10:00,2023-06-05,10:25,0,1,1
51,2023-06-05T10:25:00+10:00,2023-06-05,10:25,1,2,3
79,2023-06-05T10:25:00+10:00,2023-06-05,10:25,2,4,6
117,2023-06-05T10:25:00+10:00,2023-06-05,10:25,8,4,12
5,2023-06-05T10:25:00+10:00,2023-06-05,10:25,4,12,16
6,2023-06-05T10:25:00+10:00,2023-06-05,10:25,3,2,5
28,2023-06-05T10:25:00+10:00,2023-06-05,10:25,7,1,8
31,2023-06-05T10:25:00+10:00,2023-06-05,10:25,1,1,2
36,2023-06-05T10:25:00+10:00,2023-06-05,10:25,0,6,6
37,2023-06-05T10:25:00+10:00,2023-06-05,10:25,1,1,2
44,2023-06-05T10:25:00+10:00,2023-06-05,10:25,0,1,1
47,2023-06-05T10:25:00+10:00,2023-06-05,10:25,8,9,17
50,2023-06-05T10:25:00+10:00,2023-06-05,10:25,5,3,8
54,2023-06-05T10:25:00+10:00,2023-06-05,10:25,3,0,3
55,2023-06-05T10:25:00+10:00,2023-06-05,10:25,10,7,17
59,2023-06-05T10:25:00+10:00,2023-06-05,10:25,43,19,62
87,2023-06-05T10:25:00+10:00,2023-06-05,10:25,0,1,1
118,2023-06-05T10:25:00+10:00,2023-06-05,10:25,1,2,3
2,2023-06-05T10:25:00+10:00,2023-06-05,10:25,4,3,7
9,2023-06-05T10:25:00+10:00,2023-06-05,10:25,1,9,10
18,2023-06-05T10:25:00+10:00,2023-06-05,10:25,0,5,5
19,2023-06-05T10:25:00+10:00,2023-06-05,10:25,1,1,2
23,2023-06-05T10:25:00+10:00,2023-06-05,10:25,0,5,5
27,2023-06-05T10:25:00+10:00,2023-06-05,10:25,0,1,1
52,2023-06-05T10:25:00+10:00,2023-06-05,10:25,4,0,4
57,2023-06-05T10:25:00+10:00,2023-06-05,10:25,1,2,3
58,2023-06-05T10:25:00+10:00,2023-06-05,10:25,11,3,14
62,2023-06-05T10:25:00+10:00,2023-06-05,10:25,3,2,5
67,2023-06-05T10:25:00+10:00,2023-06-05,10:25,3,3,6
72,2023-06-05T10:25:00+10:00,2023-06-05,10:25,15,0,15
76,2023-06-05T10:25:00+10:00,2023-06-05,10:25,2,1,3
4,2023-06-05T10:24:00+10:00,2023-06-05,10:24,18,7,25
6,2023-06-05T10:24:00+10:00,2023-06-05,10:24,10,4,14
26,2023-06-05T10:24:00+10:00,2023-06-05,10:24,6,2,8
29,2023-06-05T10:24:00+10:00,2023-06-05,10:24,1,1,2
31,2023-06-05T10:24:00+10:00,2023-06-05,10:24,1,1,2
39,2023-06-05T10:24:00+10:00,2023-06-05,10:24,3,0,3
45,2023-06-05T10:24:00+10:00,2023-06-05,10:24,5,6,11
61,2023-06-05T10:24:00+10:00,2023-06-05,10:24,4,2,6
65,2023-06-05T10:24:00+10:00,2023-06-05,10:24,2,1,3
70,2023-06-05T10:24:00+10:00,2023-06-05,10:24,1,0,1
87,2023-06-05T10:24:00+10:00,2023-06-05,10:24,0,1,1
2,2023-06-05T10:24:00+10:00,2023-06-05,10:24,4,0,4
19,2023-06-05T10:24:00+10:00,2023-06-05,10:24,3,0,3
23,2023-06-05T10:24:00+10:00,2023-06-05,10:24,0,3,3
24,2023-06-05T10:24:00+10:00,2023-06-05,10:24,6,1,7
35,2023-06-05T10:24:00+10:00,2023-06-05,10:24,4,5,9
53,2023-06-05T10:24:00+10:00,2023-06-05,10:24,4,3,7
57,2023-06-05T10:24:00+10:00,2023-06-05,10:24,3,3,6
67,2023-06-05T10:24:00+10:00,2023-06-05,10:24,3,4,7
72,2023-06-05T10:24:00+10:00,2023-06-05,10:24,8,5,13
76,2023-06-05T10:24:00+10:00,2023-06-05,10:24,1,0,1
5,2023-06-05T10:24:00+10:00,2023-06-05,10:24,0,4,4
8,2023-06-05T10:24:00+10:00,2023-06-05,10:24,1,4,5
36,2023-06-05T10:24:00+10:00,2023-06-05,10:24,8,0,8
37,2023-06-05T10:24:00+10:00,2023-06-05,10:24,2,3,5
40,2023-06-05T10:24:00+10:00,2023-06-05,10:24,8,2,10
54,2023-06-05T10:24:00+10:00,2023-06-05,10:24,3,2,5
55,2023-06-05T10:24:00+10:00,2023-06-05,10:24,9,11,20
69,2023-06-05T10:24:00+10:00,2023-06-05,10:24,2,1,3
1,2023-06-05T10:24:00+10:00,2023-06-05,10:24,5,12,17
18,2023-06-05T10:24:00+10:00,2023-06-05,10:24,2,3,5
20,2023-06-05T10:24:00+10:00,2023-06-05,10:24,1,2,3
27,2023-06-05T10:24:00+10:00,2023-06-05,10:24,2,0,2
30,2023-06-05T10:24:00+10:00,2023-06-05,10:24,1,0,1
48,2023-06-05T10:24:00+10:00,2023-06-05,10:24,2,3,5
51,2023-06-05T10:24:00+10:00,2023-06-05,10:24,2,1,3
52,2023-06-05T10:24:00+10:00,2023-06-05,10:24,6,0,6
56,2023-06-05T10:24:00+10:00,2023-06-05,10:24,1,2,3
79,2023-06-05T10:24:00+10:00,2023-06-05,10:24,6,7,13
85,2023-06-05T10:24:00+10:00,2023-06-05,10:24,0,2,2
3,2023-06-05T10:24:00+10:00,2023-06-05,10:24,3,5,8
14,2023-06-05T10:24:00+10:00,2023-06-05,10:24,1,1,2
21,2023-06-05T10:24:00+10:00,2023-06-05,10:24,4,4,8
28,2023-06-05T10:24:00+10:00,2023-06-05,10:24,5,3,8
41,2023-06-05T10:24:00+10:00,2023-06-05,10:24,22,8,30
42,2023-06-05T10:24:00+10:00,2023-06-05,10:24,3,4,7
47,2023-06-05T10:24:00+10:00,2023-06-05,10:24,4,4,8
50,2023-06-05T10:24:00+10:00,2023-06-05,10:24,1,3,4
66,2023-06-05T10:24:00+10:00,2023-06-05,10:24,4,2,6
75,2023-06-05T10:24:00+10:00,2023-06-05,10:24,0,1,1
77,2023-06-05T10:24:00+10:00,2023-06-05,10:24,1,1,2
108,2023-06-05T10:24:00+10:00,2023-06-05,10:24,3,3,6
9,2023-06-05T10:24:00+10:00,2023-06-05,10:24,2,5,7
12,2023-06-05T10:24:00+10:00,2023-06-05,10:24,0,1,1
17,2023-06-05T10:24:00+10:00,2023-06-05,10:24,4,0,4
46,2023-06-05T10:24:00+10:00,2023-06-05,10:24,2,1,3
49,2023-06-05T10:24:00+10:00,2023-06-05,10:24,0,1,1
58,2023-06-05T10:24:00+10:00,2023-06-05,10:24,2,3,5
62,2023-06-05T10:24:00+10:00,2023-06-05,10:24,1,2,3
63,2023-06-05T10:24:00+10:00,2023-06-05,10:24,3,2,5
68,2023-06-05T10:24:00+10:00,2023-06-05,10:24,8,3,11
86,2023-06-05T10:24:00+10:00,2023-06-05,10:24,1,0,1
4,2023-06-05T10:23:00+10:00,2023-06-05,10:23,16,7,23
14,2023-06-05T10:23:00+10:00,2023-06-05,10:23,0,2,2
28,2023-06-05T10:23:00+10:00,2023-06-05,10:23,7,8,15
29,2023-06-05T10:23:00+10:00,2023-06-05,10:23,0,4,4
41,2023-06-05T10:23:00+10:00,2023-06-05,10:23,30,6,36
47,2023-06-05T10:23:00+10:00,2023-06-05,10:23,7,6,13
50,2023-06-05T10:23:00+10:00,2023-06-05,10:23,1,0,1
55,2023-06-05T10:23:00+10:00,2023-06-05,10:23,0,10,10
71,2023-06-05T10:23:00+10:00,2023-06-05,10:23,1,0,1
78,2023-06-05T10:23:00+10:00,2023-06-05,10:23,1,1,2
1,2023-06-05T10:23:00+10:00,2023-06-05,10:23,8,8,16
2,2023-06-05T10:23:00+10:00,2023-06-05,10:23,7,4,11
9,2023-06-05T10:23:00+10:00,2023-06-05,10:23,2,4,6
12,2023-06-05T10:23:00+10:00,2023-06-05,10:23,1,3,4
17,2023-06-05T10:23:00+10:00,2023-06-05,10:23,2,6,8
18,2023-06-05T10:23:00+10:00,2023-06-05,10:23,1,3,4
20,2023-06-05T10:23:00+10:00,2023-06-05,10:23,1,9,10
35,2023-06-05T10:23:00+10:00,2023-06-05,10:23,10,7,17
46,2023-06-05T10:23:00+10:00,2023-06-05,10:23,2,10,12
51,2023-06-05T10:23:00+10:00,2023-06-05,10:23,0,1,1
53,2023-06-05T10:23:00+10:00,2023-06-05,10:23,9,2,11
63,2023-06-05T10:23:00+10:00,2023-06-05,10:23,3,7,10
67,2023-06-05T10:23:00+10:00,2023-06-05,10:23,9,4,13
72,2023-06-05T10:23:00+10:00,2023-06-05,10:23,3,2,5
76,2023-06-05T10:23:00+10:00,2023-06-05,10:23,0,1,1
79,2023-06-05T10:23:00+10:00,2023-06-05,10:23,6,2,8
3,2023-06-05T10:23:00+10:00,2023-06-05,10:23,0,8,8
5,2023-06-05T10:23:00+10:00,2023-06-05,10:23,2,7,9
6,2023-06-05T10:23:00+10:00,2023-06-05,10:23,6,7,13
42,2023-06-05T10:23:00+10:00,2023-06-05,10:23,4,1,5
54,2023-06-05T10:23:00+10:00,2023-06-05,10:23,0,3,3
70,2023-06-05T10:23:00+10:00,2023-06-05,10:23,1,2,3
77,2023-06-05T10:23:00+10:00,2023-06-05,10:23,2,1,3
87,2023-06-05T10:23:00+10:00,2023-06-05,10:23,1,0,1
108,2023-06-05T10:23:00+10:00,2023-06-05,10:23,0,10,10
10,2023-06-05T10:23:00+10:00,2023-06-05,10:23,0,1,1
19,2023-06-05T10:23:00+10:00,2023-06-05,10:23,2,0,2
23,2023-06-05T10:23:00+10:00,2023-06-05,10:23,6,2,8
24,2023-06-05T10:23:00+10:00,2023-06-05,10:23,13,3,16
48,2023-06-05T10:23:00+10:00,2023-06-05,10:23,2,3,5
52,2023-06-05T10:23:00+10:00,2023-06-05,10:23,5,0,5
56,2023-06-05T10:23:00+10:00,2023-06-05,10:23,11,0,11
57,2023-06-05T10:23:00+10:00,2023-06-05,10:23,2,1,3
58,2023-06-05T10:23:00+10:00,2023-06-05,10:23,15,0,15
8,2023-06-05T10:23:00+10:00,2023-06-05,10:23,0,4,4
21,2023-06-05T10:23:00+10:00,2023-06-05,10:23,0,3,3
26,2023-06-05T10:23:00+10:00,2023-06-05,10:23,6,3,9
36,2023-06-05T10:23:00+10:00,2023-06-05,10:23,0,1,1
37,2023-06-05T10:23:00+10:00,2023-06-05,10:23,2,1,3
39,2023-06-05T10:23:00+10:00,2023-06-05,10:23,2,0,2
40,2023-06-05T10:23:00+10:00,2023-06-05,10:23,7,2,9
45,2023-06-05T10:23:00+10:00,2023-06-05,10:23,6,3,9
61,2023-06-05T10:23:00+10:00,2023-06-05,10:23,0,7,7
65,2023-06-05T10:23:00+10:00,2023-06-05,10:23,3,5,8
66,2023-06-05T10:23:00+10:00,2023-06-05,10:23,10,16,26
69,2023-06-05T10:23:00+10:00,2023-06-05,10:23,1,3,4
30,2023-06-05T10:23:00+10:00,2023-06-05,10:23,1,2,3
62,2023-06-05T10:23:00+10:00,2023-06-05,10:23,3,0,3
68,2023-06-05T10:23:00+10:00,2023-06-05,10:23,1,3,4
85,2023-06-05T10:23:00+10:00,2023-06-05,10:23,2,0,2
3,2023-06-05T10:22:00+10:00,2023-06-05,10:22,2,7,9
14,2023-06-05T10:22:00+10:00,2023-06-05,10:22,0,2,2
26,2023-06-05T10:22:00+10:00,2023-06-05,10:22,2,3,5
28,2023-06-05T10:22:00+10:00,2023-06-05,10:22,5,4,9
29,2023-06-05T10:22:00+10:00,2023-06-05,10:22,2,0,2
36,2023-06-05T10:22:00+10:00,2023-06-05,10:22,4,1,5
45,2023-06-05T10:22:00+10:00,2023-06-05,10:22,4,0,4
50,2023-06-05T10:22:00+10:00,2023-06-05,10:22,2,1,3
65,2023-06-05T10:22:00+10:00,2023-06-05,10:22,4,4,8
69,2023-06-05T10:22:00+10:00,2023-06-05,10:22,6,2,8
70,2023-06-05T10:22:00+10:00,2023-06-05,10:22,1,0,1
108,2023-06-05T10:22:00+10:00,2023-06-05,10:22,3,6,9
2,2023-06-05T10:22:00+10:00,2023-06-05,10:22,1,2,3
9,2023-06-05T10:22:00+10:00,2023-06-05,10:22,3,5,8
17,2023-06-05T10:22:00+10:00,2023-06-05,10:22,5,0,5
24,2023-06-05T10:22:00+10:00,2023-06-05,10:22,10,5,15
35,2023-06-05T10:22:00+10:00,2023-06-05,10:22,6,8,14
48,2023-06-05T10:22:00+10:00,2023-06-05,10:22,0,1,1
52,2023-06-05T10:22:00+10:00,2023-06-05,10:22,4,2,6
56,2023-06-05T10:22:00+10:00,2023-06-05,10:22,2,0,2
63,2023-06-05T10:22:00+10:00,2023-06-05,10:22,0,2,2
67,2023-06-05T10:22:00+10:00,2023-06-05,10:22,2,6,8
72,2023-06-05T10:22:00+10:00,2023-06-05,10:22,4,0,4
76,2023-06-05T10:22:00+10:00,2023-06-05,10:22,1,1,2
79,2023-06-05T10:22:00+10:00,2023-06-05,10:22,1,5,6
86,2023-06-05T10:22:00+10:00,2023-06-05,10:22,0,1,1
5,2023-06-05T10:22:00+10:00,2023-06-05,10:22,1,4,5
6,2023-06-05T10:22:00+10:00,2023-06-05,10:22,5,1,6
21,2023-06-05T10:22:00+10:00,2023-06-05,10:22,6,0,6
31,2023-06-05T10:22:00+10:00,2023-06-05,10:22,0,2,2
39,2023-06-05T10:22:00+10:00,2023-06-05,10:22,3,3,6
40,2023-06-05T10:22:00+10:00,2023-06-05,10:22,6,2,8
41,2023-06-05T10:22:00+10:00,2023-06-05,10:22,11,25,36
42,2023-06-05T10:22:00+10:00,2023-06-05,10:22,1,3,4
55,2023-06-05T10:22:00+10:00,2023-06-05,10:22,6,11,17
1,2023-06-05T10:22:00+10:00,2023-06-05,10:22,5,3,8
10,2023-06-05T10:22:00+10:00,2023-06-05,10:22,3,1,4
12,2023-06-05T10:22:00+10:00,2023-06-05,10:22,0,1,1
18,2023-06-05T10:22:00+10:00,2023-06-05,10:22,2,3,5
23,2023-06-05T10:22:00+10:00,2023-06-05,10:22,2,0,2
27,2023-06-05T10:22:00+10:00,2023-06-05,10:22,0,1,1
49,2023-06-05T10:22:00+10:00,2023-06-05,10:22,0,1,1
62,2023-06-05T10:22:00+10:00,2023-06-05,10:22,3,1,4
68,2023-06-05T10:22:00+10:00,2023-06-05,10:22,5,3,8
85,2023-06-05T10:22:00+10:00,2023-06-05,10:22,1,0,1
4,2023-06-05T10:22:00+10:00,2023-06-05,10:22,17,16,33
8,2023-06-05T10:22:00+10:00,2023-06-05,10:22,1,0,1
37,2023-06-05T10:22:00+10:00,2023-06-05,10:22,1,1,2
47,2023-06-05T10:22:00+10:00,2023-06-05,10:22,9,6,15
54,2023-06-05T10:22:00+10:00,2023-06-05,10:22,4,1,5
61,2023-06-05T10:22:00+10:00,2023-06-05,10:22,1,5,6
66,2023-06-05T10:22:00+10:00,2023-06-05,10:22,4,3,7
78,2023-06-05T10:22:00+10:00,2023-06-05,10:22,0,1,1
87,2023-06-05T10:22:00+10:00,2023-06-05,10:22,2,1,3
20,2023-06-05T10:22:00+10:00,2023-06-05,10:22,1,2,3
30,2023-06-05T10:22:00+10:00,2023-06-05,10:22,5,2,7
46,2023-06-05T10:22:00+10:00,2023-06-05,10:22,0,3,3
51,2023-06-05T10:22:00+10:00,2023-06-05,10:22,3,1,4
53,2023-06-05T10:22:00+10:00,2023-06-05,10:22,5,10,15
57,2023-06-05T10:22:00+10:00,2023-06-05,10:22,4,1,5
58,2023-06-05T10:22:00+10:00,2023-06-05,10:22,7,3,10
6,2023-06-05T10:21:00+10:00,2023-06-05,10:21,6,7,13
8,2023-06-05T10:21:00+10:00,2023-06-05,10:21,2,2,4
29,2023-06-05T10:21:00+10:00,2023-06-05,10:21,1,6,7
31,2023-06-05T10:21:00+10:00,2023-06-05,10:21,0,1,1
37,2023-06-05T10:21:00+10:00,2023-06-05,10:21,1,0,1
39,2023-06-05T10:21:00+10:00,2023-06-05,10:21,1,0,1
55,2023-06-05T10:21:00+10:00,2023-06-05,10:21,4,11,15
69,2023-06-05T10:21:00+10:00,2023-06-05,10:21,3,2,5
87,2023-06-05T10:21:00+10:00,2023-06-05,10:21,2,0,2
10,2023-06-05T10:21:00+10:00,2023-06-05,10:21,1,2,3
11,2023-06-05T10:21:00+10:00,2023-06-05,10:21,0,1,1
18,2023-06-05T10:21:00+10:00,2023-06-05,10:21,1,5,6
23,2023-06-05T10:21:00+10:00,2023-06-05,10:21,2,1,3
24,2023-06-05T10:21:00+10:00,2023-06-05,10:21,10,18,28
48,2023-06-05T10:21:00+10:00,2023-06-05,10:21,1,1,2
52,2023-06-05T10:21:00+10:00,2023-06-05,10:21,2,1,3
56,2023-06-05T10:21:00+10:00,2023-06-05,10:21,0,1,1
58,2023-06-05T10:21:00+10:00,2023-06-05,10:21,15,2,17
72,2023-06-05T10:21:00+10:00,2023-06-05,10:21,6,1,7
86,2023-06-05T10:21:00+10:00,2023-06-05,10:21,1,0,1
4,2023-06-05T10:21:00+10:00,2023-06-05,10:21,14,9,23
5,2023-06-05T10:21:00+10:00,2023-06-05,10:21,7,9,16
21,2023-06-05T10:21:00+10:00,2023-06-05,10:21,0,3,3
28,2023-06-05T10:21:00+10:00,2023-06-05,10:21,5,2,7
41,2023-06-05T10:21:00+10:00,2023-06-05,10:21,13,28,41
47,2023-06-05T10:21:00+10:00,2023-06-05,10:21,2,8,10
50,2023-06-05T10:21:00+10:00,2023-06-05,10:21,0,2,2
54,2023-06-05T10:21:00+10:00,2023-06-05,10:21,1,0,1
65,2023-06-05T10:21:00+10:00,2023-06-05,10:21,7,2,9
70,2023-06-05T10:21:00+10:00,2023-06-05,10:21,1,2,3
77,2023-06-05T10:21:00+10:00,2023-06-05,10:21,1,1,2
108,2023-06-05T10:21:00+10:00,2023-06-05,10:21,2,1,3
1,2023-06-05T10:21:00+10:00,2023-06-05,10:21,8,6,14
12,2023-06-05T10:21:00+10:00,2023-06-05,10:21,1,0,1
17,2023-06-05T10:21:00+10:00,2023-06-05,10:21,4,8,12
30,2023-06-05T10:21:00+10:00,2023-06-05,10:21,5,2,7
35,2023-06-05T10:21:00+10:00,2023-06-05,10:21,3,6,9
57,2023-06-05T10:21:00+10:00,2023-06-05,10:21,3,8,11
67,2023-06-05T10:21:00+10:00,2023-06-05,10:21,2,3,5
76,2023-06-05T10:21:00+10:00,2023-06-05,10:21,2,1,3
3,2023-06-05T10:21:00+10:00,2023-06-05,10:21,2,3,5
14,2023-06-05T10:21:00+10:00,2023-06-05,10:21,22,6,28
26,2023-06-05T10:21:00+10:00,2023-06-05,10:21,2,3,5
36,2023-06-05T10:21:00+10:00,2023-06-05,10:21,6,0,6
40,2023-06-05T10:21:00+10:00,2023-06-05,10:21,2,0,2
42,2023-06-05T10:21:00+10:00,2023-06-05,10:21,4,2,6
45,2023-06-05T10:21:00+10:00,2023-06-05,10:21,6,2,8
61,2023-06-05T10:21:00+10:00,2023-06-05,10:21,1,5,6
2,2023-06-05T10:21:00+10:00,2023-06-05,10:21,4,6,10
9,2023-06-05T10:21:00+10:00,2023-06-05,10:21,0,3,3
19,2023-06-05T10:21:00+10:00,2023-06-05,10:21,4,0,4
20,2023-06-05T10:21:00+10:00,2023-06-05,10:21,1,2,3
27,2023-06-05T10:21:00+10:00,2023-06-05,10:21,1,0,1
46,2023-06-05T10:21:00+10:00,2023-06-05,10:21,0,3,3
49,2023-06-05T10:21:00+10:00,2023-06-05,10:21,1,2,3
51,2023-06-05T10:21:00+10:00,2023-06-05,10:21,1,2,3
53,2023-06-05T10:21:00+10:00,2023-06-05,10:21,6,6,12
62,2023-06-05T10:21:00+10:00,2023-06-05,10:21,0,1,1
63,2023-06-05T10:21:00+10:00,2023-06-05,10:21,4,3,7
68,2023-06-05T10:21:00+10:00,2023-06-05,10:21,3,4,7
79,2023-06-05T10:21:00+10:00,2023-06-05,10:21,4,8,12
85,2023-06-05T10:21:00+10:00,2023-06-05,10:21,2,1,3
3,2023-06-05T10:20:00+10:00,2023-06-05,10:20,3,2,5
14,2023-06-05T10:20:00+10:00,2023-06-05,10:20,15,1,16
21,2023-06-05T10:20:00+10:00,2023-06-05,10:20,1,0,1
26,2023-06-05T10:20:00+10:00,2023-06-05,10:20,6,3,9
28,2023-06-05T10:20:00+10:00,2023-06-05,10:20,17,3,20
31,2023-06-05T10:20:00+10:00,2023-06-05,10:20,0,2,2
36,2023-06-05T10:20:00+10:00,2023-06-05,10:20,1,1,2
41,2023-06-05T10:20:00+10:00,2023-06-05,10:20,32,9,41
45,2023-06-05T10:20:00+10:00,2023-06-05,10:20,2,2,4
69,2023-06-05T10:20:00+10:00,2023-06-05,10:20,1,0,1
70,2023-06-05T10:20:00+10:00,2023-06-05,10:20,0,4,4
75,2023-06-05T10:20:00+10:00,2023-06-05,10:20,1,0,1
77,2023-06-05T10:20:00+10:00,2023-06-05,10:20,5,0,5
78,2023-06-05T10:20:00+10:00,2023-06-05,10:20,0,1,1
84,2023-06-05T10:20:00+10:00,2023-06-05,10:20,61,23,84
1,2023-06-05T10:20:00+10:00,2023-06-05,10:20,5,12,17
2,2023-06-05T10:20:00+10:00,2023-06-05,10:20,0,2,2
17,2023-06-05T10:20:00+10:00,2023-06-05,10:20,6,2,8
19,2023-06-05T10:20:00+10:00,2023-06-05,10:20,2,1,3
23,2023-06-05T10:20:00+10:00,2023-06-05,10:20,1,3,4
27,2023-06-05T10:20:00+10:00,2023-06-05,10:20,0,1,1
35,2023-06-05T10:20:00+10:00,2023-06-05,10:20,8,4,12
46,2023-06-05T10:20:00+10:00,2023-06-05,10:20,0,6,6
49,2023-06-05T10:20:00+10:00,2023-06-05,10:20,2,0,2
52,2023-06-05T10:20:00+10:00,2023-06-05,10:20,1,3,4
56,2023-06-05T10:20:00+10:00,2023-06-05,10:20,2,0,2
58,2023-06-05T10:20:00+10:00,2023-06-05,10:20,13,8,21
63,2023-06-05T10:20:00+10:00,2023-06-05,10:20,0,2,2
67,2023-06-05T10:20:00+10:00,2023-06-05,10:20,8,4,12
72,2023-06-05T10:20:00+10:00,2023-06-05,10:20,2,1,3
86,2023-06-05T10:20:00+10:00,2023-06-05,10:20,2,0,2
109,2023-06-05T10:20:00+10:00,2023-06-05,10:20,14,15,29
4,2023-06-05T10:20:00+10:00,2023-06-05,10:20,22,8,30
6,2023-06-05T10:20:00+10:00,2023-06-05,10:20,14,4,18
8,2023-06-05T10:20:00+10:00,2023-06-05,10:20,2,5,7
37,2023-06-05T10:20:00+10:00,2023-06-05,10:20,0,3,3
44,2023-06-05T10:20:00+10:00,2023-06-05,10:20,0,1,1
47,2023-06-05T10:20:00+10:00,2023-06-05,10:20,4,14,18
50,2023-06-05T10:20:00+10:00,2023-06-05,10:20,1,7,8
54,2023-06-05T10:20:00+10:00,2023-06-05,10:20,2,2,4
55,2023-06-05T10:20:00+10:00,2023-06-05,10:20,1,5,6
59,2023-06-05T10:20:00+10:00,2023-06-05,10:20,25,30,55
61,2023-06-05T10:20:00+10:00,2023-06-05,10:20,3,5,8
66,2023-06-05T10:20:00+10:00,2023-06-05,10:20,6,7,13
107,2023-06-05T10:20:00+10:00,2023-06-05,10:20,1,7,8
108,2023-06-05T10:20:00+10:00,2023-06-05,10:20,1,5,6
9,2023-06-05T10:20:00+10:00,2023-06-05,10:20,2,8,10
10,2023-06-05T10:20:00+10:00,2023-06-05,10:20,1,0,1
12,2023-06-05T10:20:00+10:00,2023-06-05,10:20,2,0,2
20,2023-06-05T10:20:00+10:00,2023-06-05,10:20,2,1,3
30,2023-06-05T10:20:00+10:00,2023-06-05,10:20,0,3,3
51,2023-06-05T10:20:00+10:00,2023-06-05,10:20,0,3,3
53,2023-06-05T10:20:00+10:00,2023-06-05,10:20,19,4,23
57,2023-06-05T10:20:00+10:00,2023-06-05,10:20,1,3,4
62,2023-06-05T10:20:00+10:00,2023-06-05,10:20,0,1,1
68,2023-06-05T10:20:00+10:00,2023-06-05,10:20,6,6,12
79,2023-06-05T10:20:00+10:00,2023-06-05,10:20,0,1,1
85,2023-06-05T10:20:00+10:00,2023-06-05,10:20,0,1,1
5,2023-06-05T10:20:00+10:00,2023-06-05,10:20,3,4,7
29,2023-06-05T10:20:00+10:00,2023-06-05,10:20,3,1,4
39,2023-06-05T10:20:00+10:00,2023-06-05,10:20,2,3,5
40,2023-06-05T10:20:00+10:00,2023-06-05,10:20,4,2,6
65,2023-06-05T10:20:00+10:00,2023-06-05,10:20,3,10,13
11,2023-06-05T10:20:00+10:00,2023-06-05,10:20,1,1,2
18,2023-06-05T10:20:00+10:00,2023-06-05,10:20,2,0,2
24,2023-06-05T10:20:00+10:00,2023-06-05,10:20,25,2,27
48,2023-06-05T10:20:00+10:00,2023-06-05,10:20,1,2,3
76,2023-06-05T10:20:00+10:00,2023-06-05,10:20,1,0,1
117,2023-06-05T10:20:00+10:00,2023-06-05,10:20,4,8,12
14,2023-06-05T10:19:00+10:00,2023-06-05,10:19,4,2,6
21,2023-06-05T10:19:00+10:00,2023-06-05,10:19,4,2,6
26,2023-06-05T10:19:00+10:00,2023-06-05,10:19,4,5,9
31,2023-06-05T10:19:00+10:00,2023-06-05,10:19,1,2,3
36,2023-06-05T10:19:00+10:00,2023-06-05,10:19,0,2,2
39,2023-06-05T10:19:00+10:00,2023-06-05,10:19,1,1,2
40,2023-06-05T10:19:00+10:00,2023-06-05,10:19,2,3,5
45,2023-06-05T10:19:00+10:00,2023-06-05,10:19,3,3,6
50,2023-06-05T10:19:00+10:00,2023-06-05,10:19,0,2,2
65,2023-06-05T10:19:00+10:00,2023-06-05,10:19,2,1,3
69,2023-06-05T10:19:00+10:00,2023-06-05,10:19,6,1,7
78,2023-06-05T10:19:00+10:00,2023-06-05,10:19,0,1,1
52,2023-06-05T10:19:00+10:00,2023-06-05,10:19,2,2,4
53,2023-06-05T10:19:00+10:00,2023-06-05,10:19,6,6,12
85,2023-06-05T10:19:00+10:00,2023-06-05,10:19,0,2,2
8,2023-06-05T10:19:00+10:00,2023-06-05,10:19,0,1,1
28,2023-06-05T10:19:00+10:00,2023-06-05,10:19,7,5,12
37,2023-06-05T10:19:00+10:00,2023-06-05,10:19,1,0,1
55,2023-06-05T10:19:00+10:00,2023-06-05,10:19,4,16,20
66,2023-06-05T10:19:00+10:00,2023-06-05,10:19,8,3,11
70,2023-06-05T10:19:00+10:00,2023-06-05,10:19,1,0,1
75,2023-06-05T10:19:00+10:00,2023-06-05,10:19,1,0,1
77,2023-06-05T10:19:00+10:00,2023-06-05,10:19,0,3,3
108,2023-06-05T10:19:00+10:00,2023-06-05,10:19,7,5,12
9,2023-06-05T10:19:00+10:00,2023-06-05,10:19,2,5,7
17,2023-06-05T10:19:00+10:00,2023-06-05,10:19,1,10,11
18,2023-06-05T10:19:00+10:00,2023-06-05,10:19,2,3,5
20,2023-06-05T10:19:00+10:00,2023-06-05,10:19,2,1,3
23,2023-06-05T10:19:00+10:00,2023-06-05,10:19,4,5,9
24,2023-06-05T10:19:00+10:00,2023-06-05,10:19,1,8,9
46,2023-06-05T10:19:00+10:00,2023-06-05,10:19,0,3,3
48,2023-06-05T10:19:00+10:00,2023-06-05,10:19,4,1,5
51,2023-06-05T10:19:00+10:00,2023-06-05,10:19,1,6,7
57,2023-06-05T10:19:00+10:00,2023-06-05,10:19,1,1,2
67,2023-06-05T10:19:00+10:00,2023-06-05,10:19,9,4,13
68,2023-06-05T10:19:00+10:00,2023-06-05,10:19,6,3,9
72,2023-06-05T10:19:00+10:00,2023-06-05,10:19,4,0,4
76,2023-06-05T10:19:00+10:00,2023-06-05,10:19,1,1,2
3,2023-06-05T10:19:00+10:00,2023-06-05,10:19,5,4,9
4,2023-06-05T10:19:00+10:00,2023-06-05,10:19,14,8,22
5,2023-06-05T10:19:00+10:00,2023-06-05,10:19,7,8,15
6,2023-06-05T10:19:00+10:00,2023-06-05,10:19,5,8,13
29,2023-06-05T10:19:00+10:00,2023-06-05,10:19,1,2,3
41,2023-06-05T10:19:00+10:00,2023-06-05,10:19,16,15,31
42,2023-06-05T10:19:00+10:00,2023-06-05,10:19,0,1,1
47,2023-06-05T10:19:00+10:00,2023-06-05,10:19,5,5,10
54,2023-06-05T10:19:00+10:00,2023-06-05,10:19,1,0,1
61,2023-06-05T10:19:00+10:00,2023-06-05,10:19,2,4,6
1,2023-06-05T10:19:00+10:00,2023-06-05,10:19,7,17,24
2,2023-06-05T10:19:00+10:00,2023-06-05,10:19,2,6,8
10,2023-06-05T10:19:00+10:00,2023-06-05,10:19,0,3,3
19,2023-06-05T10:19:00+10:00,2023-06-05,10:19,2,1,3
30,2023-06-05T10:19:00+10:00,2023-06-05,10:19,4,0,4
35,2023-06-05T10:19:00+10:00,2023-06-05,10:19,5,4,9
56,2023-06-05T10:19:00+10:00,2023-06-05,10:19,4,0,4
58,2023-06-05T10:19:00+10:00,2023-06-05,10:19,8,2,10
62,2023-06-05T10:19:00+10:00,2023-06-05,10:19,2,0,2
63,2023-06-05T10:19:00+10:00,2023-06-05,10:19,0,3,3
79,2023-06-05T10:19:00+10:00,2023-06-05,10:19,2,5,7
4,2023-06-05T10:18:00+10:00,2023-06-05,10:18,12,9,21
14,2023-06-05T10:18:00+10:00,2023-06-05,10:18,4,1,5
29,2023-06-05T10:18:00+10:00,2023-06-05,10:18,0,1,1
31,2023-06-05T10:18:00+10:00,2023-06-05,10:18,3,0,3
36,2023-06-05T10:18:00+10:00,2023-06-05,10:18,5,2,7
50,2023-06-05T10:18:00+10:00,2023-06-05,10:18,0,1,1
70,2023-06-05T10:18:00+10:00,2023-06-05,10:18,3,2,5
108,2023-06-05T10:18:00+10:00,2023-06-05,10:18,1,3,4
1,2023-06-05T10:18:00+10:00,2023-06-05,10:18,5,4,9
11,2023-06-05T10:18:00+10:00,2023-06-05,10:18,0,3,3
17,2023-06-05T10:18:00+10:00,2023-06-05,10:18,12,2,14
23,2023-06-05T10:18:00+10:00,2023-06-05,10:18,3,0,3
35,2023-06-05T10:18:00+10:00,2023-06-05,10:18,11,14,25
49,2023-06-05T10:18:00+10:00,2023-06-05,10:18,0,1,1
56,2023-06-05T10:18:00+10:00,2023-06-05,10:18,4,1,5
58,2023-06-05T10:18:00+10:00,2023-06-05,10:18,12,1,13
62,2023-06-05T10:18:00+10:00,2023-06-05,10:18,2,2,4
67,2023-06-05T10:18:00+10:00,2023-06-05,10:18,4,6,10
3,2023-06-05T10:18:00+10:00,2023-06-05,10:18,4,8,12
5,2023-06-05T10:18:00+10:00,2023-06-05,10:18,2,5,7
8,2023-06-05T10:18:00+10:00,2023-06-05,10:18,0,1,1
26,2023-06-05T10:18:00+10:00,2023-06-05,10:18,4,3,7
39,2023-06-05T10:18:00+10:00,2023-06-05,10:18,2,0,2
40,2023-06-05T10:18:00+10:00,2023-06-05,10:18,0,4,4
45,2023-06-05T10:18:00+10:00,2023-06-05,10:18,3,5,8
65,2023-06-05T10:18:00+10:00,2023-06-05,10:18,1,3,4
66,2023-06-05T10:18:00+10:00,2023-06-05,10:18,1,3,4
78,2023-06-05T10:18:00+10:00,2023-06-05,10:18,0,1,1
2,2023-06-05T10:18:00+10:00,2023-06-05,10:18,0,4,4
12,2023-06-05T10:18:00+10:00,2023-06-05,10:18,1,4,5
18,2023-06-05T10:18:00+10:00,2023-06-05,10:18,1,2,3
30,2023-06-05T10:18:00+10:00,2023-06-05,10:18,1,0,1
46,2023-06-05T10:18:00+10:00,2023-06-05,10:18,0,1,1
68,2023-06-05T10:18:00+10:00,2023-06-05,10:18,4,8,12
6,2023-06-05T10:18:00+10:00,2023-06-05,10:18,4,4,8
21,2023-06-05T10:18:00+10:00,2023-06-05,10:18,1,3,4
28,2023-06-05T10:18:00+10:00,2023-06-05,10:18,6,6,12
41,2023-06-05T10:18:00+10:00,2023-06-05,10:18,21,9,30
42,2023-06-05T10:18:00+10:00,2023-06-05,10:18,0,1,1
47,2023-06-05T10:18:00+10:00,2023-06-05,10:18,8,9,17
54,2023-06-05T10:18:00+10:00,2023-06-05,10:18,1,2,3
55,2023-06-05T10:18:00+10:00,2023-06-05,10:18,5,5,10
61,2023-06-05T10:18:00+10:00,2023-06-05,10:18,2,4,6
69,2023-06-05T10:18:00+10:00,2023-06-05,10:18,6,1,7
77,2023-06-05T10:18:00+10:00,2023-06-05,10:18,1,0,1
9,2023-06-05T10:18:00+10:00,2023-06-05,10:18,3,4,7
19,2023-06-05T10:18:00+10:00,2023-06-05,10:18,0,2,2
24,2023-06-05T10:18:00+10:00,2023-06-05,10:18,14,8,22
51,2023-06-05T10:18:00+10:00,2023-06-05,10:18,1,2,3
52,2023-06-05T10:18:00+10:00,2023-06-05,10:18,3,2,5
53,2023-06-05T10:18:00+10:00,2023-06-05,10:18,7,2,9
63,2023-06-05T10:18:00+10:00,2023-06-05,10:18,2,8,10
72,2023-06-05T10:18:00+10:00,2023-06-05,10:18,11,0,11
79,2023-06-05T10:18:00+10:00,2023-06-05,10:18,2,5,7
86,2023-06-05T10:18:00+10:00,2023-06-05,10:18,0,1,1
3,2023-06-05T10:17:00+10:00,2023-06-05,10:17,1,0,1
4,2023-06-05T10:17:00+10:00,2023-06-05,10:17,15,10,25
8,2023-06-05T10:17:00+10:00,2023-06-05,10:17,1,2,3
26,2023-06-05T10:17:00+10:00,2023-06-05,10:17,0,12,12
40,2023-06-05T10:17:00+10:00,2023-06-05,10:17,0,3,3
41,2023-06-05T10:17:00+10:00,2023-06-05,10:17,28,7,35
42,2023-06-05T10:17:00+10:00,2023-06-05,10:17,3,5,8
47,2023-06-05T10:17:00+10:00,2023-06-05,10:17,4,2,6
78,2023-06-05T10:17:00+10:00,2023-06-05,10:17,0,1,1
108,2023-06-05T10:17:00+10:00,2023-06-05,10:17,5,2,7
2,2023-06-05T10:17:00+10:00,2023-06-05,10:17,4,3,7
10,2023-06-05T10:17:00+10:00,2023-06-05,10:17,0,3,3
18,2023-06-05T10:17:00+10:00,2023-06-05,10:17,3,2,5
20,2023-06-05T10:17:00+10:00,2023-06-05,10:17,2,0,2
24,2023-06-05T10:17:00+10:00,2023-06-05,10:17,5,6,11
53,2023-06-05T10:17:00+10:00,2023-06-05,10:17,6,5,11
57,2023-06-05T10:17:00+10:00,2023-06-05,10:17,3,1,4
68,2023-06-05T10:17:00+10:00,2023-06-05,10:17,3,3,6
72,2023-06-05T10:17:00+10:00,2023-06-05,10:17,1,2,3
85,2023-06-05T10:17:00+10:00,2023-06-05,10:17,4,1,5
5,2023-06-05T10:17:00+10:00,2023-06-05,10:17,4,11,15
6,2023-06-05T10:17:00+10:00,2023-06-05,10:17,6,8,14
14,2023-06-05T10:17:00+10:00,2023-06-05,10:17,2,1,3
28,2023-06-05T10:17:00+10:00,2023-06-05,10:17,6,2,8
29,2023-06-05T10:17:00+10:00,2023-06-05,10:17,1,2,3
31,2023-06-05T10:17:00+10:00,2023-06-05,10:17,0,5,5
39,2023-06-05T10:17:00+10:00,2023-06-05,10:17,4,1,5
45,2023-06-05T10:17:00+10:00,2023-06-05,10:17,1,5,6
50,2023-06-05T10:17:00+10:00,2023-06-05,10:17,4,0,4
55,2023-06-05T10:17:00+10:00,2023-06-05,10:17,2,7,9
70,2023-06-05T10:17:00+10:00,2023-06-05,10:17,0,2,2
87,2023-06-05T10:17:00+10:00,2023-06-05,10:17,3,0,3
30,2023-06-05T10:17:00+10:00,2023-06-05,10:17,1,0,1
48,2023-06-05T10:17:00+10:00,2023-06-05,10:17,1,1,2
58,2023-06-05T10:17:00+10:00,2023-06-05,10:17,6,1,7
62,2023-06-05T10:17:00+10:00,2023-06-05,10:17,1,0,1
63,2023-06-05T10:17:00+10:00,2023-06-05,10:17,0,5,5
76,2023-06-05T10:17:00+10:00,2023-06-05,10:17,1,1,2
79,2023-06-05T10:17:00+10:00,2023-06-05,10:17,1,1,2
21,2023-06-05T10:17:00+10:00,2023-06-05,10:17,2,2,4
36,2023-06-05T10:17:00+10:00,2023-06-05,10:17,0,1,1
54,2023-06-05T10:17:00+10:00,2023-06-05,10:17,1,1,2
61,2023-06-05T10:17:00+10:00,2023-06-05,10:17,8,0,8
65,2023-06-05T10:17:00+10:00,2023-06-05,10:17,6,4,10
66,2023-06-05T10:17:00+10:00,2023-06-05,10:17,6,5,11
69,2023-06-05T10:17:00+10:00,2023-06-05,10:17,6,1,7
77,2023-06-05T10:17:00+10:00,2023-06-05,10:17,4,1,5
1,2023-06-05T10:17:00+10:00,2023-06-05,10:17,3,2,5
9,2023-06-05T10:17:00+10:00,2023-06-05,10:17,0,4,4
12,2023-06-05T10:17:00+10:00,2023-06-05,10:17,0,2,2
17,2023-06-05T10:17:00+10:00,2023-06-05,10:17,2,3,5
19,2023-06-05T10:17:00+10:00,2023-06-05,10:17,1,0,1
23,2023-06-05T10:17:00+10:00,2023-06-05,10:17,6,1,7
35,2023-06-05T10:17:00+10:00,2023-06-05,10:17,5,7,12
49,2023-06-05T10:17:00+10:00,2023-06-05,10:17,1,0,1
51,2023-06-05T10:17:00+10:00,2023-06-05,10:17,1,3,4
52,2023-06-05T10:17:00+10:00,2023-06-05,10:17,3,0,3
56,2023-06-05T10:17:00+10:00,2023-06-05,10:17,3,0,3
67,2023-06-05T10:17:00+10:00,2023-06-05,10:17,6,7,13
5,2023-06-05T10:16:00+10:00,2023-06-05,10:16,6,10,16
14,2023-06-05T10:16:00+10:00,2023-06-05,10:16,1,1,2
26,2023-06-05T10:16:00+10:00,2023-06-05,10:16,5,4,9
39,2023-06-05T10:16:00+10:00,2023-06-05,10:16,3,1,4
47,2023-06-05T10:16:00+10:00,2023-06-05,10:16,7,7,14
61,2023-06-05T10:16:00+10:00,2023-06-05,10:16,1,8,9
75,2023-06-05T10:16:00+10:00,2023-06-05,10:16,0,1,1
1,2023-06-05T10:16:00+10:00,2023-06-05,10:16,10,3,13
27,2023-06-05T10:16:00+10:00,2023-06-05,10:16,1,3,4
53,2023-06-05T10:16:00+10:00,2023-06-05,10:16,5,3,8
56,2023-06-05T10:16:00+10:00,2023-06-05,10:16,5,0,5
67,2023-06-05T10:16:00+10:00,2023-06-05,10:16,3,20,23
86,2023-06-05T10:16:00+10:00,2023-06-05,10:16,0,1,1
3,2023-06-05T10:16:00+10:00,2023-06-05,10:16,6,3,9
4,2023-06-05T10:16:00+10:00,2023-06-05,10:16,9,6,15
8,2023-06-05T10:16:00+10:00,2023-06-05,10:16,1,3,4
31,2023-06-05T10:16:00+10:00,2023-06-05,10:16,1,0,1
37,2023-06-05T10:16:00+10:00,2023-06-05,10:16,0,1,1
40,2023-06-05T10:16:00+10:00,2023-06-05,10:16,1,2,3
41,2023-06-05T10:16:00+10:00,2023-06-05,10:16,17,15,32
42,2023-06-05T10:16:00+10:00,2023-06-05,10:16,2,3,5
44,2023-06-05T10:16:00+10:00,2023-06-05,10:16,0,1,1
45,2023-06-05T10:16:00+10:00,2023-06-05,10:16,3,6,9
50,2023-06-05T10:16:00+10:00,2023-06-05,10:16,0,2,2
55,2023-06-05T10:16:00+10:00,2023-06-05,10:16,2,9,11
66,2023-06-05T10:16:00+10:00,2023-06-05,10:16,8,8,16
70,2023-06-05T10:16:00+10:00,2023-06-05,10:16,2,1,3
77,2023-06-05T10:16:00+10:00,2023-06-05,10:16,2,1,3
108,2023-06-05T10:16:00+10:00,2023-06-05,10:16,3,7,10
2,2023-06-05T10:16:00+10:00,2023-06-05,10:16,4,6,10
9,2023-06-05T10:16:00+10:00,2023-06-05,10:16,4,6,10
18,2023-06-05T10:16:00+10:00,2023-06-05,10:16,1,1,2
19,2023-06-05T10:16:00+10:00,2023-06-05,10:16,0,2,2
20,2023-06-05T10:16:00+10:00,2023-06-05,10:16,0,2,2
35,2023-06-05T10:16:00+10:00,2023-06-05,10:16,5,2,7
46,2023-06-05T10:16:00+10:00,2023-06-05,10:16,0,2,2
48,2023-06-05T10:16:00+10:00,2023-06-05,10:16,1,2,3
51,2023-06-05T10:16:00+10:00,2023-06-05,10:16,2,0,2
52,2023-06-05T10:16:00+10:00,2023-06-05,10:16,10,2,12
57,2023-06-05T10:16:00+10:00,2023-06-05,10:16,2,1,3
58,2023-06-05T10:16:00+10:00,2023-06-05,10:16,6,0,6
62,2023-06-05T10:16:00+10:00,2023-06-05,10:16,3,0,3
63,2023-06-05T10:16:00+10:00,2023-06-05,10:16,4,1,5
68,2023-06-05T10:16:00+10:00,2023-06-05,10:16,1,5,6
79,2023-06-05T10:16:00+10:00,2023-06-05,10:16,9,4,13
6,2023-06-05T10:16:00+10:00,2023-06-05,10:16,11,4,15
21,2023-06-05T10:16:00+10:00,2023-06-05,10:16,1,2,3
28,2023-06-05T10:16:00+10:00,2023-06-05,10:16,2,3,5
29,2023-06-05T10:16:00+10:00,2023-06-05,10:16,0,2,2
36,2023-06-05T10:16:00+10:00,2023-06-05,10:16,0,1,1
54,2023-06-05T10:16:00+10:00,2023-06-05,10:16,4,0,4
65,2023-06-05T10:16:00+10:00,2023-06-05,10:16,3,1,4
69,2023-06-05T10:16:00+10:00,2023-06-05,10:16,4,3,7
87,2023-06-05T10:16:00+10:00,2023-06-05,10:16,2,1,3
10,2023-06-05T10:16:00+10:00,2023-06-05,10:16,2,0,2
12,2023-06-05T10:16:00+10:00,2023-06-05,10:16,4,2,6
17,2023-06-05T10:16:00+10:00,2023-06-05,10:16,2,2,4
23,2023-06-05T10:16:00+10:00,2023-06-05,10:16,2,0,2
24,2023-06-05T10:16:00+10:00,2023-06-05,10:16,11,4,15
30,2023-06-05T10:16:00+10:00,2023-06-05,10:16,0,2,2
72,2023-06-05T10:16:00+10:00,2023-06-05,10:16,2,0,2
76,2023-06-05T10:16:00+10:00,2023-06-05,10:16,0,1,1
5,2023-06-05T10:15:00+10:00,2023-06-05,10:15,1,16,17
31,2023-06-05T10:15:00+10:00,2023-06-05,10:15,0,1,1
36,2023-06-05T10:15:00+10:00,2023-06-05,10:15,0,2,2
39,2023-06-05T10:15:00+10:00,2023-06-05,10:15,2,0,2
44,2023-06-05T10:15:00+10:00,2023-06-05,10:15,0,2,2
45,2023-06-05T10:15:00+10:00,2023-06-05,10:15,3,2,5
50,2023-06-05T10:15:00+10:00,2023-06-05,10:15,1,2,3
54,2023-06-05T10:15:00+10:00,2023-06-05,10:15,3,0,3
65,2023-06-05T10:15:00+10:00,2023-06-05,10:15,1,0,1
66,2023-06-05T10:15:00+10:00,2023-06-05,10:15,6,5,11
84,2023-06-05T10:15:00+10:00,2023-06-05,10:15,62,31,93
2,2023-06-05T10:15:00+10:00,2023-06-05,10:15,6,6,12
9,2023-06-05T10:15:00+10:00,2023-06-05,10:15,0,4,4
11,2023-06-05T10:15:00+10:00,2023-06-05,10:15,2,1,3
18,2023-06-05T10:15:00+10:00,2023-06-05,10:15,3,1,4
19,2023-06-05T10:15:00+10:00,2023-06-05,10:15,2,0,2
27,2023-06-05T10:15:00+10:00,2023-06-05,10:15,2,0,2
30,2023-06-05T10:15:00+10:00,2023-06-05,10:15,1,2,3
46,2023-06-05T10:15:00+10:00,2023-06-05,10:15,2,1,3
48,2023-06-05T10:15:00+10:00,2023-06-05,10:15,4,0,4
58,2023-06-05T10:15:00+10:00,2023-06-05,10:15,6,1,7
63,2023-06-05T10:15:00+10:00,2023-06-05,10:15,1,2,3
67,2023-06-05T10:15:00+10:00,2023-06-05,10:15,4,6,10
85,2023-06-05T10:15:00+10:00,2023-06-05,10:15,1,0,1
109,2023-06-05T10:15:00+10:00,2023-06-05,10:15,10,8,18
117,2023-06-05T10:15:00+10:00,2023-06-05,10:15,17,5,22
4,2023-06-05T10:15:00+10:00,2023-06-05,10:15,9,4,13
6,2023-06-05T10:15:00+10:00,2023-06-05,10:15,4,4,8
47,2023-06-05T10:15:00+10:00,2023-06-05,10:15,3,6,9
55,2023-06-05T10:15:00+10:00,2023-06-05,10:15,2,11,13
61,2023-06-05T10:15:00+10:00,2023-06-05,10:15,4,2,6
77,2023-06-05T10:15:00+10:00,2023-06-05,10:15,1,1,2
87,2023-06-05T10:15:00+10:00,2023-06-05,10:15,1,2,3
107,2023-06-05T10:15:00+10:00,2023-06-05,10:15,8,14,22
10,2023-06-05T10:15:00+10:00,2023-06-05,10:15,2,1,3
23,2023-06-05T10:15:00+10:00,2023-06-05,10:15,6,5,11
35,2023-06-05T10:15:00+10:00,2023-06-05,10:15,7,5,12
49,2023-06-05T10:15:00+10:00,2023-06-05,10:15,0,1,1
51,2023-06-05T10:15:00+10:00,2023-06-05,10:15,3,0,3
56,2023-06-05T10:15:00+10:00,2023-06-05,10:15,1,1,2
57,2023-06-05T10:15:00+10:00,2023-06-05,10:15,1,3,4
72,2023-06-05T10:15:00+10:00,2023-06-05,10:15,6,2,8
86,2023-06-05T10:15:00+10:00,2023-06-05,10:15,2,0,2
3,2023-06-05T10:15:00+10:00,2023-06-05,10:15,11,1,12
8,2023-06-05T10:15:00+10:00,2023-06-05,10:15,0,7,7
14,2023-06-05T10:15:00+10:00,2023-06-05,10:15,4,2,6
21,2023-06-05T10:15:00+10:00,2023-06-05,10:15,1,0,1
26,2023-06-05T10:15:00+10:00,2023-06-05,10:15,5,1,6
28,2023-06-05T10:15:00+10:00,2023-06-05,10:15,10,2,12
29,2023-06-05T10:15:00+10:00,2023-06-05,10:15,1,1,2
41,2023-06-05T10:15:00+10:00,2023-06-05,10:15,5,11,16
59,2023-06-05T10:15:00+10:00,2023-06-05,10:15,27,17,44
69,2023-06-05T10:15:00+10:00,2023-06-05,10:15,2,0,2
70,2023-06-05T10:15:00+10:00,2023-06-05,10:15,1,1,2
108,2023-06-05T10:15:00+10:00,2023-06-05,10:15,5,2,7
118,2023-06-05T10:15:00+10:00,2023-06-05,10:15,1,1,2
1,2023-06-05T10:15:00+10:00,2023-06-05,10:15,18,6,24
12,2023-06-05T10:15:00+10:00,2023-06-05,10:15,1,3,4
17,2023-06-05T10:15:00+10:00,2023-06-05,10:15,6,2,8
20,2023-06-05T10:15:00+10:00,2023-06-05,10:15,3,0,3
24,2023-06-05T10:15:00+10:00,2023-06-05,10:15,15,7,22
52,2023-06-05T10:15:00+10:00,2023-06-05,10:15,1,5,6
53,2023-06-05T10:15:00+10:00,2023-06-05,10:15,8,7,15
62,2023-06-05T10:15:00+10:00,2023-06-05,10:15,2,2,4
68,2023-06-05T10:15:00+10:00,2023-06-05,10:15,4,4,8
79,2023-06-05T10:15:00+10:00,2023-06-05,10:15,4,6,10
26,2023-06-05T10:14:00+10:00,2023-06-05,10:14,2,4,6
39,2023-06-05T10:14:00+10:00,2023-06-05,10:14,4,2,6
55,2023-06-05T10:14:00+10:00,2023-06-05,10:14,3,5,8
61,2023-06-05T10:14:00+10:00,2023-06-05,10:14,2,1,3
10,2023-06-05T10:14:00+10:00,2023-06-05,10:14,2,1,3
18,2023-06-05T10:14:00+10:00,2023-06-05,10:14,3,3,6
19,2023-06-05T10:14:00+10:00,2023-06-05,10:14,2,1,3
24,2023-06-05T10:14:00+10:00,2023-06-05,10:14,3,25,28
30,2023-06-05T10:14:00+10:00,2023-06-05,10:14,0,3,3
52,2023-06-05T10:14:00+10:00,2023-06-05,10:14,1,2,3
53,2023-06-05T10:14:00+10:00,2023-06-05,10:14,3,5,8
56,2023-06-05T10:14:00+10:00,2023-06-05,10:14,2,4,6
63,2023-06-05T10:14:00+10:00,2023-06-05,10:14,0,4,4
67,2023-06-05T10:14:00+10:00,2023-06-05,10:14,3,4,7
3,2023-06-05T10:14:00+10:00,2023-06-05,10:14,0,2,2
4,2023-06-05T10:14:00+10:00,2023-06-05,10:14,12,7,19
6,2023-06-05T10:14:00+10:00,2023-06-05,10:14,3,0,3
8,2023-06-05T10:14:00+10:00,2023-06-05,10:14,1,0,1
37,2023-06-05T10:14:00+10:00,2023-06-05,10:14,1,0,1
41,2023-06-05T10:14:00+10:00,2023-06-05,10:14,39,7,46
45,2023-06-05T10:14:00+10:00,2023-06-05,10:14,4,1,5
47,2023-06-05T10:14:00+10:00,2023-06-05,10:14,3,3,6
66,2023-06-05T10:14:00+10:00,2023-06-05,10:14,2,2,4
87,2023-06-05T10:14:00+10:00,2023-06-05,10:14,1,0,1
1,2023-06-05T10:14:00+10:00,2023-06-05,10:14,9,8,17
2,2023-06-05T10:14:00+10:00,2023-06-05,10:14,8,4,12
9,2023-06-05T10:14:00+10:00,2023-06-05,10:14,3,2,5
12,2023-06-05T10:14:00+10:00,2023-06-05,10:14,1,0,1
17,2023-06-05T10:14:00+10:00,2023-06-05,10:14,7,2,9
20,2023-06-05T10:14:00+10:00,2023-06-05,10:14,1,2,3
27,2023-06-05T10:14:00+10:00,2023-06-05,10:14,1,0,1
35,2023-06-05T10:14:00+10:00,2023-06-05,10:14,5,3,8
48,2023-06-05T10:14:00+10:00,2023-06-05,10:14,1,2,3
51,2023-06-05T10:14:00+10:00,2023-06-05,10:14,3,0,3
58,2023-06-05T10:14:00+10:00,2023-06-05,10:14,2,0,2
72,2023-06-05T10:14:00+10:00,2023-06-05,10:14,1,0,1
5,2023-06-05T10:14:00+10:00,2023-06-05,10:14,3,6,9
14,2023-06-05T10:14:00+10:00,2023-06-05,10:14,4,0,4
21,2023-06-05T10:14:00+10:00,2023-06-05,10:14,1,6,7
28,2023-06-05T10:14:00+10:00,2023-06-05,10:14,11,0,11
29,2023-06-05T10:14:00+10:00,2023-06-05,10:14,2,2,4
36,2023-06-05T10:14:00+10:00,2023-06-05,10:14,2,1,3
40,2023-06-05T10:14:00+10:00,2023-06-05,10:14,1,0,1
42,2023-06-05T10:14:00+10:00,2023-06-05,10:14,1,0,1
50,2023-06-05T10:14:00+10:00,2023-06-05,10:14,1,2,3
65,2023-06-05T10:14:00+10:00,2023-06-05,10:14,3,2,5
69,2023-06-05T10:14:00+10:00,2023-06-05,10:14,4,0,4
70,2023-06-05T10:14:00+10:00,2023-06-05,10:14,3,4,7
77,2023-06-05T10:14:00+10:00,2023-06-05,10:14,1,0,1
108,2023-06-05T10:14:00+10:00,2023-06-05,10:14,8,10,18
23,2023-06-05T10:14:00+10:00,2023-06-05,10:14,4,5,9
49,2023-06-05T10:14:00+10:00,2023-06-05,10:14,1,0,1
57,2023-06-05T10:14:00+10:00,2023-06-05,10:14,6,11,17
62,2023-06-05T10:14:00+10:00,2023-06-05,10:14,1,0,1
68,2023-06-05T10:14:00+10:00,2023-06-05,10:14,2,1,3
79,2023-06-05T10:14:00+10:00,2023-06-05,10:14,13,16,29
85,2023-06-05T10:14:00+10:00,2023-06-05,10:14,1,3,4
4,2023-06-05T10:13:00+10:00,2023-06-05,10:13,13,7,20
14,2023-06-05T10:13:00+10:00,2023-06-05,10:13,1,0,1
28,2023-06-05T10:13:00+10:00,2023-06-05,10:13,4,2,6
29,2023-06-05T10:13:00+10:00,2023-06-05,10:13,1,0,1
31,2023-06-05T10:13:00+10:00,2023-06-05,10:13,1,0,1
36,2023-06-05T10:13:00+10:00,2023-06-05,10:13,1,1,2
37,2023-06-05T10:13:00+10:00,2023-06-05,10:13,2,1,3
39,2023-06-05T10:13:00+10:00,2023-06-05,10:13,0,3,3
42,2023-06-05T10:13:00+10:00,2023-06-05,10:13,0,1,1
61,2023-06-05T10:13:00+10:00,2023-06-05,10:13,4,5,9
65,2023-06-05T10:13:00+10:00,2023-06-05,10:13,0,3,3
87,2023-06-05T10:13:00+10:00,2023-06-05,10:13,6,0,6
1,2023-06-05T10:13:00+10:00,2023-06-05,10:13,3,5,8
17,2023-06-05T10:13:00+10:00,2023-06-05,10:13,2,6,8
30,2023-06-05T10:13:00+10:00,2023-06-05,10:13,7,3,10
35,2023-06-05T10:13:00+10:00,2023-06-05,10:13,4,4,8
58,2023-06-05T10:13:00+10:00,2023-06-05,10:13,8,1,9
67,2023-06-05T10:13:00+10:00,2023-06-05,10:13,6,17,23
72,2023-06-05T10:13:00+10:00,2023-06-05,10:13,2,1,3
76,2023-06-05T10:13:00+10:00,2023-06-05,10:13,0,1,1
85,2023-06-05T10:13:00+10:00,2023-06-05,10:13,2,0,2
5,2023-06-05T10:13:00+10:00,2023-06-05,10:13,12,9,21
26,2023-06-05T10:13:00+10:00,2023-06-05,10:13,3,3,6
41,2023-06-05T10:13:00+10:00,2023-06-05,10:13,25,11,36
45,2023-06-05T10:13:00+10:00,2023-06-05,10:13,3,4,7
47,2023-06-05T10:13:00+10:00,2023-06-05,10:13,5,3,8
54,2023-06-05T10:13:00+10:00,2023-06-05,10:13,1,1,2
66,2023-06-05T10:13:00+10:00,2023-06-05,10:13,5,6,11
78,2023-06-05T10:13:00+10:00,2023-06-05,10:13,0,4,4
10,2023-06-05T10:13:00+10:00,2023-06-05,10:13,4,0,4
20,2023-06-05T10:13:00+10:00,2023-06-05,10:13,2,1,3
24,2023-06-05T10:13:00+10:00,2023-06-05,10:13,9,4,13
46,2023-06-05T10:13:00+10:00,2023-06-05,10:13,0,1,1
49,2023-06-05T10:13:00+10:00,2023-06-05,10:13,0,1,1
52,2023-06-05T10:13:00+10:00,2023-06-05,10:13,3,4,7
56,2023-06-05T10:13:00+10:00,2023-06-05,10:13,1,0,1
57,2023-06-05T10:13:00+10:00,2023-06-05,10:13,1,4,5
86,2023-06-05T10:13:00+10:00,2023-06-05,10:13,1,2,3
3,2023-06-05T10:13:00+10:00,2023-06-05,10:13,1,6,7
6,2023-06-05T10:13:00+10:00,2023-06-05,10:13,3,2,5
8,2023-06-05T10:13:00+10:00,2023-06-05,10:13,5,0,5
40,2023-06-05T10:13:00+10:00,2023-06-05,10:13,1,2,3
44,2023-06-05T10:13:00+10:00,2023-06-05,10:13,1,1,2
50,2023-06-05T10:13:00+10:00,2023-06-05,10:13,1,2,3
55,2023-06-05T10:13:00+10:00,2023-06-05,10:13,9,13,22
70,2023-06-05T10:13:00+10:00,2023-06-05,10:13,2,1,3
71,2023-06-05T10:13:00+10:00,2023-06-05,10:13,1,0,1
77,2023-06-05T10:13:00+10:00,2023-06-05,10:13,1,1,2
108,2023-06-05T10:13:00+10:00,2023-06-05,10:13,0,5,5
2,2023-06-05T10:13:00+10:00,2023-06-05,10:13,2,2,4
9,2023-06-05T10:13:00+10:00,2023-06-05,10:13,0,12,12
18,2023-06-05T10:13:00+10:00,2023-06-05,10:13,1,1,2
19,2023-06-05T10:13:00+10:00,2023-06-05,10:13,3,1,4
23,2023-06-05T10:13:00+10:00,2023-06-05,10:13,3,0,3
27,2023-06-05T10:13:00+10:00,2023-06-05,10:13,2,1,3
48,2023-06-05T10:13:00+10:00,2023-06-05,10:13,3,2,5
51,2023-06-05T10:13:00+10:00,2023-06-05,10:13,0,1,1
53,2023-06-05T10:13:00+10:00,2023-06-05,10:13,8,5,13
62,2023-06-05T10:13:00+10:00,2023-06-05,10:13,1,0,1
63,2023-06-05T10:13:00+10:00,2023-06-05,10:13,1,4,5
68,2023-06-05T10:13:00+10:00,2023-06-05,10:13,2,1,3
79,2023-06-05T10:13:00+10:00,2023-06-05,10:13,2,5,7
5,2023-06-05T10:12:00+10:00,2023-06-05,10:12,6,7,13
26,2023-06-05T10:12:00+10:00,2023-06-05,10:12,8,0,8
28,2023-06-05T10:12:00+10:00,2023-06-05,10:12,9,1,10
29,2023-06-05T10:12:00+10:00,2023-06-05,10:12,0,2,2
42,2023-06-05T10:12:00+10:00,2023-06-05,10:12,2,0,2
55,2023-06-05T10:12:00+10:00,2023-06-05,10:12,5,3,8
61,2023-06-05T10:12:00+10:00,2023-06-05,10:12,2,2,4
65,2023-06-05T10:12:00+10:00,2023-06-05,10:12,2,6,8
75,2023-06-05T10:12:00+10:00,2023-06-05,10:12,2,0,2
108,2023-06-05T10:12:00+10:00,2023-06-05,10:12,5,4,9
10,2023-06-05T10:12:00+10:00,2023-06-05,10:12,0,1,1
17,2023-06-05T10:12:00+10:00,2023-06-05,10:12,6,9,15
20,2023-06-05T10:12:00+10:00,2023-06-05,10:12,4,1,5
23,2023-06-05T10:12:00+10:00,2023-06-05,10:12,0,2,2
24,2023-06-05T10:12:00+10:00,2023-06-05,10:12,5,15,20
27,2023-06-05T10:12:00+10:00,2023-06-05,10:12,2,0,2
49,2023-06-05T10:12:00+10:00,2023-06-05,10:12,3,0,3
51,2023-06-05T10:12:00+10:00,2023-06-05,10:12,2,1,3
62,2023-06-05T10:12:00+10:00,2023-06-05,10:12,2,1,3
67,2023-06-05T10:12:00+10:00,2023-06-05,10:12,5,3,8
3,2023-06-05T10:12:00+10:00,2023-06-05,10:12,7,3,10
4,2023-06-05T10:12:00+10:00,2023-06-05,10:12,8,7,15
6,2023-06-05T10:12:00+10:00,2023-06-05,10:12,9,3,12
21,2023-06-05T10:12:00+10:00,2023-06-05,10:12,0,3,3
31,2023-06-05T10:12:00+10:00,2023-06-05,10:12,0,2,2
36,2023-06-05T10:12:00+10:00,2023-06-05,10:12,2,0,2
37,2023-06-05T10:12:00+10:00,2023-06-05,10:12,0,1,1
39,2023-06-05T10:12:00+10:00,2023-06-05,10:12,2,2,4
40,2023-06-05T10:12:00+10:00,2023-06-05,10:12,1,2,3
41,2023-06-05T10:12:00+10:00,2023-06-05,10:12,11,20,31
45,2023-06-05T10:12:00+10:00,2023-06-05,10:12,3,4,7
50,2023-06-05T10:12:00+10:00,2023-06-05,10:12,2,3,5
54,2023-06-05T10:12:00+10:00,2023-06-05,10:12,2,2,4
66,2023-06-05T10:12:00+10:00,2023-06-05,10:12,4,1,5
69,2023-06-05T10:12:00+10:00,2023-06-05,10:12,4,0,4
70,2023-06-05T10:12:00+10:00,2023-06-05,10:12,3,1,4
87,2023-06-05T10:12:00+10:00,2023-06-05,10:12,0,1,1
2,2023-06-05T10:12:00+10:00,2023-06-05,10:12,1,6,7
11,2023-06-05T10:12:00+10:00,2023-06-05,10:12,1,0,1
18,2023-06-05T10:12:00+10:00,2023-06-05,10:12,1,1,2
30,2023-06-05T10:12:00+10:00,2023-06-05,10:12,0,1,1
35,2023-06-05T10:12:00+10:00,2023-06-05,10:12,6,2,8
46,2023-06-05T10:12:00+10:00,2023-06-05,10:12,0,4,4
53,2023-06-05T10:12:00+10:00,2023-06-05,10:12,9,7,16
56,2023-06-05T10:12:00+10:00,2023-06-05,10:12,1,2,3
57,2023-06-05T10:12:00+10:00,2023-06-05,10:12,0,8,8
63,2023-06-05T10:12:00+10:00,2023-06-05,10:12,4,3,7
68,2023-06-05T10:12:00+10:00,2023-06-05,10:12,2,2,4
72,2023-06-05T10:12:00+10:00,2023-06-05,10:12,4,1,5
76,2023-06-05T10:12:00+10:00,2023-06-05,10:12,1,1,2
85,2023-06-05T10:12:00+10:00,2023-06-05,10:12,2,2,4
86,2023-06-05T10:12:00+10:00,2023-06-05,10:12,0,2,2
8,2023-06-05T10:12:00+10:00,2023-06-05,10:12,0,3,3
14,2023-06-05T10:12:00+10:00,2023-06-05,10:12,6,0,6
44,2023-06-05T10:12:00+10:00,2023-06-05,10:12,1,1,2
47,2023-06-05T10:12:00+10:00,2023-06-05,10:12,3,3,6
71,2023-06-05T10:12:00+10:00,2023-06-05,10:12,1,0,1
77,2023-06-05T10:12:00+10:00,2023-06-05,10:12,4,6,10
1,2023-06-05T10:12:00+10:00,2023-06-05,10:12,3,3,6
9,2023-06-05T10:12:00+10:00,2023-06-05,10:12,1,1,2
12,2023-06-05T10:12:00+10:00,2023-06-05,10:12,1,1,2
19,2023-06-05T10:12:00+10:00,2023-06-05,10:12,2,1,3
48,2023-06-05T10:12:00+10:00,2023-06-05,10:12,0,1,1
58,2023-06-05T10:12:00+10:00,2023-06-05,10:12,16,1,17
79,2023-06-05T10:12:00+10:00,2023-06-05,10:12,7,8,15
5,2023-06-05T10:11:00+10:00,2023-06-05,10:11,3,8,11
28,2023-06-05T10:11:00+10:00,2023-06-05,10:11,2,4,6
47,2023-06-05T10:11:00+10:00,2023-06-05,10:11,7,7,14
50,2023-06-05T10:11:00+10:00,2023-06-05,10:11,5,2,7
55,2023-06-05T10:11:00+10:00,2023-06-05,10:11,3,2,5
71,2023-06-05T10:11:00+10:00,2023-06-05,10:11,1,1,2
87,2023-06-05T10:11:00+10:00,2023-06-05,10:11,0,4,4
108,2023-06-05T10:11:00+10:00,2023-06-05,10:11,7,7,14
2,2023-06-05T10:11:00+10:00,2023-06-05,10:11,1,5,6
12,2023-06-05T10:11:00+10:00,2023-06-05,10:11,1,1,2
17,2023-06-05T10:11:00+10:00,2023-06-05,10:11,4,6,10
19,2023-06-05T10:11:00+10:00,2023-06-05,10:11,2,1,3
23,2023-06-05T10:11:00+10:00,2023-06-05,10:11,4,2,6
30,2023-06-05T10:11:00+10:00,2023-06-05,10:11,2,4,6
48,2023-06-05T10:11:00+10:00,2023-06-05,10:11,1,1,2
53,2023-06-05T10:11:00+10:00,2023-06-05,10:11,8,11,19
56,2023-06-05T10:11:00+10:00,2023-06-05,10:11,4,3,7
57,2023-06-05T10:11:00+10:00,2023-06-05,10:11,4,4,8
72,2023-06-05T10:11:00+10:00,2023-06-05,10:11,8,1,9
86,2023-06-05T10:11:00+10:00,2023-06-05,10:11,1,0,1
3,2023-06-05T10:11:00+10:00,2023-06-05,10:11,4,3,7
6,2023-06-05T10:11:00+10:00,2023-06-05,10:11,6,1,7
8,2023-06-05T10:11:00+10:00,2023-06-05,10:11,3,2,5
14,2023-06-05T10:11:00+10:00,2023-06-05,10:11,3,1,4
21,2023-06-05T10:11:00+10:00,2023-06-05,10:11,2,0,2
26,2023-06-05T10:11:00+10:00,2023-06-05,10:11,1,4,5
40,2023-06-05T10:11:00+10:00,2023-06-05,10:11,1,3,4
42,2023-06-05T10:11:00+10:00,2023-06-05,10:11,2,5,7
44,2023-06-05T10:11:00+10:00,2023-06-05,10:11,0,1,1
61,2023-06-05T10:11:00+10:00,2023-06-05,10:11,2,13,15
66,2023-06-05T10:11:00+10:00,2023-06-05,10:11,11,7,18
69,2023-06-05T10:11:00+10:00,2023-06-05,10:11,4,3,7
70,2023-06-05T10:11:00+10:00,2023-06-05,10:11,2,0,2
10,2023-06-05T10:11:00+10:00,2023-06-05,10:11,0,1,1
27,2023-06-05T10:11:00+10:00,2023-06-05,10:11,1,2,3
46,2023-06-05T10:11:00+10:00,2023-06-05,10:11,1,3,4
62,2023-06-05T10:11:00+10:00,2023-06-05,10:11,2,0,2
79,2023-06-05T10:11:00+10:00,2023-06-05,10:11,5,9,14
85,2023-06-05T10:11:00+10:00,2023-06-05,10:11,1,0,1
4,2023-06-05T10:11:00+10:00,2023-06-05,10:11,14,12,26
29,2023-06-05T10:11:00+10:00,2023-06-05,10:11,0,2,2
31,2023-06-05T10:11:00+10:00,2023-06-05,10:11,2,1,3
36,2023-06-05T10:11:00+10:00,2023-06-05,10:11,0,3,3
37,2023-06-05T10:11:00+10:00,2023-06-05,10:11,1,0,1
39,2023-06-05T10:11:00+10:00,2023-06-05,10:11,1,2,3
41,2023-06-05T10:11:00+10:00,2023-06-05,10:11,18,4,22
45,2023-06-05T10:11:00+10:00,2023-06-05,10:11,2,7,9
54,2023-06-05T10:11:00+10:00,2023-06-05,10:11,3,2,5
65,2023-06-05T10:11:00+10:00,2023-06-05,10:11,7,4,11
1,2023-06-05T10:11:00+10:00,2023-06-05,10:11,6,8,14
9,2023-06-05T10:11:00+10:00,2023-06-05,10:11,0,3,3
18,2023-06-05T10:11:00+10:00,2023-06-05,10:11,0,3,3
24,2023-06-05T10:11:00+10:00,2023-06-05,10:11,11,7,18
35,2023-06-05T10:11:00+10:00,2023-06-05,10:11,5,2,7
51,2023-06-05T10:11:00+10:00,2023-06-05,10:11,1,0,1
52,2023-06-05T10:11:00+10:00,2023-06-05,10:11,3,4,7
58,2023-06-05T10:11:00+10:00,2023-06-05,10:11,5,5,10
63,2023-06-05T10:11:00+10:00,2023-06-05,10:11,2,2,4
67,2023-06-05T10:11:00+10:00,2023-06-05,10:11,1,4,5
68,2023-06-05T10:11:00+10:00,2023-06-05,10:11,3,4,7
8,2023-06-05T10:10:00+10:00,2023-06-05,10:10,1,2,3
28,2023-06-05T10:10:00+10:00,2023-06-05,10:10,5,2,7
40,2023-06-05T10:10:00+10:00,2023-06-05,10:10,2,2,4
44,2023-06-05T10:10:00+10:00,2023-06-05,10:10,1,1,2
45,2023-06-05T10:10:00+10:00,2023-06-05,10:10,7,5,12
50,2023-06-05T10:10:00+10:00,2023-06-05,10:10,1,3,4
55,2023-06-05T10:10:00+10:00,2023-06-05,10:10,4,11,15
61,2023-06-05T10:10:00+10:00,2023-06-05,10:10,1,7,8
66,2023-06-05T10:10:00+10:00,2023-06-05,10:10,2,5,7
69,2023-06-05T10:10:00+10:00,2023-06-05,10:10,5,4,9
78,2023-06-05T10:10:00+10:00,2023-06-05,10:10,0,1,1
108,2023-06-05T10:10:00+10:00,2023-06-05,10:10,0,5,5
118,2023-06-05T10:10:00+10:00,2023-06-05,10:10,0,4,4
1,2023-06-05T10:10:00+10:00,2023-06-05,10:10,7,5,12
9,2023-06-05T10:10:00+10:00,2023-06-05,10:10,0,8,8
30,2023-06-05T10:10:00+10:00,2023-06-05,10:10,0,4,4
35,2023-06-05T10:10:00+10:00,2023-06-05,10:10,7,5,12
51,2023-06-05T10:10:00+10:00,2023-06-05,10:10,1,1,2
52,2023-06-05T10:10:00+10:00,2023-06-05,10:10,5,5,10
57,2023-06-05T10:10:00+10:00,2023-06-05,10:10,2,7,9
63,2023-06-05T10:10:00+10:00,2023-06-05,10:10,3,2,5
67,2023-06-05T10:10:00+10:00,2023-06-05,10:10,6,2,8
79,2023-06-05T10:10:00+10:00,2023-06-05,10:10,6,15,21
85,2023-06-05T10:10:00+10:00,2023-06-05,10:10,1,0,1
109,2023-06-05T10:10:00+10:00,2023-06-05,10:10,9,9,18
3,2023-06-05T10:10:00+10:00,2023-06-05,10:10,1,1,2
4,2023-06-05T10:10:00+10:00,2023-06-05,10:10,21,11,32
5,2023-06-05T10:10:00+10:00,2023-06-05,10:10,0,7,7
14,2023-06-05T10:10:00+10:00,2023-06-05,10:10,3,0,3
21,2023-06-05T10:10:00+10:00,2023-06-05,10:10,2,0,2
29,2023-06-05T10:10:00+10:00,2023-06-05,10:10,2,1,3
36,2023-06-05T10:10:00+10:00,2023-06-05,10:10,1,1,2
37,2023-06-05T10:10:00+10:00,2023-06-05,10:10,1,1,2
42,2023-06-05T10:10:00+10:00,2023-06-05,10:10,4,2,6
70,2023-06-05T10:10:00+10:00,2023-06-05,10:10,1,0,1
107,2023-06-05T10:10:00+10:00,2023-06-05,10:10,4,13,17
2,2023-06-05T10:10:00+10:00,2023-06-05,10:10,5,4,9
11,2023-06-05T10:10:00+10:00,2023-06-05,10:10,3,2,5
18,2023-06-05T10:10:00+10:00,2023-06-05,10:10,1,3,4
19,2023-06-05T10:10:00+10:00,2023-06-05,10:10,9,0,9
27,2023-06-05T10:10:00+10:00,2023-06-05,10:10,5,0,5
46,2023-06-05T10:10:00+10:00,2023-06-05,10:10,1,0,1
58,2023-06-05T10:10:00+10:00,2023-06-05,10:10,14,4,18
62,2023-06-05T10:10:00+10:00,2023-06-05,10:10,4,2,6
68,2023-06-05T10:10:00+10:00,2023-06-05,10:10,7,2,9
6,2023-06-05T10:10:00+10:00,2023-06-05,10:10,7,2,9
26,2023-06-05T10:10:00+10:00,2023-06-05,10:10,3,3,6
31,2023-06-05T10:10:00+10:00,2023-06-05,10:10,1,0,1
41,2023-06-05T10:10:00+10:00,2023-06-05,10:10,21,12,33
47,2023-06-05T10:10:00+10:00,2023-06-05,10:10,2,6,8
59,2023-06-05T10:10:00+10:00,2023-06-05,10:10,12,19,31
65,2023-06-05T10:10:00+10:00,2023-06-05,10:10,7,0,7
75,2023-06-05T10:10:00+10:00,2023-06-05,10:10,0,3,3
77,2023-06-05T10:10:00+10:00,2023-06-05,10:10,1,0,1
84,2023-06-05T10:10:00+10:00,2023-06-05,10:10,58,22,80
87,2023-06-05T10:10:00+10:00,2023-06-05,10:10,5,2,7
10,2023-06-05T10:10:00+10:00,2023-06-05,10:10,0,2,2
12,2023-06-05T10:10:00+10:00,2023-06-05,10:10,4,2,6
17,2023-06-05T10:10:00+10:00,2023-06-05,10:10,4,2,6
20,2023-06-05T10:10:00+10:00,2023-06-05,10:10,4,3,7
23,2023-06-05T10:10:00+10:00,2023-06-05,10:10,0,6,6
24,2023-06-05T10:10:00+10:00,2023-06-05,10:10,28,5,33
48,2023-06-05T10:10:00+10:00,2023-06-05,10:10,2,5,7
49,2023-06-05T10:10:00+10:00,2023-06-05,10:10,1,2,3
53,2023-06-05T10:10:00+10:00,2023-06-05,10:10,6,5,11
72,2023-06-05T10:10:00+10:00,2023-06-05,10:10,6,3,9
117,2023-06-05T10:10:00+10:00,2023-06-05,10:10,8,9,17
3,2023-06-05T10:09:00+10:00,2023-06-05,10:09,12,9,21
4,2023-06-05T10:09:00+10:00,2023-06-05,10:09,22,10,32
21,2023-06-05T10:09:00+10:00,2023-06-05,10:09,1,1,2
28,2023-06-05T10:09:00+10:00,2023-06-05,10:09,7,6,13
40,2023-06-05T10:09:00+10:00,2023-06-05,10:09,4,2,6
44,2023-06-05T10:09:00+10:00,2023-06-05,10:09,0,1,1
45,2023-06-05T10:09:00+10:00,2023-06-05,10:09,5,4,9
50,2023-06-05T10:09:00+10:00,2023-06-05,10:09,3,0,3
65,2023-06-05T10:09:00+10:00,2023-06-05,10:09,10,6,16
77,2023-06-05T10:09:00+10:00,2023-06-05,10:09,1,1,2
87,2023-06-05T10:09:00+10:00,2023-06-05,10:09,0,2,2
19,2023-06-05T10:09:00+10:00,2023-06-05,10:09,0,3,3
27,2023-06-05T10:09:00+10:00,2023-06-05,10:09,0,2,2
48,2023-06-05T10:09:00+10:00,2023-06-05,10:09,1,1,2
49,2023-06-05T10:09:00+10:00,2023-06-05,10:09,0,1,1
52,2023-06-05T10:09:00+10:00,2023-06-05,10:09,0,3,3
67,2023-06-05T10:09:00+10:00,2023-06-05,10:09,1,7,8
5,2023-06-05T10:09:00+10:00,2023-06-05,10:09,6,10,16
8,2023-06-05T10:09:00+10:00,2023-06-05,10:09,2,1,3
14,2023-06-05T10:09:00+10:00,2023-06-05,10:09,4,0,4
26,2023-06-05T10:09:00+10:00,2023-06-05,10:09,3,3,6
47,2023-06-05T10:09:00+10:00,2023-06-05,10:09,0,14,14
61,2023-06-05T10:09:00+10:00,2023-06-05,10:09,1,10,11
75,2023-06-05T10:09:00+10:00,2023-06-05,10:09,1,1,2
1,2023-06-05T10:09:00+10:00,2023-06-05,10:09,2,5,7
2,2023-06-05T10:09:00+10:00,2023-06-05,10:09,1,4,5
9,2023-06-05T10:09:00+10:00,2023-06-05,10:09,0,7,7
11,2023-06-05T10:09:00+10:00,2023-06-05,10:09,1,0,1
18,2023-06-05T10:09:00+10:00,2023-06-05,10:09,3,2,5
30,2023-06-05T10:09:00+10:00,2023-06-05,10:09,2,2,4
46,2023-06-05T10:09:00+10:00,2023-06-05,10:09,1,0,1
58,2023-06-05T10:09:00+10:00,2023-06-05,10:09,1,3,4
68,2023-06-05T10:09:00+10:00,2023-06-05,10:09,2,1,3
76,2023-06-05T10:09:00+10:00,2023-06-05,10:09,2,3,5
6,2023-06-05T10:09:00+10:00,2023-06-05,10:09,4,1,5
31,2023-06-05T10:09:00+10:00,2023-06-05,10:09,6,0,6
36,2023-06-05T10:09:00+10:00,2023-06-05,10:09,5,6,11
37,2023-06-05T10:09:00+10:00,2023-06-05,10:09,1,0,1
41,2023-06-05T10:09:00+10:00,2023-06-05,10:09,17,8,25
42,2023-06-05T10:09:00+10:00,2023-06-05,10:09,4,0,4
55,2023-06-05T10:09:00+10:00,2023-06-05,10:09,11,9,20
66,2023-06-05T10:09:00+10:00,2023-06-05,10:09,3,4,7
69,2023-06-05T10:09:00+10:00,2023-06-05,10:09,8,0,8
108,2023-06-05T10:09:00+10:00,2023-06-05,10:09,8,3,11
10,2023-06-05T10:09:00+10:00,2023-06-05,10:09,0,4,4
23,2023-06-05T10:09:00+10:00,2023-06-05,10:09,1,4,5
24,2023-06-05T10:09:00+10:00,2023-06-05,10:09,6,4,10
35,2023-06-05T10:09:00+10:00,2023-06-05,10:09,3,2,5
51,2023-06-05T10:09:00+10:00,2023-06-05,10:09,3,2,5
53,2023-06-05T10:09:00+10:00,2023-06-05,10:09,8,10,18
56,2023-06-05T10:09:00+10:00,2023-06-05,10:09,7,1,8
57,2023-06-05T10:09:00+10:00,2023-06-05,10:09,5,2,7
63,2023-06-05T10:09:00+10:00,2023-06-05,10:09,5,1,6
72,2023-06-05T10:09:00+10:00,2023-06-05,10:09,2,0,2
79,2023-06-05T10:09:00+10:00,2023-06-05,10:09,2,3,5
86,2023-06-05T10:09:00+10:00,2023-06-05,10:09,1,0,1
3,2023-06-05T10:08:00+10:00,2023-06-05,10:08,3,3,6
6,2023-06-05T10:08:00+10:00,2023-06-05,10:08,2,4,6
29,2023-06-05T10:08:00+10:00,2023-06-05,10:08,5,4,9
36,2023-06-05T10:08:00+10:00,2023-06-05,10:08,2,1,3
39,2023-06-05T10:08:00+10:00,2023-06-05,10:08,1,0,1
40,2023-06-05T10:08:00+10:00,2023-06-05,10:08,7,1,8
41,2023-06-05T10:08:00+10:00,2023-06-05,10:08,25,16,41
42,2023-06-05T10:08:00+10:00,2023-06-05,10:08,2,0,2
47,2023-06-05T10:08:00+10:00,2023-06-05,10:08,10,10,20
50,2023-06-05T10:08:00+10:00,2023-06-05,10:08,1,5,6
65,2023-06-05T10:08:00+10:00,2023-06-05,10:08,3,2,5
66,2023-06-05T10:08:00+10:00,2023-06-05,10:08,7,2,9
70,2023-06-05T10:08:00+10:00,2023-06-05,10:08,2,0,2
78,2023-06-05T10:08:00+10:00,2023-06-05,10:08,0,1,1
87,2023-06-05T10:08:00+10:00,2023-06-05,10:08,0,2,2
108,2023-06-05T10:08:00+10:00,2023-06-05,10:08,4,4,8
2,2023-06-05T10:08:00+10:00,2023-06-05,10:08,0,7,7
10,2023-06-05T10:08:00+10:00,2023-06-05,10:08,2,2,4
20,2023-06-05T10:08:00+10:00,2023-06-05,10:08,0,1,1
24,2023-06-05T10:08:00+10:00,2023-06-05,10:08,20,2,22
30,2023-06-05T10:08:00+10:00,2023-06-05,10:08,2,5,7
46,2023-06-05T10:08:00+10:00,2023-06-05,10:08,1,3,4
51,2023-06-05T10:08:00+10:00,2023-06-05,10:08,2,1,3
52,2023-06-05T10:08:00+10:00,2023-06-05,10:08,1,2,3
56,2023-06-05T10:08:00+10:00,2023-06-05,10:08,4,0,4
57,2023-06-05T10:08:00+10:00,2023-06-05,10:08,0,6,6
58,2023-06-05T10:08:00+10:00,2023-06-05,10:08,19,1,20
62,2023-06-05T10:08:00+10:00,2023-06-05,10:08,2,0,2
63,2023-06-05T10:08:00+10:00,2023-06-05,10:08,3,1,4
86,2023-06-05T10:08:00+10:00,2023-06-05,10:08,3,0,3
61,2023-06-05T10:08:00+10:00,2023-06-05,10:08,2,7,9
69,2023-06-05T10:08:00+10:00,2023-06-05,10:08,2,2,4
1,2023-06-05T10:08:00+10:00,2023-06-05,10:08,9,8,17
11,2023-06-05T10:08:00+10:00,2023-06-05,10:08,3,0,3
12,2023-06-05T10:08:00+10:00,2023-06-05,10:08,3,0,3
17,2023-06-05T10:08:00+10:00,2023-06-05,10:08,4,3,7
18,2023-06-05T10:08:00+10:00,2023-06-05,10:08,3,6,9
23,2023-06-05T10:08:00+10:00,2023-06-05,10:08,2,2,4
27,2023-06-05T10:08:00+10:00,2023-06-05,10:08,1,1,2
35,2023-06-05T10:08:00+10:00,2023-06-05,10:08,6,5,11
53,2023-06-05T10:08:00+10:00,2023-06-05,10:08,5,5,10
67,2023-06-05T10:08:00+10:00,2023-06-05,10:08,3,5,8
4,2023-06-05T10:08:00+10:00,2023-06-05,10:08,18,6,24
5,2023-06-05T10:08:00+10:00,2023-06-05,10:08,2,10,12
8,2023-06-05T10:08:00+10:00,2023-06-05,10:08,3,0,3
14,2023-06-05T10:08:00+10:00,2023-06-05,10:08,2,3,5
21,2023-06-05T10:08:00+10:00,2023-06-05,10:08,5,6,11
26,2023-06-05T10:08:00+10:00,2023-06-05,10:08,3,5,8
28,2023-06-05T10:08:00+10:00,2023-06-05,10:08,23,0,23
37,2023-06-05T10:08:00+10:00,2023-06-05,10:08,1,4,5
45,2023-06-05T10:08:00+10:00,2023-06-05,10:08,4,2,6
54,2023-06-05T10:08:00+10:00,2023-06-05,10:08,1,0,1
55,2023-06-05T10:08:00+10:00,2023-06-05,10:08,2,7,9
9,2023-06-05T10:08:00+10:00,2023-06-05,10:08,2,4,6
19,2023-06-05T10:08:00+10:00,2023-06-05,10:08,3,4,7
48,2023-06-05T10:08:00+10:00,2023-06-05,10:08,1,1,2
68,2023-06-05T10:08:00+10:00,2023-06-05,10:08,1,1,2
72,2023-06-05T10:08:00+10:00,2023-06-05,10:08,11,0,11
79,2023-06-05T10:08:00+10:00,2023-06-05,10:08,4,7,11
85,2023-06-05T10:08:00+10:00,2023-06-05,10:08,0,1,1
5,2023-06-05T10:07:00+10:00,2023-06-05,10:07,3,8,11
14,2023-06-05T10:07:00+10:00,2023-06-05,10:07,5,2,7
28,2023-06-05T10:07:00+10:00,2023-06-05,10:07,5,3,8
31,2023-06-05T10:07:00+10:00,2023-06-05,10:07,0,2,2
41,2023-06-05T10:07:00+10:00,2023-06-05,10:07,22,10,32
45,2023-06-05T10:07:00+10:00,2023-06-05,10:07,12,10,22
65,2023-06-05T10:07:00+10:00,2023-06-05,10:07,2,3,5
70,2023-06-05T10:07:00+10:00,2023-06-05,10:07,4,0,4
11,2023-06-05T10:07:00+10:00,2023-06-05,10:07,1,4,5
12,2023-06-05T10:07:00+10:00,2023-06-05,10:07,1,0,1
17,2023-06-05T10:07:00+10:00,2023-06-05,10:07,7,6,13
23,2023-06-05T10:07:00+10:00,2023-06-05,10:07,5,4,9
53,2023-06-05T10:07:00+10:00,2023-06-05,10:07,5,12,17
56,2023-06-05T10:07:00+10:00,2023-06-05,10:07,1,0,1
63,2023-06-05T10:07:00+10:00,2023-06-05,10:07,4,7,11
72,2023-06-05T10:07:00+10:00,2023-06-05,10:07,2,1,3
79,2023-06-05T10:07:00+10:00,2023-06-05,10:07,5,6,11
86,2023-06-05T10:07:00+10:00,2023-06-05,10:07,0,1,1
21,2023-06-05T10:07:00+10:00,2023-06-05,10:07,2,0,2
26,2023-06-05T10:07:00+10:00,2023-06-05,10:07,5,7,12
36,2023-06-05T10:07:00+10:00,2023-06-05,10:07,2,2,4
40,2023-06-05T10:07:00+10:00,2023-06-05,10:07,3,3,6
42,2023-06-05T10:07:00+10:00,2023-06-05,10:07,2,1,3
77,2023-06-05T10:07:00+10:00,2023-06-05,10:07,1,2,3
78,2023-06-05T10:07:00+10:00,2023-06-05,10:07,0,1,1
87,2023-06-05T10:07:00+10:00,2023-06-05,10:07,1,1,2
108,2023-06-05T10:07:00+10:00,2023-06-05,10:07,2,4,6
9,2023-06-05T10:07:00+10:00,2023-06-05,10:07,1,8,9
18,2023-06-05T10:07:00+10:00,2023-06-05,10:07,3,7,10
35,2023-06-05T10:07:00+10:00,2023-06-05,10:07,13,4,17
46,2023-06-05T10:07:00+10:00,2023-06-05,10:07,0,5,5
49,2023-06-05T10:07:00+10:00,2023-06-05,10:07,0,2,2
51,2023-06-05T10:07:00+10:00,2023-06-05,10:07,4,0,4
62,2023-06-05T10:07:00+10:00,2023-06-05,10:07,1,1,2
3,2023-06-05T10:07:00+10:00,2023-06-05,10:07,3,7,10
4,2023-06-05T10:07:00+10:00,2023-06-05,10:07,8,5,13
6,2023-06-05T10:07:00+10:00,2023-06-05,10:07,4,1,5
8,2023-06-05T10:07:00+10:00,2023-06-05,10:07,2,2,4
29,2023-06-05T10:07:00+10:00,2023-06-05,10:07,2,0,2
37,2023-06-05T10:07:00+10:00,2023-06-05,10:07,1,0,1
39,2023-06-05T10:07:00+10:00,2023-06-05,10:07,3,3,6
44,2023-06-05T10:07:00+10:00,2023-06-05,10:07,0,1,1
47,2023-06-05T10:07:00+10:00,2023-06-05,10:07,6,9,15
50,2023-06-05T10:07:00+10:00,2023-06-05,10:07,1,4,5
55,2023-06-05T10:07:00+10:00,2023-06-05,10:07,10,4,14
61,2023-06-05T10:07:00+10:00,2023-06-05,10:07,4,12,16
66,2023-06-05T10:07:00+10:00,2023-06-05,10:07,1,3,4
69,2023-06-05T10:07:00+10:00,2023-06-05,10:07,2,3,5
75,2023-06-05T10:07:00+10:00,2023-06-05,10:07,1,0,1
1,2023-06-05T10:07:00+10:00,2023-06-05,10:07,8,7,15
2,2023-06-05T10:07:00+10:00,2023-06-05,10:07,4,6,10
19,2023-06-05T10:07:00+10:00,2023-06-05,10:07,0,2,2
20,2023-06-05T10:07:00+10:00,2023-06-05,10:07,2,0,2
24,2023-06-05T10:07:00+10:00,2023-06-05,10:07,23,5,28
30,2023-06-05T10:07:00+10:00,2023-06-05,10:07,1,3,4
48,2023-06-05T10:07:00+10:00,2023-06-05,10:07,2,6,8
52,2023-06-05T10:07:00+10:00,2023-06-05,10:07,0,3,3
57,2023-06-05T10:07:00+10:00,2023-06-05,10:07,1,6,7
58,2023-06-05T10:07:00+10:00,2023-06-05,10:07,21,1,22
67,2023-06-05T10:07:00+10:00,2023-06-05,10:07,5,2,7
68,2023-06-05T10:07:00+10:00,2023-06-05,10:07,3,0,3
76,2023-06-05T10:07:00+10:00,2023-06-05,10:07,1,1,2
85,2023-06-05T10:07:00+10:00,2023-06-05,10:07,0,1,1
4,2023-06-05T10:06:00+10:00,2023-06-05,10:06,13,7,20
21,2023-06-05T10:06:00+10:00,2023-06-05,10:06,2,7,9
31,2023-06-05T10:06:00+10:00,2023-06-05,10:06,1,0,1
44,2023-06-05T10:06:00+10:00,2023-06-05,10:06,0,2,2
47,2023-06-05T10:06:00+10:00,2023-06-05,10:06,2,13,15
65,2023-06-05T10:06:00+10:00,2023-06-05,10:06,1,8,9
108,2023-06-05T10:06:00+10:00,2023-06-05,10:06,1,2,3
2,2023-06-05T10:06:00+10:00,2023-06-05,10:06,0,9,9
9,2023-06-05T10:06:00+10:00,2023-06-05,10:06,1,7,8
24,2023-06-05T10:06:00+10:00,2023-06-05,10:06,14,13,27
35,2023-06-05T10:06:00+10:00,2023-06-05,10:06,13,3,16
48,2023-06-05T10:06:00+10:00,2023-06-05,10:06,2,2,4
49,2023-06-05T10:06:00+10:00,2023-06-05,10:06,2,0,2
51,2023-06-05T10:06:00+10:00,2023-06-05,10:06,1,0,1
53,2023-06-05T10:06:00+10:00,2023-06-05,10:06,9,11,20
56,2023-06-05T10:06:00+10:00,2023-06-05,10:06,1,0,1
79,2023-06-05T10:06:00+10:00,2023-06-05,10:06,0,16,16
85,2023-06-05T10:06:00+10:00,2023-06-05,10:06,1,0,1
5,2023-06-05T10:06:00+10:00,2023-06-05,10:06,6,11,17
8,2023-06-05T10:06:00+10:00,2023-06-05,10:06,0,4,4
14,2023-06-05T10:06:00+10:00,2023-06-05,10:06,3,1,4
26,2023-06-05T10:06:00+10:00,2023-06-05,10:06,3,2,5
28,2023-06-05T10:06:00+10:00,2023-06-05,10:06,6,0,6
36,2023-06-05T10:06:00+10:00,2023-06-05,10:06,2,4,6
37,2023-06-05T10:06:00+10:00,2023-06-05,10:06,1,1,2
40,2023-06-05T10:06:00+10:00,2023-06-05,10:06,5,2,7
41,2023-06-05T10:06:00+10:00,2023-06-05,10:06,20,6,26
61,2023-06-05T10:06:00+10:00,2023-06-05,10:06,6,4,10
66,2023-06-05T10:06:00+10:00,2023-06-05,10:06,4,6,10
75,2023-06-05T10:06:00+10:00,2023-06-05,10:06,0,3,3
77,2023-06-05T10:06:00+10:00,2023-06-05,10:06,0,2,2
87,2023-06-05T10:06:00+10:00,2023-06-05,10:06,1,0,1
10,2023-06-05T10:06:00+10:00,2023-06-05,10:06,1,0,1
17,2023-06-05T10:06:00+10:00,2023-06-05,10:06,3,3,6
18,2023-06-05T10:06:00+10:00,2023-06-05,10:06,0,4,4
19,2023-06-05T10:06:00+10:00,2023-06-05,10:06,0,3,3
27,2023-06-05T10:06:00+10:00,2023-06-05,10:06,0,1,1
62,2023-06-05T10:06:00+10:00,2023-06-05,10:06,1,4,5
63,2023-06-05T10:06:00+10:00,2023-06-05,10:06,3,0,3
86,2023-06-05T10:06:00+10:00,2023-06-05,10:06,3,0,3
3,2023-06-05T10:06:00+10:00,2023-06-05,10:06,4,4,8
6,2023-06-05T10:06:00+10:00,2023-06-05,10:06,9,3,12
29,2023-06-05T10:06:00+10:00,2023-06-05,10:06,2,1,3
39,2023-06-05T10:06:00+10:00,2023-06-05,10:06,0,2,2
42,2023-06-05T10:06:00+10:00,2023-06-05,10:06,2,1,3
45,2023-06-05T10:06:00+10:00,2023-06-05,10:06,2,1,3
50,2023-06-05T10:06:00+10:00,2023-06-05,10:06,2,0,2
55,2023-06-05T10:06:00+10:00,2023-06-05,10:06,4,7,11
70,2023-06-05T10:06:00+10:00,2023-06-05,10:06,2,1,3
78,2023-06-05T10:06:00+10:00,2023-06-05,10:06,1,0,1
1,2023-06-05T10:06:00+10:00,2023-06-05,10:06,6,11,17
12,2023-06-05T10:06:00+10:00,2023-06-05,10:06,0,1,1
23,2023-06-05T10:06:00+10:00,2023-06-05,10:06,6,0,6
52,2023-06-05T10:06:00+10:00,2023-06-05,10:06,2,2,4
57,2023-06-05T10:06:00+10:00,2023-06-05,10:06,2,5,7
58,2023-06-05T10:06:00+10:00,2023-06-05,10:06,21,0,21
67,2023-06-05T10:06:00+10:00,2023-06-05,10:06,0,6,6
68,2023-06-05T10:06:00+10:00,2023-06-05,10:06,2,4,6
72,2023-06-05T10:06:00+10:00,2023-06-05,10:06,3,0,3
3,2023-06-05T10:05:00+10:00,2023-06-05,10:05,1,10,11
6,2023-06-05T10:05:00+10:00,2023-06-05,10:05,3,8,11
28,2023-06-05T10:05:00+10:00,2023-06-05,10:05,9,2,11
36,2023-06-05T10:05:00+10:00,2023-06-05,10:05,2,4,6
39,2023-06-05T10:05:00+10:00,2023-06-05,10:05,2,3,5
42,2023-06-05T10:05:00+10:00,2023-06-05,10:05,2,1,3
45,2023-06-05T10:05:00+10:00,2023-06-05,10:05,3,6,9
65,2023-06-05T10:05:00+10:00,2023-06-05,10:05,17,1,18
77,2023-06-05T10:05:00+10:00,2023-06-05,10:05,1,0,1
84,2023-06-05T10:05:00+10:00,2023-06-05,10:05,55,19,74
87,2023-06-05T10:05:00+10:00,2023-06-05,10:05,1,0,1
107,2023-06-05T10:05:00+10:00,2023-06-05,10:05,1,15,16
1,2023-06-05T10:05:00+10:00,2023-06-05,10:05,9,6,15
10,2023-06-05T10:05:00+10:00,2023-06-05,10:05,0,2,2
17,2023-06-05T10:05:00+10:00,2023-06-05,10:05,6,4,10
23,2023-06-05T10:05:00+10:00,2023-06-05,10:05,4,2,6
24,2023-06-05T10:05:00+10:00,2023-06-05,10:05,9,2,11
27,2023-06-05T10:05:00+10:00,2023-06-05,10:05,2,0,2
46,2023-06-05T10:05:00+10:00,2023-06-05,10:05,0,2,2
52,2023-06-05T10:05:00+10:00,2023-06-05,10:05,2,1,3
58,2023-06-05T10:05:00+10:00,2023-06-05,10:05,9,3,12
68,2023-06-05T10:05:00+10:00,2023-06-05,10:05,2,1,3
109,2023-06-05T10:05:00+10:00,2023-06-05,10:05,3,12,15
5,2023-06-05T10:05:00+10:00,2023-06-05,10:05,5,11,16
8,2023-06-05T10:05:00+10:00,2023-06-05,10:05,1,3,4
14,2023-06-05T10:05:00+10:00,2023-06-05,10:05,1,2,3
21,2023-06-05T10:05:00+10:00,2023-06-05,10:05,6,3,9
26,2023-06-05T10:05:00+10:00,2023-06-05,10:05,6,5,11
31,2023-06-05T10:05:00+10:00,2023-06-05,10:05,1,1,2
37,2023-06-05T10:05:00+10:00,2023-06-05,10:05,1,2,3
40,2023-06-05T10:05:00+10:00,2023-06-05,10:05,3,2,5
47,2023-06-05T10:05:00+10:00,2023-06-05,10:05,5,2,7
55,2023-06-05T10:05:00+10:00,2023-06-05,10:05,2,5,7
66,2023-06-05T10:05:00+10:00,2023-06-05,10:05,7,6,13
69,2023-06-05T10:05:00+10:00,2023-06-05,10:05,6,0,6
70,2023-06-05T10:05:00+10:00,2023-06-05,10:05,0,1,1
108,2023-06-05T10:05:00+10:00,2023-06-05,10:05,1,7,8
9,2023-06-05T10:05:00+10:00,2023-06-05,10:05,1,8,9
19,2023-06-05T10:05:00+10:00,2023-06-05,10:05,6,0,6
30,2023-06-05T10:05:00+10:00,2023-06-05,10:05,3,0,3
51,2023-06-05T10:05:00+10:00,2023-06-05,10:05,1,5,6
53,2023-06-05T10:05:00+10:00,2023-06-05,10:05,5,14,19
57,2023-06-05T10:05:00+10:00,2023-06-05,10:05,5,6,11
62,2023-06-05T10:05:00+10:00,2023-06-05,10:05,4,2,6
76,2023-06-05T10:05:00+10:00,2023-06-05,10:05,1,0,1
79,2023-06-05T10:05:00+10:00,2023-06-05,10:05,5,10,15
85,2023-06-05T10:05:00+10:00,2023-06-05,10:05,2,2,4
86,2023-06-05T10:05:00+10:00,2023-06-05,10:05,2,0,2
4,2023-06-05T10:05:00+10:00,2023-06-05,10:05,16,10,26
29,2023-06-05T10:05:00+10:00,2023-06-05,10:05,3,0,3
41,2023-06-05T10:05:00+10:00,2023-06-05,10:05,20,5,25
50,2023-06-05T10:05:00+10:00,2023-06-05,10:05,2,4,6
59,2023-06-05T10:05:00+10:00,2023-06-05,10:05,30,17,47
61,2023-06-05T10:05:00+10:00,2023-06-05,10:05,2,2,4
2,2023-06-05T10:05:00+10:00,2023-06-05,10:05,0,12,12
11,2023-06-05T10:05:00+10:00,2023-06-05,10:05,2,2,4
18,2023-06-05T10:05:00+10:00,2023-06-05,10:05,3,6,9
20,2023-06-05T10:05:00+10:00,2023-06-05,10:05,0,1,1
35,2023-06-05T10:05:00+10:00,2023-06-05,10:05,7,4,11
56,2023-06-05T10:05:00+10:00,2023-06-05,10:05,4,1,5
63,2023-06-05T10:05:00+10:00,2023-06-05,10:05,2,4,6
67,2023-06-05T10:05:00+10:00,2023-06-05,10:05,7,5,12
72,2023-06-05T10:05:00+10:00,2023-06-05,10:05,3,0,3
117,2023-06-05T10:05:00+10:00,2023-06-05,10:05,4,7,11
4,2023-06-05T10:04:00+10:00,2023-06-05,10:04,12,8,20
6,2023-06-05T10:04:00+10:00,2023-06-05,10:04,9,0,9
21,2023-06-05T10:04:00+10:00,2023-06-05,10:04,3,3,6
29,2023-06-05T10:04:00+10:00,2023-06-05,10:04,0,1,1
36,2023-06-05T10:04:00+10:00,2023-06-05,10:04,0,4,4
37,2023-06-05T10:04:00+10:00,2023-06-05,10:04,2,1,3
39,2023-06-05T10:04:00+10:00,2023-06-05,10:04,1,0,1
40,2023-06-05T10:04:00+10:00,2023-06-05,10:04,2,3,5
41,2023-06-05T10:04:00+10:00,2023-06-05,10:04,27,19,46
42,2023-06-05T10:04:00+10:00,2023-06-05,10:04,0,2,2
47,2023-06-05T10:04:00+10:00,2023-06-05,10:04,4,6,10
54,2023-06-05T10:04:00+10:00,2023-06-05,10:04,3,2,5
55,2023-06-05T10:04:00+10:00,2023-06-05,10:04,4,6,10
66,2023-06-05T10:04:00+10:00,2023-06-05,10:04,7,4,11
77,2023-06-05T10:04:00+10:00,2023-06-05,10:04,2,2,4
108,2023-06-05T10:04:00+10:00,2023-06-05,10:04,1,11,12
1,2023-06-05T10:04:00+10:00,2023-06-05,10:04,3,14,17
12,2023-06-05T10:04:00+10:00,2023-06-05,10:04,1,2,3
17,2023-06-05T10:04:00+10:00,2023-06-05,10:04,7,3,10
18,2023-06-05T10:04:00+10:00,2023-06-05,10:04,4,3,7
35,2023-06-05T10:04:00+10:00,2023-06-05,10:04,5,6,11
48,2023-06-05T10:04:00+10:00,2023-06-05,10:04,3,1,4
52,2023-06-05T10:04:00+10:00,2023-06-05,10:04,5,3,8
56,2023-06-05T10:04:00+10:00,2023-06-05,10:04,2,2,4
62,2023-06-05T10:04:00+10:00,2023-06-05,10:04,7,1,8
68,2023-06-05T10:04:00+10:00,2023-06-05,10:04,2,1,3
72,2023-06-05T10:04:00+10:00,2023-06-05,10:04,3,3,6
76,2023-06-05T10:04:00+10:00,2023-06-05,10:04,0,1,1
85,2023-06-05T10:04:00+10:00,2023-06-05,10:04,1,1,2
8,2023-06-05T10:04:00+10:00,2023-06-05,10:04,2,3,5
31,2023-06-05T10:04:00+10:00,2023-06-05,10:04,1,0,1
61,2023-06-05T10:04:00+10:00,2023-06-05,10:04,4,4,8
69,2023-06-05T10:04:00+10:00,2023-06-05,10:04,12,4,16
70,2023-06-05T10:04:00+10:00,2023-06-05,10:04,2,2,4
75,2023-06-05T10:04:00+10:00,2023-06-05,10:04,1,0,1
2,2023-06-05T10:04:00+10:00,2023-06-05,10:04,2,7,9
10,2023-06-05T10:04:00+10:00,2023-06-05,10:04,2,1,3
19,2023-06-05T10:04:00+10:00,2023-06-05,10:04,3,2,5
23,2023-06-05T10:04:00+10:00,2023-06-05,10:04,4,0,4
30,2023-06-05T10:04:00+10:00,2023-06-05,10:04,2,0,2
58,2023-06-05T10:04:00+10:00,2023-06-05,10:04,7,3,10
63,2023-06-05T10:04:00+10:00,2023-06-05,10:04,3,7,10
67,2023-06-05T10:04:00+10:00,2023-06-05,10:04,3,6,9
3,2023-06-05T10:04:00+10:00,2023-06-05,10:04,4,4,8
5,2023-06-05T10:04:00+10:00,2023-06-05,10:04,3,8,11
14,2023-06-05T10:04:00+10:00,2023-06-05,10:04,1,1,2
26,2023-06-05T10:04:00+10:00,2023-06-05,10:04,1,1,2
28,2023-06-05T10:04:00+10:00,2023-06-05,10:04,9,3,12
44,2023-06-05T10:04:00+10:00,2023-06-05,10:04,0,1,1
45,2023-06-05T10:04:00+10:00,2023-06-05,10:04,3,0,3
50,2023-06-05T10:04:00+10:00,2023-06-05,10:04,2,0,2
65,2023-06-05T10:04:00+10:00,2023-06-05,10:04,10,5,15
87,2023-06-05T10:04:00+10:00,2023-06-05,10:04,0,4,4
9,2023-06-05T10:04:00+10:00,2023-06-05,10:04,7,7,14
24,2023-06-05T10:04:00+10:00,2023-06-05,10:04,8,3,11
46,2023-06-05T10:04:00+10:00,2023-06-05,10:04,3,2,5
53,2023-06-05T10:04:00+10:00,2023-06-05,10:04,5,6,11
57,2023-06-05T10:04:00+10:00,2023-06-05,10:04,1,0,1
79,2023-06-05T10:04:00+10:00,2023-06-05,10:04,0,3,3
86,2023-06-05T10:04:00+10:00,2023-06-05,10:04,5,0,5
3,2023-06-05T10:03:00+10:00,2023-06-05,10:03,4,5,9
4,2023-06-05T10:03:00+10:00,2023-06-05,10:03,11,15,26
6,2023-06-05T10:03:00+10:00,2023-06-05,10:03,1,2,3
31,2023-06-05T10:03:00+10:00,2023-06-05,10:03,0,1,1
45,2023-06-05T10:03:00+10:00,2023-06-05,10:03,6,5,11
61,2023-06-05T10:03:00+10:00,2023-06-05,10:03,3,3,6
70,2023-06-05T10:03:00+10:00,2023-06-05,10:03,0,2,2
77,2023-06-05T10:03:00+10:00,2023-06-05,10:03,1,2,3
17,2023-06-05T10:03:00+10:00,2023-06-05,10:03,4,7,11
18,2023-06-05T10:03:00+10:00,2023-06-05,10:03,4,1,5
20,2023-06-05T10:03:00+10:00,2023-06-05,10:03,0,1,1
30,2023-06-05T10:03:00+10:00,2023-06-05,10:03,0,3,3
53,2023-06-05T10:03:00+10:00,2023-06-05,10:03,4,6,10
57,2023-06-05T10:03:00+10:00,2023-06-05,10:03,1,4,5
62,2023-06-05T10:03:00+10:00,2023-06-05,10:03,0,1,1
67,2023-06-05T10:03:00+10:00,2023-06-05,10:03,3,5,8
68,2023-06-05T10:03:00+10:00,2023-06-05,10:03,1,4,5
79,2023-06-05T10:03:00+10:00,2023-06-05,10:03,6,3,9
85,2023-06-05T10:03:00+10:00,2023-06-05,10:03,2,1,3
86,2023-06-05T10:03:00+10:00,2023-06-05,10:03,0,1,1
8,2023-06-05T10:03:00+10:00,2023-06-05,10:03,2,0,2
26,2023-06-05T10:03:00+10:00,2023-06-05,10:03,8,4,12
28,2023-06-05T10:03:00+10:00,2023-06-05,10:03,4,4,8
29,2023-06-05T10:03:00+10:00,2023-06-05,10:03,1,2,3
40,2023-06-05T10:03:00+10:00,2023-06-05,10:03,3,0,3
44,2023-06-05T10:03:00+10:00,2023-06-05,10:03,0,1,1
47,2023-06-05T10:03:00+10:00,2023-06-05,10:03,5,5,10
54,2023-06-05T10:03:00+10:00,2023-06-05,10:03,0,4,4
65,2023-06-05T10:03:00+10:00,2023-06-05,10:03,7,3,10
66,2023-06-05T10:03:00+10:00,2023-06-05,10:03,2,7,9
108,2023-06-05T10:03:00+10:00,2023-06-05,10:03,4,7,11
1,2023-06-05T10:03:00+10:00,2023-06-05,10:03,3,7,10
12,2023-06-05T10:03:00+10:00,2023-06-05,10:03,1,1,2
19,2023-06-05T10:03:00+10:00,2023-06-05,10:03,0,3,3
24,2023-06-05T10:03:00+10:00,2023-06-05,10:03,14,1,15
46,2023-06-05T10:03:00+10:00,2023-06-05,10:03,1,0,1
51,2023-06-05T10:03:00+10:00,2023-06-05,10:03,0,2,2
58,2023-06-05T10:03:00+10:00,2023-06-05,10:03,11,3,14
72,2023-06-05T10:03:00+10:00,2023-06-05,10:03,3,3,6
5,2023-06-05T10:03:00+10:00,2023-06-05,10:03,1,3,4
14,2023-06-05T10:03:00+10:00,2023-06-05,10:03,4,0,4
21,2023-06-05T10:03:00+10:00,2023-06-05,10:03,4,1,5
36,2023-06-05T10:03:00+10:00,2023-06-05,10:03,5,0,5
37,2023-06-05T10:03:00+10:00,2023-06-05,10:03,4,0,4
39,2023-06-05T10:03:00+10:00,2023-06-05,10:03,2,5,7
41,2023-06-05T10:03:00+10:00,2023-06-05,10:03,8,3,11
55,2023-06-05T10:03:00+10:00,2023-06-05,10:03,10,5,15
69,2023-06-05T10:03:00+10:00,2023-06-05,10:03,0,1,1
75,2023-06-05T10:03:00+10:00,2023-06-05,10:03,1,0,1
87,2023-06-05T10:03:00+10:00,2023-06-05,10:03,1,0,1
2,2023-06-05T10:03:00+10:00,2023-06-05,10:03,6,6,12
9,2023-06-05T10:03:00+10:00,2023-06-05,10:03,1,2,3
23,2023-06-05T10:03:00+10:00,2023-06-05,10:03,4,1,5
35,2023-06-05T10:03:00+10:00,2023-06-05,10:03,2,6,8
49,2023-06-05T10:03:00+10:00,2023-06-05,10:03,0,2,2
52,2023-06-05T10:03:00+10:00,2023-06-05,10:03,2,1,3
56,2023-06-05T10:03:00+10:00,2023-06-05,10:03,0,1,1
63,2023-06-05T10:03:00+10:00,2023-06-05,10:03,2,3,5
76,2023-06-05T10:03:00+10:00,2023-06-05,10:03,1,0,1
3,2023-06-05T10:02:00+10:00,2023-06-05,10:02,6,3,9
4,2023-06-05T10:02:00+10:00,2023-06-05,10:02,19,13,32
6,2023-06-05T10:02:00+10:00,2023-06-05,10:02,8,2,10
8,2023-06-05T10:02:00+10:00,2023-06-05,10:02,1,4,5
14,2023-06-05T10:02:00+10:00,2023-06-05,10:02,3,3,6
26,2023-06-05T10:02:00+10:00,2023-06-05,10:02,2,2,4
28,2023-06-05T10:02:00+10:00,2023-06-05,10:02,11,3,14
45,2023-06-05T10:02:00+10:00,2023-06-05,10:02,5,3,8
66,2023-06-05T10:02:00+10:00,2023-06-05,10:02,1,4,5
69,2023-06-05T10:02:00+10:00,2023-06-05,10:02,1,1,2
70,2023-06-05T10:02:00+10:00,2023-06-05,10:02,2,0,2
77,2023-06-05T10:02:00+10:00,2023-06-05,10:02,0,2,2
1,2023-06-05T10:02:00+10:00,2023-06-05,10:02,2,6,8
9,2023-06-05T10:02:00+10:00,2023-06-05,10:02,4,6,10
11,2023-06-05T10:02:00+10:00,2023-06-05,10:02,0,2,2
17,2023-06-05T10:02:00+10:00,2023-06-05,10:02,7,5,12
19,2023-06-05T10:02:00+10:00,2023-06-05,10:02,1,7,8
30,2023-06-05T10:02:00+10:00,2023-06-05,10:02,1,6,7
53,2023-06-05T10:02:00+10:00,2023-06-05,10:02,8,9,17
56,2023-06-05T10:02:00+10:00,2023-06-05,10:02,4,0,4
57,2023-06-05T10:02:00+10:00,2023-06-05,10:02,3,6,9
63,2023-06-05T10:02:00+10:00,2023-06-05,10:02,1,1,2
72,2023-06-05T10:02:00+10:00,2023-06-05,10:02,2,1,3
79,2023-06-05T10:02:00+10:00,2023-06-05,10:02,2,8,10
85,2023-06-05T10:02:00+10:00,2023-06-05,10:02,1,1,2
86,2023-06-05T10:02:00+10:00,2023-06-05,10:02,0,2,2
5,2023-06-05T10:02:00+10:00,2023-06-05,10:02,5,11,16
21,2023-06-05T10:02:00+10:00,2023-06-05,10:02,1,2,3
29,2023-06-05T10:02:00+10:00,2023-06-05,10:02,1,2,3
36,2023-06-05T10:02:00+10:00,2023-06-05,10:02,3,0,3
40,2023-06-05T10:02:00+10:00,2023-06-05,10:02,5,1,6
41,2023-06-05T10:02:00+10:00,2023-06-05,10:02,13,11,24
61,2023-06-05T10:02:00+10:00,2023-06-05,10:02,1,1,2
65,2023-06-05T10:02:00+10:00,2023-06-05,10:02,7,9,16
87,2023-06-05T10:02:00+10:00,2023-06-05,10:02,2,1,3
108,2023-06-05T10:02:00+10:00,2023-06-05,10:02,7,8,15
24,2023-06-05T10:02:00+10:00,2023-06-05,10:02,15,1,16
27,2023-06-05T10:02:00+10:00,2023-06-05,10:02,1,0,1
46,2023-06-05T10:02:00+10:00,2023-06-05,10:02,2,1,3
51,2023-06-05T10:02:00+10:00,2023-06-05,10:02,0,2,2
58,2023-06-05T10:02:00+10:00,2023-06-05,10:02,8,3,11
37,2023-06-05T10:02:00+10:00,2023-06-05,10:02,1,2,3
39,2023-06-05T10:02:00+10:00,2023-06-05,10:02,1,2,3
42,2023-06-05T10:02:00+10:00,2023-06-05,10:02,0,2,2
47,2023-06-05T10:02:00+10:00,2023-06-05,10:02,10,2,12
50,2023-06-05T10:02:00+10:00,2023-06-05,10:02,0,1,1
55,2023-06-05T10:02:00+10:00,2023-06-05,10:02,1,7,8
75,2023-06-05T10:02:00+10:00,2023-06-05,10:02,1,0,1
78,2023-06-05T10:02:00+10:00,2023-06-05,10:02,1,0,1
2,2023-06-05T10:02:00+10:00,2023-06-05,10:02,4,4,8
10,2023-06-05T10:02:00+10:00,2023-06-05,10:02,3,0,3
12,2023-06-05T10:02:00+10:00,2023-06-05,10:02,1,2,3
18,2023-06-05T10:02:00+10:00,2023-06-05,10:02,3,3,6
20,2023-06-05T10:02:00+10:00,2023-06-05,10:02,1,2,3
23,2023-06-05T10:02:00+10:00,2023-06-05,10:02,5,2,7
35,2023-06-05T10:02:00+10:00,2023-06-05,10:02,12,4,16
48,2023-06-05T10:02:00+10:00,2023-06-05,10:02,3,1,4
49,2023-06-05T10:02:00+10:00,2023-06-05,10:02,1,0,1
52,2023-06-05T10:02:00+10:00,2023-06-05,10:02,0,2,2
62,2023-06-05T10:02:00+10:00,2023-06-05,10:02,3,3,6
67,2023-06-05T10:02:00+10:00,2023-06-05,10:02,8,9,17
68,2023-06-05T10:02:00+10:00,2023-06-05,10:02,4,2,6
76,2023-06-05T10:02:00+10:00,2023-06-05,10:02,2,0,2
4,2023-06-05T10:01:00+10:00,2023-06-05,10:01,12,3,15
5,2023-06-05T10:01:00+10:00,2023-06-05,10:01,4,8,12
6,2023-06-05T10:01:00+10:00,2023-06-05,10:01,6,2,8
8,2023-06-05T10:01:00+10:00,2023-06-05,10:01,2,1,3
28,2023-06-05T10:01:00+10:00,2023-06-05,10:01,16,2,18
40,2023-06-05T10:01:00+10:00,2023-06-05,10:01,7,2,9
47,2023-06-05T10:01:00+10:00,2023-06-05,10:01,1,9,10
66,2023-06-05T10:01:00+10:00,2023-06-05,10:01,7,5,12
77,2023-06-05T10:01:00+10:00,2023-06-05,10:01,1,0,1
87,2023-06-05T10:01:00+10:00,2023-06-05,10:01,0,1,1
1,2023-06-05T10:01:00+10:00,2023-06-05,10:01,7,9,16
2,2023-06-05T10:01:00+10:00,2023-06-05,10:01,2,7,9
12,2023-06-05T10:01:00+10:00,2023-06-05,10:01,4,1,5
17,2023-06-05T10:01:00+10:00,2023-06-05,10:01,20,3,23
23,2023-06-05T10:01:00+10:00,2023-06-05,10:01,1,2,3
27,2023-06-05T10:01:00+10:00,2023-06-05,10:01,2,2,4
35,2023-06-05T10:01:00+10:00,2023-06-05,10:01,8,11,19
46,2023-06-05T10:01:00+10:00,2023-06-05,10:01,2,4,6
48,2023-06-05T10:01:00+10:00,2023-06-05,10:01,3,1,4
51,2023-06-05T10:01:00+10:00,2023-06-05,10:01,0,1,1
57,2023-06-05T10:01:00+10:00,2023-06-05,10:01,2,1,3
58,2023-06-05T10:01:00+10:00,2023-06-05,10:01,10,4,14
68,2023-06-05T10:01:00+10:00,2023-06-05,10:01,5,2,7
72,2023-06-05T10:01:00+10:00,2023-06-05,10:01,3,0,3
86,2023-06-05T10:01:00+10:00,2023-06-05,10:01,0,1,1
14,2023-06-05T10:01:00+10:00,2023-06-05,10:01,13,25,38
21,2023-06-05T10:01:00+10:00,2023-06-05,10:01,6,2,8
26,2023-06-05T10:01:00+10:00,2023-06-05,10:01,1,7,8
36,2023-06-05T10:01:00+10:00,2023-06-05,10:01,4,2,6
41,2023-06-05T10:01:00+10:00,2023-06-05,10:01,19,14,33
54,2023-06-05T10:01:00+10:00,2023-06-05,10:01,3,0,3
61,2023-06-05T10:01:00+10:00,2023-06-05,10:01,2,3,5
75,2023-06-05T10:01:00+10:00,2023-06-05,10:01,1,0,1
9,2023-06-05T10:01:00+10:00,2023-06-05,10:01,0,16,16
10,2023-06-05T10:01:00+10:00,2023-06-05,10:01,3,2,5
19,2023-06-05T10:01:00+10:00,2023-06-05,10:01,0,1,1
20,2023-06-05T10:01:00+10:00,2023-06-05,10:01,1,1,2
24,2023-06-05T10:01:00+10:00,2023-06-05,10:01,9,11,20
53,2023-06-05T10:01:00+10:00,2023-06-05,10:01,4,3,7
56,2023-06-05T10:01:00+10:00,2023-06-05,10:01,6,5,11
85,2023-06-05T10:01:00+10:00,2023-06-05,10:01,1,0,1
3,2023-06-05T10:01:00+10:00,2023-06-05,10:01,1,7,8
29,2023-06-05T10:01:00+10:00,2023-06-05,10:01,0,1,1
31,2023-06-05T10:01:00+10:00,2023-06-05,10:01,1,0,1
42,2023-06-05T10:01:00+10:00,2023-06-05,10:01,5,0,5
45,2023-06-05T10:01:00+10:00,2023-06-05,10:01,2,7,9
50,2023-06-05T10:01:00+10:00,2023-06-05,10:01,2,3,5
55,2023-06-05T10:01:00+10:00,2023-06-05,10:01,1,8,9
65,2023-06-05T10:01:00+10:00,2023-06-05,10:01,9,1,10
69,2023-06-05T10:01:00+10:00,2023-06-05,10:01,2,1,3
70,2023-06-05T10:01:00+10:00,2023-06-05,10:01,1,3,4
108,2023-06-05T10:01:00+10:00,2023-06-05,10:01,2,7,9
18,2023-06-05T10:01:00+10:00,2023-06-05,10:01,7,6,13
30,2023-06-05T10:01:00+10:00,2023-06-05,10:01,4,6,10
52,2023-06-05T10:01:00+10:00,2023-06-05,10:01,3,3,6
62,2023-06-05T10:01:00+10:00,2023-06-05,10:01,0,3,3
63,2023-06-05T10:01:00+10:00,2023-06-05,10:01,3,5,8
67,2023-06-05T10:01:00+10:00,2023-06-05,10:01,1,9,10
76,2023-06-05T10:01:00+10:00,2023-06-05,10:01,1,0,1
79,2023-06-05T10:01:00+10:00,2023-06-05,10:01,9,4,13
3,2023-06-05T10:00:00+10:00,2023-06-05,10:00,3,20,23
4,2023-06-05T10:00:00+10:00,2023-06-05,10:00,12,7,19
14,2023-06-05T10:00:00+10:00,2023-06-05,10:00,8,20,28
31,2023-06-05T10:00:00+10:00,2023-06-05,10:00,0,1,1
36,2023-06-05T10:00:00+10:00,2023-06-05,10:00,4,3,7
39,2023-06-05T10:00:00+10:00,2023-06-05,10:00,1,8,9
42,2023-06-05T10:00:00+10:00,2023-06-05,10:00,4,1,5
47,2023-06-05T10:00:00+10:00,2023-06-05,10:00,8,5,13
61,2023-06-05T10:00:00+10:00,2023-06-05,10:00,8,1,9
66,2023-06-05T10:00:00+10:00,2023-06-05,10:00,5,6,11
69,2023-06-05T10:00:00+10:00,2023-06-05,10:00,1,1,2
78,2023-06-05T10:00:00+10:00,2023-06-05,10:00,0,2,2
87,2023-06-05T10:00:00+10:00,2023-06-05,10:00,1,3,4
1,2023-06-05T10:00:00+10:00,2023-06-05,10:00,3,8,11
10,2023-06-05T10:00:00+10:00,2023-06-05,10:00,1,0,1
17,2023-06-05T10:00:00+10:00,2023-06-05,10:00,9,1,10
19,2023-06-05T10:00:00+10:00,2023-06-05,10:00,2,1,3
30,2023-06-05T10:00:00+10:00,2023-06-05,10:00,5,2,7
63,2023-06-05T10:00:00+10:00,2023-06-05,10:00,4,11,15
68,2023-06-05T10:00:00+10:00,2023-06-05,10:00,1,1,2
79,2023-06-05T10:00:00+10:00,2023-06-05,10:00,6,11,17
85,2023-06-05T10:00:00+10:00,2023-06-05,10:00,1,0,1
5,2023-06-05T10:00:00+10:00,2023-06-05,10:00,4,4,8
6,2023-06-05T10:00:00+10:00,2023-06-05,10:00,4,3,7
21,2023-06-05T10:00:00+10:00,2023-06-05,10:00,1,2,3
26,2023-06-05T10:00:00+10:00,2023-06-05,10:00,3,3,6
29,2023-06-05T10:00:00+10:00,2023-06-05,10:00,1,2,3
40,2023-06-05T10:00:00+10:00,2023-06-05,10:00,2,5,7
41,2023-06-05T10:00:00+10:00,2023-06-05,10:00,33,7,40
45,2023-06-05T10:00:00+10:00,2023-06-05,10:00,0,3,3
54,2023-06-05T10:00:00+10:00,2023-06-05,10:00,2,0,2
55,2023-06-05T10:00:00+10:00,2023-06-05,10:00,9,7,16
59,2023-06-05T10:00:00+10:00,2023-06-05,10:00,32,21,53
65,2023-06-05T10:00:00+10:00,2023-06-05,10:00,3,9,12
2,2023-06-05T10:00:00+10:00,2023-06-05,10:00,5,4,9
11,2023-06-05T10:00:00+10:00,2023-06-05,10:00,1,3,4
12,2023-06-05T10:00:00+10:00,2023-06-05,10:00,1,4,5
24,2023-06-05T10:00:00+10:00,2023-06-05,10:00,18,2,20
49,2023-06-05T10:00:00+10:00,2023-06-05,10:00,2,0,2
52,2023-06-05T10:00:00+10:00,2023-06-05,10:00,2,5,7
57,2023-06-05T10:00:00+10:00,2023-06-05,10:00,1,1,2
58,2023-06-05T10:00:00+10:00,2023-06-05,10:00,16,5,21
62,2023-06-05T10:00:00+10:00,2023-06-05,10:00,1,3,4
72,2023-06-05T10:00:00+10:00,2023-06-05,10:00,2,1,3
76,2023-06-05T10:00:00+10:00,2023-06-05,10:00,0,1,1
86,2023-06-05T10:00:00+10:00,2023-06-05,10:00,0,1,1
117,2023-06-05T10:00:00+10:00,2023-06-05,10:00,5,9,14
8,2023-06-05T10:00:00+10:00,2023-06-05,10:00,3,0,3
28,2023-06-05T10:00:00+10:00,2023-06-05,10:00,1,8,9
50,2023-06-05T10:00:00+10:00,2023-06-05,10:00,2,1,3
70,2023-06-05T10:00:00+10:00,2023-06-05,10:00,1,1,2
75,2023-06-05T10:00:00+10:00,2023-06-05,10:00,1,0,1
84,2023-06-05T10:00:00+10:00,2023-06-05,10:00,49,27,76
107,2023-06-05T10:00:00+10:00,2023-06-05,10:00,3,7,10
108,2023-06-05T10:00:00+10:00,2023-06-05,10:00,7,10,17
118,2023-06-05T10:00:00+10:00,2023-06-05,10:00,0,1,1
9,2023-06-05T10:00:00+10:00,2023-06-05,10:00,10,11,21
18,2023-06-05T10:00:00+10:00,2023-06-05,10:00,0,6,6
20,2023-06-05T10:00:00+10:00,2023-06-05,10:00,1,4,5
23,2023-06-05T10:00:00+10:00,2023-06-05,10:00,1,6,7
27,2023-06-05T10:00:00+10:00,2023-06-05,10:00,0,1,1
35,2023-06-05T10:00:00+10:00,2023-06-05,10:00,8,6,14
46,2023-06-05T10:00:00+10:00,2023-06-05,10:00,2,1,3
53,2023-06-05T10:00:00+10:00,2023-06-05,10:00,6,6,12
56,2023-06-05T10:00:00+10:00,2023-06-05,10:00,1,0,1
67,2023-06-05T10:00:00+10:00,2023-06-05,10:00,1,3,4
109,2023-06-05T10:00:00+10:00,2023-06-05,10:00,4,20,24
5,2023-06-05T09:59:00+10:00,2023-06-05,09:59,8,9,17
6,2023-06-05T09:59:00+10:00,2023-06-05,09:59,8,5,13
8,2023-06-05T09:59:00+10:00,2023-06-05,09:59,2,1,3
26,2023-06-05T09:59:00+10:00,2023-06-05,09:59,7,4,11
39,2023-06-05T09:59:00+10:00,2023-06-05,09:59,1,7,8
40,2023-06-05T09:59:00+10:00,2023-06-05,09:59,1,2,3
41,2023-06-05T09:59:00+10:00,2023-06-05,09:59,36,12,48
45,2023-06-05T09:59:00+10:00,2023-06-05,09:59,7,8,15
54,2023-06-05T09:59:00+10:00,2023-06-05,09:59,2,0,2
65,2023-06-05T09:59:00+10:00,2023-06-05,09:59,1,1,2
71,2023-06-05T09:59:00+10:00,2023-06-05,09:59,0,1,1
9,2023-06-05T09:59:00+10:00,2023-06-05,09:59,1,8,9
12,2023-06-05T09:59:00+10:00,2023-06-05,09:59,5,1,6
17,2023-06-05T09:59:00+10:00,2023-06-05,09:59,6,2,8
18,2023-06-05T09:59:00+10:00,2023-06-05,09:59,10,2,12
19,2023-06-05T09:59:00+10:00,2023-06-05,09:59,5,1,6
24,2023-06-05T09:59:00+10:00,2023-06-05,09:59,6,8,14
27,2023-06-05T09:59:00+10:00,2023-06-05,09:59,2,1,3
51,2023-06-05T09:59:00+10:00,2023-06-05,09:59,1,0,1
52,2023-06-05T09:59:00+10:00,2023-06-05,09:59,3,0,3
57,2023-06-05T09:59:00+10:00,2023-06-05,09:59,1,3,4
58,2023-06-05T09:59:00+10:00,2023-06-05,09:59,5,4,9
67,2023-06-05T09:59:00+10:00,2023-06-05,09:59,7,6,13
68,2023-06-05T09:59:00+10:00,2023-06-05,09:59,3,3,6
86,2023-06-05T09:59:00+10:00,2023-06-05,09:59,2,0,2
3,2023-06-05T09:59:00+10:00,2023-06-05,09:59,3,8,11
21,2023-06-05T09:59:00+10:00,2023-06-05,09:59,1,2,3
28,2023-06-05T09:59:00+10:00,2023-06-05,09:59,1,2,3
31,2023-06-05T09:59:00+10:00,2023-06-05,09:59,1,0,1
37,2023-06-05T09:59:00+10:00,2023-06-05,09:59,1,2,3
66,2023-06-05T09:59:00+10:00,2023-06-05,09:59,7,5,12
70,2023-06-05T09:59:00+10:00,2023-06-05,09:59,0,2,2
77,2023-06-05T09:59:00+10:00,2023-06-05,09:59,3,0,3
78,2023-06-05T09:59:00+10:00,2023-06-05,09:59,1,0,1
2,2023-06-05T09:59:00+10:00,2023-06-05,09:59,3,4,7
10,2023-06-05T09:59:00+10:00,2023-06-05,09:59,1,7,8
30,2023-06-05T09:59:00+10:00,2023-06-05,09:59,1,6,7
48,2023-06-05T09:59:00+10:00,2023-06-05,09:59,0,2,2
56,2023-06-05T09:59:00+10:00,2023-06-05,09:59,3,0,3
63,2023-06-05T09:59:00+10:00,2023-06-05,09:59,1,7,8
72,2023-06-05T09:59:00+10:00,2023-06-05,09:59,5,22,27
85,2023-06-05T09:59:00+10:00,2023-06-05,09:59,1,1,2
4,2023-06-05T09:59:00+10:00,2023-06-05,09:59,17,4,21
14,2023-06-05T09:59:00+10:00,2023-06-05,09:59,6,9,15
29,2023-06-05T09:59:00+10:00,2023-06-05,09:59,3,2,5
36,2023-06-05T09:59:00+10:00,2023-06-05,09:59,3,3,6
42,2023-06-05T09:59:00+10:00,2023-06-05,09:59,2,2,4
44,2023-06-05T09:59:00+10:00,2023-06-05,09:59,0,2,2
47,2023-06-05T09:59:00+10:00,2023-06-05,09:59,6,5,11
50,2023-06-05T09:59:00+10:00,2023-06-05,09:59,0,1,1
55,2023-06-05T09:59:00+10:00,2023-06-05,09:59,3,9,12
61,2023-06-05T09:59:00+10:00,2023-06-05,09:59,2,9,11
69,2023-06-05T09:59:00+10:00,2023-06-05,09:59,2,1,3
87,2023-06-05T09:59:00+10:00,2023-06-05,09:59,2,0,2
108,2023-06-05T09:59:00+10:00,2023-06-05,09:59,4,7,11
1,2023-06-05T09:59:00+10:00,2023-06-05,09:59,1,4,5
20,2023-06-05T09:59:00+10:00,2023-06-05,09:59,2,0,2
23,2023-06-05T09:59:00+10:00,2023-06-05,09:59,2,2,4
35,2023-06-05T09:59:00+10:00,2023-06-05,09:59,4,3,7
46,2023-06-05T09:59:00+10:00,2023-06-05,09:59,2,7,9
53,2023-06-05T09:59:00+10:00,2023-06-05,09:59,3,9,12
62,2023-06-05T09:59:00+10:00,2023-06-05,09:59,0,2,2
79,2023-06-05T09:59:00+10:00,2023-06-05,09:59,5,14,19
5,2023-06-05T09:58:00+10:00,2023-06-05,09:58,8,14,22
8,2023-06-05T09:58:00+10:00,2023-06-05,09:58,2,0,2
14,2023-06-05T09:58:00+10:00,2023-06-05,09:58,7,17,24
21,2023-06-05T09:58:00+10:00,2023-06-05,09:58,9,1,10
29,2023-06-05T09:58:00+10:00,2023-06-05,09:58,2,0,2
31,2023-06-05T09:58:00+10:00,2023-06-05,09:58,1,2,3
36,2023-06-05T09:58:00+10:00,2023-06-05,09:58,2,0,2
39,2023-06-05T09:58:00+10:00,2023-06-05,09:58,2,0,2
54,2023-06-05T09:58:00+10:00,2023-06-05,09:58,2,0,2
55,2023-06-05T09:58:00+10:00,2023-06-05,09:58,2,5,7
77,2023-06-05T09:58:00+10:00,2023-06-05,09:58,1,1,2
1,2023-06-05T09:58:00+10:00,2023-06-05,09:58,7,6,13
10,2023-06-05T09:58:00+10:00,2023-06-05,09:58,0,4,4
11,2023-06-05T09:58:00+10:00,2023-06-05,09:58,1,0,1
17,2023-06-05T09:58:00+10:00,2023-06-05,09:58,6,0,6
23,2023-06-05T09:58:00+10:00,2023-06-05,09:58,4,1,5
46,2023-06-05T09:58:00+10:00,2023-06-05,09:58,4,0,4
56,2023-06-05T09:58:00+10:00,2023-06-05,09:58,1,1,2
62,2023-06-05T09:58:00+10:00,2023-06-05,09:58,4,2,6
67,2023-06-05T09:58:00+10:00,2023-06-05,09:58,5,12,17
72,2023-06-05T09:58:00+10:00,2023-06-05,09:58,4,14,18
85,2023-06-05T09:58:00+10:00,2023-06-05,09:58,1,1,2
4,2023-06-05T09:58:00+10:00,2023-06-05,09:58,9,13,22
40,2023-06-05T09:58:00+10:00,2023-06-05,09:58,4,2,6
42,2023-06-05T09:58:00+10:00,2023-06-05,09:58,8,0,8
45,2023-06-05T09:58:00+10:00,2023-06-05,09:58,3,4,7
50,2023-06-05T09:58:00+10:00,2023-06-05,09:58,4,1,5
66,2023-06-05T09:58:00+10:00,2023-06-05,09:58,5,2,7
70,2023-06-05T09:58:00+10:00,2023-06-05,09:58,1,1,2
108,2023-06-05T09:58:00+10:00,2023-06-05,09:58,1,8,9
2,2023-06-05T09:58:00+10:00,2023-06-05,09:58,3,9,12
12,2023-06-05T09:58:00+10:00,2023-06-05,09:58,2,3,5
18,2023-06-05T09:58:00+10:00,2023-06-05,09:58,2,3,5
19,2023-06-05T09:58:00+10:00,2023-06-05,09:58,6,0,6
24,2023-06-05T09:58:00+10:00,2023-06-05,09:58,13,1,14
30,2023-06-05T09:58:00+10:00,2023-06-05,09:58,1,5,6
48,2023-06-05T09:58:00+10:00,2023-06-05,09:58,2,0,2
51,2023-06-05T09:58:00+10:00,2023-06-05,09:58,1,0,1
63,2023-06-05T09:58:00+10:00,2023-06-05,09:58,2,2,4
68,2023-06-05T09:58:00+10:00,2023-06-05,09:58,0,1,1
76,2023-06-05T09:58:00+10:00,2023-06-05,09:58,2,0,2
3,2023-06-05T09:58:00+10:00,2023-06-05,09:58,4,0,4
6,2023-06-05T09:58:00+10:00,2023-06-05,09:58,1,2,3
26,2023-06-05T09:58:00+10:00,2023-06-05,09:58,3,6,9
28,2023-06-05T09:58:00+10:00,2023-06-05,09:58,4,1,5
41,2023-06-05T09:58:00+10:00,2023-06-05,09:58,15,16,31
47,2023-06-05T09:58:00+10:00,2023-06-05,09:58,4,9,13
61,2023-06-05T09:58:00+10:00,2023-06-05,09:58,1,3,4
65,2023-06-05T09:58:00+10:00,2023-06-05,09:58,8,1,9
87,2023-06-05T09:58:00+10:00,2023-06-05,09:58,4,1,5
9,2023-06-05T09:58:00+10:00,2023-06-05,09:58,1,8,9
27,2023-06-05T09:58:00+10:00,2023-06-05,09:58,1,0,1
35,2023-06-05T09:58:00+10:00,2023-06-05,09:58,6,2,8
52,2023-06-05T09:58:00+10:00,2023-06-05,09:58,2,5,7
53,2023-06-05T09:58:00+10:00,2023-06-05,09:58,16,12,28
57,2023-06-05T09:58:00+10:00,2023-06-05,09:58,2,1,3
58,2023-06-05T09:58:00+10:00,2023-06-05,09:58,7,7,14
79,2023-06-05T09:58:00+10:00,2023-06-05,09:58,1,4,5
86,2023-06-05T09:58:00+10:00,2023-06-05,09:58,1,0,1
14,2023-06-05T09:57:00+10:00,2023-06-05,09:57,8,13,21
28,2023-06-05T09:57:00+10:00,2023-06-05,09:57,3,0,3
31,2023-06-05T09:57:00+10:00,2023-06-05,09:57,3,0,3
39,2023-06-05T09:57:00+10:00,2023-06-05,09:57,2,1,3
50,2023-06-05T09:57:00+10:00,2023-06-05,09:57,1,1,2
65,2023-06-05T09:57:00+10:00,2023-06-05,09:57,9,11,20
71,2023-06-05T09:57:00+10:00,2023-06-05,09:57,1,4,5
2,2023-06-05T09:57:00+10:00,2023-06-05,09:57,2,7,9
10,2023-06-05T09:57:00+10:00,2023-06-05,09:57,1,6,7
18,2023-06-05T09:57:00+10:00,2023-06-05,09:57,1,4,5
19,2023-06-05T09:57:00+10:00,2023-06-05,09:57,1,3,4
35,2023-06-05T09:57:00+10:00,2023-06-05,09:57,1,1,2
48,2023-06-05T09:57:00+10:00,2023-06-05,09:57,1,0,1
52,2023-06-05T09:57:00+10:00,2023-06-05,09:57,1,1,2
53,2023-06-05T09:57:00+10:00,2023-06-05,09:57,13,2,15
57,2023-06-05T09:57:00+10:00,2023-06-05,09:57,1,1,2
63,2023-06-05T09:57:00+10:00,2023-06-05,09:57,3,4,7
68,2023-06-05T09:57:00+10:00,2023-06-05,09:57,5,1,6
76,2023-06-05T09:57:00+10:00,2023-06-05,09:57,1,1,2
3,2023-06-05T09:57:00+10:00,2023-06-05,09:57,6,8,14
4,2023-06-05T09:57:00+10:00,2023-06-05,09:57,3,4,7
5,2023-06-05T09:57:00+10:00,2023-06-05,09:57,8,3,11
6,2023-06-05T09:57:00+10:00,2023-06-05,09:57,2,7,9
8,2023-06-05T09:57:00+10:00,2023-06-05,09:57,2,1,3
21,2023-06-05T09:57:00+10:00,2023-06-05,09:57,2,1,3
29,2023-06-05T09:57:00+10:00,2023-06-05,09:57,1,0,1
44,2023-06-05T09:57:00+10:00,2023-06-05,09:57,2,0,2
45,2023-06-05T09:57:00+10:00,2023-06-05,09:57,2,2,4
54,2023-06-05T09:57:00+10:00,2023-06-05,09:57,1,1,2
55,2023-06-05T09:57:00+10:00,2023-06-05,09:57,10,5,15
61,2023-06-05T09:57:00+10:00,2023-06-05,09:57,2,4,6
66,2023-06-05T09:57:00+10:00,2023-06-05,09:57,4,3,7
87,2023-06-05T09:57:00+10:00,2023-06-05,09:57,4,5,9
1,2023-06-05T09:57:00+10:00,2023-06-05,09:57,4,7,11
9,2023-06-05T09:57:00+10:00,2023-06-05,09:57,1,7,8
17,2023-06-05T09:57:00+10:00,2023-06-05,09:57,5,2,7
23,2023-06-05T09:57:00+10:00,2023-06-05,09:57,7,1,8
46,2023-06-05T09:57:00+10:00,2023-06-05,09:57,0,3,3
49,2023-06-05T09:57:00+10:00,2023-06-05,09:57,2,0,2
56,2023-06-05T09:57:00+10:00,2023-06-05,09:57,4,0,4
58,2023-06-05T09:57:00+10:00,2023-06-05,09:57,15,19,34
62,2023-06-05T09:57:00+10:00,2023-06-05,09:57,2,1,3
79,2023-06-05T09:57:00+10:00,2023-06-05,09:57,5,3,8
85,2023-06-05T09:57:00+10:00,2023-06-05,09:57,3,4,7
86,2023-06-05T09:57:00+10:00,2023-06-05,09:57,1,1,2
26,2023-06-05T09:57:00+10:00,2023-06-05,09:57,5,2,7
36,2023-06-05T09:57:00+10:00,2023-06-05,09:57,5,8,13
40,2023-06-05T09:57:00+10:00,2023-06-05,09:57,2,3,5
41,2023-06-05T09:57:00+10:00,2023-06-05,09:57,14,10,24
42,2023-06-05T09:57:00+10:00,2023-06-05,09:57,1,0,1
47,2023-06-05T09:57:00+10:00,2023-06-05,09:57,6,8,14
69,2023-06-05T09:57:00+10:00,2023-06-05,09:57,1,2,3
70,2023-06-05T09:57:00+10:00,2023-06-05,09:57,1,4,5
77,2023-06-05T09:57:00+10:00,2023-06-05,09:57,2,0,2
108,2023-06-05T09:57:00+10:00,2023-06-05,09:57,5,6,11
20,2023-06-05T09:57:00+10:00,2023-06-05,09:57,1,3,4
24,2023-06-05T09:57:00+10:00,2023-06-05,09:57,8,6,14
30,2023-06-05T09:57:00+10:00,2023-06-05,09:57,1,0,1
51,2023-06-05T09:57:00+10:00,2023-06-05,09:57,1,0,1
67,2023-06-05T09:57:00+10:00,2023-06-05,09:57,10,3,13
72,2023-06-05T09:57:00+10:00,2023-06-05,09:57,2,18,20
31,2023-06-05T09:56:00+10:00,2023-06-05,09:56,3,2,5
37,2023-06-05T09:56:00+10:00,2023-06-05,09:56,1,0,1
41,2023-06-05T09:56:00+10:00,2023-06-05,09:56,18,6,24
42,2023-06-05T09:56:00+10:00,2023-06-05,09:56,3,0,3
45,2023-06-05T09:56:00+10:00,2023-06-05,09:56,3,3,6
69,2023-06-05T09:56:00+10:00,2023-06-05,09:56,1,0,1
87,2023-06-05T09:56:00+10:00,2023-06-05,09:56,1,3,4
9,2023-06-05T09:56:00+10:00,2023-06-05,09:56,1,5,6
18,2023-06-05T09:56:00+10:00,2023-06-05,09:56,4,6,10
24,2023-06-05T09:56:00+10:00,2023-06-05,09:56,5,2,7
72,2023-06-05T09:56:00+10:00,2023-06-05,09:56,7,0,7
79,2023-06-05T09:56:00+10:00,2023-06-05,09:56,2,4,6
5,2023-06-05T09:56:00+10:00,2023-06-05,09:56,4,3,7
6,2023-06-05T09:56:00+10:00,2023-06-05,09:56,15,2,17
26,2023-06-05T09:56:00+10:00,2023-06-05,09:56,6,3,9
29,2023-06-05T09:56:00+10:00,2023-06-05,09:56,4,1,5
47,2023-06-05T09:56:00+10:00,2023-06-05,09:56,2,6,8
50,2023-06-05T09:56:00+10:00,2023-06-05,09:56,1,2,3
61,2023-06-05T09:56:00+10:00,2023-06-05,09:56,6,1,7
77,2023-06-05T09:56:00+10:00,2023-06-05,09:56,1,1,2
108,2023-06-05T09:56:00+10:00,2023-06-05,09:56,2,3,5
1,2023-06-05T09:56:00+10:00,2023-06-05,09:56,6,3,9
12,2023-06-05T09:56:00+10:00,2023-06-05,09:56,2,1,3
19,2023-06-05T09:56:00+10:00,2023-06-05,09:56,0,1,1
30,2023-06-05T09:56:00+10:00,2023-06-05,09:56,2,2,4
35,2023-06-05T09:56:00+10:00,2023-06-05,09:56,4,9,13
52,2023-06-05T09:56:00+10:00,2023-06-05,09:56,2,0,2
56,2023-06-05T09:56:00+10:00,2023-06-05,09:56,2,2,4
63,2023-06-05T09:56:00+10:00,2023-06-05,09:56,4,1,5
76,2023-06-05T09:56:00+10:00,2023-06-05,09:56,4,1,5
85,2023-06-05T09:56:00+10:00,2023-06-05,09:56,3,0,3
86,2023-06-05T09:56:00+10:00,2023-06-05,09:56,2,0,2
3,2023-06-05T09:56:00+10:00,2023-06-05,09:56,2,7,9
4,2023-06-05T09:56:00+10:00,2023-06-05,09:56,9,15,24
8,2023-06-05T09:56:00+10:00,2023-06-05,09:56,0,2,2
14,2023-06-05T09:56:00+10:00,2023-06-05,09:56,5,31,36
21,2023-06-05T09:56:00+10:00,2023-06-05,09:56,3,4,7
28,2023-06-05T09:56:00+10:00,2023-06-05,09:56,3,7,10
36,2023-06-05T09:56:00+10:00,2023-06-05,09:56,5,4,9
39,2023-06-05T09:56:00+10:00,2023-06-05,09:56,1,1,2
40,2023-06-05T09:56:00+10:00,2023-06-05,09:56,2,1,3
54,2023-06-05T09:56:00+10:00,2023-06-05,09:56,1,0,1
55,2023-06-05T09:56:00+10:00,2023-06-05,09:56,2,19,21
65,2023-06-05T09:56:00+10:00,2023-06-05,09:56,4,9,13
66,2023-06-05T09:56:00+10:00,2023-06-05,09:56,0,10,10
70,2023-06-05T09:56:00+10:00,2023-06-05,09:56,2,1,3
2,2023-06-05T09:56:00+10:00,2023-06-05,09:56,2,3,5
10,2023-06-05T09:56:00+10:00,2023-06-05,09:56,0,1,1
17,2023-06-05T09:56:00+10:00,2023-06-05,09:56,6,1,7
23,2023-06-05T09:56:00+10:00,2023-06-05,09:56,3,1,4
46,2023-06-05T09:56:00+10:00,2023-06-05,09:56,1,0,1
48,2023-06-05T09:56:00+10:00,2023-06-05,09:56,4,0,4
49,2023-06-05T09:56:00+10:00,2023-06-05,09:56,7,1,8
53,2023-06-05T09:56:00+10:00,2023-06-05,09:56,7,7,14
57,2023-06-05T09:56:00+10:00,2023-06-05,09:56,7,2,9
58,2023-06-05T09:56:00+10:00,2023-06-05,09:56,9,0,9
62,2023-06-05T09:56:00+10:00,2023-06-05,09:56,1,0,1
67,2023-06-05T09:56:00+10:00,2023-06-05,09:56,5,9,14
68,2023-06-05T09:56:00+10:00,2023-06-05,09:56,5,3,8
29,2023-06-05T09:55:00+10:00,2023-06-05,09:55,3,2,5
55,2023-06-05T09:55:00+10:00,2023-06-05,09:55,10,7,17
61,2023-06-05T09:55:00+10:00,2023-06-05,09:55,4,8,12
71,2023-06-05T09:55:00+10:00,2023-06-05,09:55,1,2,3
57,2023-06-05T09:55:00+10:00,2023-06-05,09:55,3,2,5
58,2023-06-05T09:55:00+10:00,2023-06-05,09:55,12,3,15
62,2023-06-05T09:55:00+10:00,2023-06-05,09:55,5,0,5
63,2023-06-05T09:55:00+10:00,2023-06-05,09:55,0,7,7
67,2023-06-05T09:55:00+10:00,2023-06-05,09:55,16,1,17
68,2023-06-05T09:55:00+10:00,2023-06-05,09:55,4,0,4
79,2023-06-05T09:55:00+10:00,2023-06-05,09:55,0,7,7
86,2023-06-05T09:55:00+10:00,2023-06-05,09:55,0,1,1
17,2023-06-05T09:55:00+10:00,2023-06-05,09:55,4,6,10
18,2023-06-05T09:55:00+10:00,2023-06-05,09:55,2,9,11
35,2023-06-05T09:55:00+10:00,2023-06-05,09:55,3,2,5
51,2023-06-05T09:55:00+10:00,2023-06-05,09:55,0,4,4
72,2023-06-05T09:55:00+10:00,2023-06-05,09:55,1,24,25
85,2023-06-05T09:55:00+10:00,2023-06-05,09:55,2,1,3
109,2023-06-05T09:55:00+10:00,2023-06-05,09:55,2,23,25
3,2023-06-05T09:55:00+10:00,2023-06-05,09:55,2,13,15
5,2023-06-05T09:55:00+10:00,2023-06-05,09:55,7,4,11
14,2023-06-05T09:55:00+10:00,2023-06-05,09:55,13,35,48
26,2023-06-05T09:55:00+10:00,2023-06-05,09:55,1,0,1
40,2023-06-05T09:55:00+10:00,2023-06-05,09:55,2,2,4
42,2023-06-05T09:55:00+10:00,2023-06-05,09:55,1,3,4
44,2023-06-05T09:55:00+10:00,2023-06-05,09:55,2,2,4
47,2023-06-05T09:55:00+10:00,2023-06-05,09:55,5,4,9
50,2023-06-05T09:55:00+10:00,2023-06-05,09:55,2,0,2
54,2023-06-05T09:55:00+10:00,2023-06-05,09:55,7,0,7
59,2023-06-05T09:55:00+10:00,2023-06-05,09:55,34,21,55
65,2023-06-05T09:55:00+10:00,2023-06-05,09:55,3,5,8
66,2023-06-05T09:55:00+10:00,2023-06-05,09:55,5,8,13
69,2023-06-05T09:55:00+10:00,2023-06-05,09:55,7,2,9
77,2023-06-05T09:55:00+10:00,2023-06-05,09:55,1,1,2
78,2023-06-05T09:55:00+10:00,2023-06-05,09:55,1,0,1
108,2023-06-05T09:55:00+10:00,2023-06-05,09:55,5,2,7
9,2023-06-05T09:55:00+10:00,2023-06-05,09:55,3,8,11
11,2023-06-05T09:55:00+10:00,2023-06-05,09:55,0,1,1
19,2023-06-05T09:55:00+10:00,2023-06-05,09:55,0,2,2
23,2023-06-05T09:55:00+10:00,2023-06-05,09:55,3,4,7
24,2023-06-05T09:55:00+10:00,2023-06-05,09:55,12,10,22
27,2023-06-05T09:55:00+10:00,2023-06-05,09:55,1,2,3
30,2023-06-05T09:55:00+10:00,2023-06-05,09:55,1,1,2
46,2023-06-05T09:55:00+10:00,2023-06-05,09:55,1,3,4
48,2023-06-05T09:55:00+10:00,2023-06-05,09:55,0,2,2
52,2023-06-05T09:55:00+10:00,2023-06-05,09:55,4,1,5
53,2023-06-05T09:55:00+10:00,2023-06-05,09:55,3,15,18
56,2023-06-05T09:55:00+10:00,2023-06-05,09:55,3,0,3
117,2023-06-05T09:55:00+10:00,2023-06-05,09:55,2,3,5
4,2023-06-05T09:55:00+10:00,2023-06-05,09:55,12,7,19
6,2023-06-05T09:55:00+10:00,2023-06-05,09:55,6,4,10
21,2023-06-05T09:55:00+10:00,2023-06-05,09:55,4,1,5
28,2023-06-05T09:55:00+10:00,2023-06-05,09:55,2,3,5
31,2023-06-05T09:55:00+10:00,2023-06-05,09:55,3,2,5
36,2023-06-05T09:55:00+10:00,2023-06-05,09:55,2,2,4
39,2023-06-05T09:55:00+10:00,2023-06-05,09:55,4,2,6
41,2023-06-05T09:55:00+10:00,2023-06-05,09:55,21,12,33
45,2023-06-05T09:55:00+10:00,2023-06-05,09:55,3,2,5
70,2023-06-05T09:55:00+10:00,2023-06-05,09:55,1,3,4
84,2023-06-05T09:55:00+10:00,2023-06-05,09:55,44,39,83
107,2023-06-05T09:55:00+10:00,2023-06-05,09:55,7,14,21
118,2023-06-05T09:55:00+10:00,2023-06-05,09:55,1,0,1
1,2023-06-05T09:55:00+10:00,2023-06-05,09:55,5,6,11
2,2023-06-05T09:55:00+10:00,2023-06-05,09:55,6,5,11
21,2023-06-05T09:54:00+10:00,2023-06-05,09:54,3,0,3
31,2023-06-05T09:54:00+10:00,2023-06-05,09:54,3,2,5
39,2023-06-05T09:54:00+10:00,2023-06-05,09:54,4,4,8
41,2023-06-05T09:54:00+10:00,2023-06-05,09:54,18,12,30
47,2023-06-05T09:54:00+10:00,2023-06-05,09:54,5,7,12
54,2023-06-05T09:54:00+10:00,2023-06-05,09:54,1,0,1
55,2023-06-05T09:54:00+10:00,2023-06-05,09:54,5,7,12
65,2023-06-05T09:54:00+10:00,2023-06-05,09:54,2,4,6
66,2023-06-05T09:54:00+10:00,2023-06-05,09:54,7,9,16
70,2023-06-05T09:54:00+10:00,2023-06-05,09:54,1,1,2
10,2023-06-05T09:54:00+10:00,2023-06-05,09:54,1,2,3
18,2023-06-05T09:54:00+10:00,2023-06-05,09:54,1,3,4
19,2023-06-05T09:54:00+10:00,2023-06-05,09:54,1,0,1
20,2023-06-05T09:54:00+10:00,2023-06-05,09:54,1,1,2
46,2023-06-05T09:54:00+10:00,2023-06-05,09:54,0,2,2
48,2023-06-05T09:54:00+10:00,2023-06-05,09:54,1,0,1
56,2023-06-05T09:54:00+10:00,2023-06-05,09:54,2,0,2
67,2023-06-05T09:54:00+10:00,2023-06-05,09:54,7,7,14
72,2023-06-05T09:54:00+10:00,2023-06-05,09:54,1,1,2
76,2023-06-05T09:54:00+10:00,2023-06-05,09:54,2,0,2
85,2023-06-05T09:54:00+10:00,2023-06-05,09:54,2,1,3
9,2023-06-05T09:54:00+10:00,2023-06-05,09:54,0,7,7
17,2023-06-05T09:54:00+10:00,2023-06-05,09:54,6,9,15
23,2023-06-05T09:54:00+10:00,2023-06-05,09:54,1,0,1
24,2023-06-05T09:54:00+10:00,2023-06-05,09:54,6,7,13
27,2023-06-05T09:54:00+10:00,2023-06-05,09:54,2,1,3
30,2023-06-05T09:54:00+10:00,2023-06-05,09:54,1,6,7
35,2023-06-05T09:54:00+10:00,2023-06-05,09:54,3,6,9
51,2023-06-05T09:54:00+10:00,2023-06-05,09:54,3,0,3
52,2023-06-05T09:54:00+10:00,2023-06-05,09:54,3,5,8
57,2023-06-05T09:54:00+10:00,2023-06-05,09:54,2,7,9
4,2023-06-05T09:54:00+10:00,2023-06-05,09:54,51,4,55
8,2023-06-05T09:54:00+10:00,2023-06-05,09:54,4,3,7
14,2023-06-05T09:54:00+10:00,2023-06-05,09:54,0,1,1
28,2023-06-05T09:54:00+10:00,2023-06-05,09:54,4,3,7
44,2023-06-05T09:54:00+10:00,2023-06-05,09:54,0,1,1
50,2023-06-05T09:54:00+10:00,2023-06-05,09:54,0,7,7
61,2023-06-05T09:54:00+10:00,2023-06-05,09:54,5,3,8
71,2023-06-05T09:54:00+10:00,2023-06-05,09:54,0,1,1
75,2023-06-05T09:54:00+10:00,2023-06-05,09:54,1,0,1
87,2023-06-05T09:54:00+10:00,2023-06-05,09:54,1,0,1
2,2023-06-05T09:54:00+10:00,2023-06-05,09:54,9,4,13
12,2023-06-05T09:54:00+10:00,2023-06-05,09:54,1,1,2
53,2023-06-05T09:54:00+10:00,2023-06-05,09:54,2,11,13
58,2023-06-05T09:54:00+10:00,2023-06-05,09:54,8,0,8
62,2023-06-05T09:54:00+10:00,2023-06-05,09:54,1,3,4
63,2023-06-05T09:54:00+10:00,2023-06-05,09:54,3,6,9
79,2023-06-05T09:54:00+10:00,2023-06-05,09:54,8,1,9
3,2023-06-05T09:54:00+10:00,2023-06-05,09:54,7,6,13
5,2023-06-05T09:54:00+10:00,2023-06-05,09:54,1,5,6
6,2023-06-05T09:54:00+10:00,2023-06-05,09:54,3,9,12
26,2023-06-05T09:54:00+10:00,2023-06-05,09:54,1,0,1
36,2023-06-05T09:54:00+10:00,2023-06-05,09:54,3,2,5
37,2023-06-05T09:54:00+10:00,2023-06-05,09:54,0,1,1
40,2023-06-05T09:54:00+10:00,2023-06-05,09:54,6,12,18
45,2023-06-05T09:54:00+10:00,2023-06-05,09:54,0,4,4
69,2023-06-05T09:54:00+10:00,2023-06-05,09:54,8,2,10
77,2023-06-05T09:54:00+10:00,2023-06-05,09:54,0,1,1
108,2023-06-05T09:54:00+10:00,2023-06-05,09:54,1,4,5
1,2023-06-05T09:54:00+10:00,2023-06-05,09:54,6,12,18
4,2023-06-05T09:53:00+10:00,2023-06-05,09:53,16,13,29
14,2023-06-05T09:53:00+10:00,2023-06-05,09:53,3,1,4
21,2023-06-05T09:53:00+10:00,2023-06-05,09:53,0,2,2
26,2023-06-05T09:53:00+10:00,2023-06-05,09:53,1,2,3
39,2023-06-05T09:53:00+10:00,2023-06-05,09:53,1,2,3
42,2023-06-05T09:53:00+10:00,2023-06-05,09:53,2,2,4
61,2023-06-05T09:53:00+10:00,2023-06-05,09:53,4,3,7
66,2023-06-05T09:53:00+10:00,2023-06-05,09:53,7,11,18
69,2023-06-05T09:53:00+10:00,2023-06-05,09:53,3,0,3
87,2023-06-05T09:53:00+10:00,2023-06-05,09:53,5,2,7
1,2023-06-05T09:53:00+10:00,2023-06-05,09:53,7,12,19
2,2023-06-05T09:53:00+10:00,2023-06-05,09:53,1,5,6
17,2023-06-05T09:53:00+10:00,2023-06-05,09:53,11,0,11
19,2023-06-05T09:53:00+10:00,2023-06-05,09:53,0,3,3
20,2023-06-05T09:53:00+10:00,2023-06-05,09:53,0,2,2
23,2023-06-05T09:53:00+10:00,2023-06-05,09:53,5,7,12
24,2023-06-05T09:53:00+10:00,2023-06-05,09:53,14,5,19
35,2023-06-05T09:53:00+10:00,2023-06-05,09:53,4,4,8
46,2023-06-05T09:53:00+10:00,2023-06-05,09:53,1,4,5
49,2023-06-05T09:53:00+10:00,2023-06-05,09:53,2,0,2
51,2023-06-05T09:53:00+10:00,2023-06-05,09:53,2,0,2
56,2023-06-05T09:53:00+10:00,2023-06-05,09:53,3,0,3
67,2023-06-05T09:53:00+10:00,2023-06-05,09:53,2,4,6
72,2023-06-05T09:53:00+10:00,2023-06-05,09:53,5,2,7
9,2023-06-05T09:53:00+10:00,2023-06-05,09:53,0,7,7
10,2023-06-05T09:53:00+10:00,2023-06-05,09:53,0,2,2
12,2023-06-05T09:53:00+10:00,2023-06-05,09:53,1,3,4
18,2023-06-05T09:53:00+10:00,2023-06-05,09:53,3,2,5
48,2023-06-05T09:53:00+10:00,2023-06-05,09:53,1,0,1
53,2023-06-05T09:53:00+10:00,2023-06-05,09:53,2,12,14
62,2023-06-05T09:53:00+10:00,2023-06-05,09:53,4,0,4
3,2023-06-05T09:53:00+10:00,2023-06-05,09:53,5,13,18
8,2023-06-05T09:53:00+10:00,2023-06-05,09:53,1,0,1
28,2023-06-05T09:53:00+10:00,2023-06-05,09:53,6,3,9
40,2023-06-05T09:53:00+10:00,2023-06-05,09:53,1,2,3
45,2023-06-05T09:53:00+10:00,2023-06-05,09:53,7,5,12
50,2023-06-05T09:53:00+10:00,2023-06-05,09:53,1,5,6
65,2023-06-05T09:53:00+10:00,2023-06-05,09:53,1,11,12
77,2023-06-05T09:53:00+10:00,2023-06-05,09:53,3,1,4
108,2023-06-05T09:53:00+10:00,2023-06-05,09:53,1,6,7
27,2023-06-05T09:53:00+10:00,2023-06-05,09:53,0,1,1
30,2023-06-05T09:53:00+10:00,2023-06-05,09:53,2,4,6
57,2023-06-05T09:53:00+10:00,2023-06-05,09:53,5,5,10
58,2023-06-05T09:53:00+10:00,2023-06-05,09:53,10,5,15
63,2023-06-05T09:53:00+10:00,2023-06-05,09:53,10,3,13
68,2023-06-05T09:53:00+10:00,2023-06-05,09:53,4,1,5
79,2023-06-05T09:53:00+10:00,2023-06-05,09:53,11,5,16
85,2023-06-05T09:53:00+10:00,2023-06-05,09:53,0,3,3
86,2023-06-05T09:53:00+10:00,2023-06-05,09:53,1,0,1
5,2023-06-05T09:53:00+10:00,2023-06-05,09:53,4,3,7
6,2023-06-05T09:53:00+10:00,2023-06-05,09:53,3,4,7
29,2023-06-05T09:53:00+10:00,2023-06-05,09:53,2,0,2
36,2023-06-05T09:53:00+10:00,2023-06-05,09:53,1,2,3
37,2023-06-05T09:53:00+10:00,2023-06-05,09:53,0,1,1
41,2023-06-05T09:53:00+10:00,2023-06-05,09:53,20,16,36
44,2023-06-05T09:53:00+10:00,2023-06-05,09:53,0,2,2
47,2023-06-05T09:53:00+10:00,2023-06-05,09:53,6,6,12
54,2023-06-05T09:53:00+10:00,2023-06-05,09:53,2,0,2
55,2023-06-05T09:53:00+10:00,2023-06-05,09:53,4,9,13
70,2023-06-05T09:53:00+10:00,2023-06-05,09:53,0,1,1
71,2023-06-05T09:53:00+10:00,2023-06-05,09:53,1,0,1
75,2023-06-05T09:53:00+10:00,2023-06-05,09:53,2,3,5
78,2023-06-05T09:53:00+10:00,2023-06-05,09:53,0,1,1
4,2023-06-05T09:52:00+10:00,2023-06-05,09:52,14,9,23
8,2023-06-05T09:52:00+10:00,2023-06-05,09:52,1,1,2
39,2023-06-05T09:52:00+10:00,2023-06-05,09:52,7,0,7
45,2023-06-05T09:52:00+10:00,2023-06-05,09:52,7,5,12
47,2023-06-05T09:52:00+10:00,2023-06-05,09:52,6,8,14
55,2023-06-05T09:52:00+10:00,2023-06-05,09:52,6,7,13
87,2023-06-05T09:52:00+10:00,2023-06-05,09:52,0,1,1
1,2023-06-05T09:52:00+10:00,2023-06-05,09:52,2,12,14
12,2023-06-05T09:52:00+10:00,2023-06-05,09:52,3,0,3
30,2023-06-05T09:52:00+10:00,2023-06-05,09:52,2,5,7
46,2023-06-05T09:52:00+10:00,2023-06-05,09:52,0,1,1
48,2023-06-05T09:52:00+10:00,2023-06-05,09:52,3,1,4
52,2023-06-05T09:52:00+10:00,2023-06-05,09:52,1,3,4
53,2023-06-05T09:52:00+10:00,2023-06-05,09:52,10,10,20
63,2023-06-05T09:52:00+10:00,2023-06-05,09:52,9,3,12
68,2023-06-05T09:52:00+10:00,2023-06-05,09:52,2,2,4
79,2023-06-05T09:52:00+10:00,2023-06-05,09:52,0,5,5
10,2023-06-05T09:52:00+10:00,2023-06-05,09:52,0,4,4
19,2023-06-05T09:52:00+10:00,2023-06-05,09:52,3,3,6
35,2023-06-05T09:52:00+10:00,2023-06-05,09:52,13,7,20
62,2023-06-05T09:52:00+10:00,2023-06-05,09:52,3,2,5
67,2023-06-05T09:52:00+10:00,2023-06-05,09:52,10,5,15
72,2023-06-05T09:52:00+10:00,2023-06-05,09:52,4,1,5
5,2023-06-05T09:52:00+10:00,2023-06-05,09:52,5,2,7
6,2023-06-05T09:52:00+10:00,2023-06-05,09:52,3,5,8
21,2023-06-05T09:52:00+10:00,2023-06-05,09:52,1,3,4
26,2023-06-05T09:52:00+10:00,2023-06-05,09:52,2,1,3
29,2023-06-05T09:52:00+10:00,2023-06-05,09:52,1,3,4
37,2023-06-05T09:52:00+10:00,2023-06-05,09:52,2,0,2
41,2023-06-05T09:52:00+10:00,2023-06-05,09:52,23,8,31
42,2023-06-05T09:52:00+10:00,2023-06-05,09:52,3,1,4
54,2023-06-05T09:52:00+10:00,2023-06-05,09:52,0,3,3
71,2023-06-05T09:52:00+10:00,2023-06-05,09:52,1,0,1
77,2023-06-05T09:52:00+10:00,2023-06-05,09:52,0,1,1
9,2023-06-05T09:52:00+10:00,2023-06-05,09:52,2,13,15
11,2023-06-05T09:52:00+10:00,2023-06-05,09:52,0,1,1
17,2023-06-05T09:52:00+10:00,2023-06-05,09:52,10,6,16
18,2023-06-05T09:52:00+10:00,2023-06-05,09:52,2,3,5
20,2023-06-05T09:52:00+10:00,2023-06-05,09:52,0,2,2
23,2023-06-05T09:52:00+10:00,2023-06-05,09:52,6,2,8
24,2023-06-05T09:52:00+10:00,2023-06-05,09:52,10,11,21
51,2023-06-05T09:52:00+10:00,2023-06-05,09:52,3,1,4
57,2023-06-05T09:52:00+10:00,2023-06-05,09:52,3,1,4
58,2023-06-05T09:52:00+10:00,2023-06-05,09:52,19,2,21
76,2023-06-05T09:52:00+10:00,2023-06-05,09:52,5,1,6
3,2023-06-05T09:52:00+10:00,2023-06-05,09:52,5,10,15
14,2023-06-05T09:52:00+10:00,2023-06-05,09:52,3,1,4
28,2023-06-05T09:52:00+10:00,2023-06-05,09:52,2,2,4
36,2023-06-05T09:52:00+10:00,2023-06-05,09:52,2,1,3
40,2023-06-05T09:52:00+10:00,2023-06-05,09:52,1,4,5
61,2023-06-05T09:52:00+10:00,2023-06-05,09:52,1,4,5
65,2023-06-05T09:52:00+10:00,2023-06-05,09:52,4,24,28
66,2023-06-05T09:52:00+10:00,2023-06-05,09:52,7,2,9
69,2023-06-05T09:52:00+10:00,2023-06-05,09:52,2,2,4
70,2023-06-05T09:52:00+10:00,2023-06-05,09:52,4,1,5
78,2023-06-05T09:52:00+10:00,2023-06-05,09:52,1,0,1
108,2023-06-05T09:52:00+10:00,2023-06-05,09:52,3,5,8
2,2023-06-05T09:52:00+10:00,2023-06-05,09:52,2,8,10
6,2023-06-05T09:51:00+10:00,2023-06-05,09:51,8,4,12
14,2023-06-05T09:51:00+10:00,2023-06-05,09:51,4,3,7
26,2023-06-05T09:51:00+10:00,2023-06-05,09:51,0,3,3
31,2023-06-05T09:51:00+10:00,2023-06-05,09:51,3,0,3
39,2023-06-05T09:51:00+10:00,2023-06-05,09:51,3,1,4
44,2023-06-05T09:51:00+10:00,2023-06-05,09:51,0,1,1
54,2023-06-05T09:51:00+10:00,2023-06-05,09:51,0,1,1
61,2023-06-05T09:51:00+10:00,2023-06-05,09:51,4,7,11
66,2023-06-05T09:51:00+10:00,2023-06-05,09:51,5,3,8
69,2023-06-05T09:51:00+10:00,2023-06-05,09:51,6,3,9
70,2023-06-05T09:51:00+10:00,2023-06-05,09:51,0,2,2
71,2023-06-05T09:51:00+10:00,2023-06-05,09:51,0,1,1
77,2023-06-05T09:51:00+10:00,2023-06-05,09:51,5,1,6
18,2023-06-05T09:51:00+10:00,2023-06-05,09:51,2,8,10
24,2023-06-05T09:51:00+10:00,2023-06-05,09:51,7,1,8
48,2023-06-05T09:51:00+10:00,2023-06-05,09:51,3,1,4
57,2023-06-05T09:51:00+10:00,2023-06-05,09:51,7,7,14
58,2023-06-05T09:51:00+10:00,2023-06-05,09:51,2,1,3
62,2023-06-05T09:51:00+10:00,2023-06-05,09:51,3,0,3
63,2023-06-05T09:51:00+10:00,2023-06-05,09:51,0,2,2
67,2023-06-05T09:51:00+10:00,2023-06-05,09:51,5,3,8
72,2023-06-05T09:51:00+10:00,2023-06-05,09:51,8,0,8
9,2023-06-05T09:51:00+10:00,2023-06-05,09:51,1,4,5
19,2023-06-05T09:51:00+10:00,2023-06-05,09:51,1,3,4
20,2023-06-05T09:51:00+10:00,2023-06-05,09:51,1,1,2
30,2023-06-05T09:51:00+10:00,2023-06-05,09:51,1,3,4
52,2023-06-05T09:51:00+10:00,2023-06-05,09:51,1,6,7
53,2023-06-05T09:51:00+10:00,2023-06-05,09:51,4,10,14
76,2023-06-05T09:51:00+10:00,2023-06-05,09:51,0,1,1
85,2023-06-05T09:51:00+10:00,2023-06-05,09:51,0,1,1
86,2023-06-05T09:51:00+10:00,2023-06-05,09:51,1,0,1
37,2023-06-05T09:51:00+10:00,2023-06-05,09:51,1,0,1
50,2023-06-05T09:51:00+10:00,2023-06-05,09:51,2,2,4
65,2023-06-05T09:51:00+10:00,2023-06-05,09:51,2,1,3
87,2023-06-05T09:51:00+10:00,2023-06-05,09:51,1,1,2
17,2023-06-05T09:51:00+10:00,2023-06-05,09:51,9,2,11
23,2023-06-05T09:51:00+10:00,2023-06-05,09:51,1,3,4
35,2023-06-05T09:51:00+10:00,2023-06-05,09:51,3,5,8
51,2023-06-05T09:51:00+10:00,2023-06-05,09:51,1,1,2
56,2023-06-05T09:51:00+10:00,2023-06-05,09:51,4,2,6
68,2023-06-05T09:51:00+10:00,2023-06-05,09:51,2,2,4
79,2023-06-05T09:51:00+10:00,2023-06-05,09:51,4,4,8
3,2023-06-05T09:51:00+10:00,2023-06-05,09:51,2,7,9
4,2023-06-05T09:51:00+10:00,2023-06-05,09:51,10,9,19
5,2023-06-05T09:51:00+10:00,2023-06-05,09:51,2,5,7
8,2023-06-05T09:51:00+10:00,2023-06-05,09:51,4,1,5
21,2023-06-05T09:51:00+10:00,2023-06-05,09:51,0,4,4
28,2023-06-05T09:51:00+10:00,2023-06-05,09:51,5,4,9
29,2023-06-05T09:51:00+10:00,2023-06-05,09:51,0,1,1
36,2023-06-05T09:51:00+10:00,2023-06-05,09:51,2,1,3
40,2023-06-05T09:51:00+10:00,2023-06-05,09:51,3,5,8
41,2023-06-05T09:51:00+10:00,2023-06-05,09:51,31,15,46
42,2023-06-05T09:51:00+10:00,2023-06-05,09:51,2,0,2
45,2023-06-05T09:51:00+10:00,2023-06-05,09:51,7,3,10
47,2023-06-05T09:51:00+10:00,2023-06-05,09:51,9,5,14
55,2023-06-05T09:51:00+10:00,2023-06-05,09:51,8,12,20
108,2023-06-05T09:51:00+10:00,2023-06-05,09:51,4,0,4
1,2023-06-05T09:51:00+10:00,2023-06-05,09:51,10,4,14
2,2023-06-05T09:51:00+10:00,2023-06-05,09:51,2,4,6
3,2023-06-05T09:50:00+10:00,2023-06-05,09:50,2,8,10
5,2023-06-05T09:50:00+10:00,2023-06-05,09:50,7,5,12
6,2023-06-05T09:50:00+10:00,2023-06-05,09:50,8,8,16
8,2023-06-05T09:50:00+10:00,2023-06-05,09:50,3,3,6
28,2023-06-05T09:50:00+10:00,2023-06-05,09:50,11,4,15
39,2023-06-05T09:50:00+10:00,2023-06-05,09:50,1,4,5
42,2023-06-05T09:50:00+10:00,2023-06-05,09:50,0,5,5
45,2023-06-05T09:50:00+10:00,2023-06-05,09:50,8,4,12
50,2023-06-05T09:50:00+10:00,2023-06-05,09:50,5,1,6
65,2023-06-05T09:50:00+10:00,2023-06-05,09:50,3,5,8
78,2023-06-05T09:50:00+10:00,2023-06-05,09:50,1,0,1
2,2023-06-05T09:50:00+10:00,2023-06-05,09:50,11,3,14
10,2023-06-05T09:50:00+10:00,2023-06-05,09:50,1,2,3
17,2023-06-05T09:50:00+10:00,2023-06-05,09:50,8,4,12
20,2023-06-05T09:50:00+10:00,2023-06-05,09:50,1,0,1
48,2023-06-05T09:50:00+10:00,2023-06-05,09:50,1,0,1
53,2023-06-05T09:50:00+10:00,2023-06-05,09:50,19,4,23
62,2023-06-05T09:50:00+10:00,2023-06-05,09:50,2,0,2
63,2023-06-05T09:50:00+10:00,2023-06-05,09:50,0,2,2
67,2023-06-05T09:50:00+10:00,2023-06-05,09:50,7,6,13
86,2023-06-05T09:50:00+10:00,2023-06-05,09:50,1,0,1
109,2023-06-05T09:50:00+10:00,2023-06-05,09:50,11,31,42
9,2023-06-05T09:50:00+10:00,2023-06-05,09:50,2,13,15
18,2023-06-05T09:50:00+10:00,2023-06-05,09:50,6,4,10
27,2023-06-05T09:50:00+10:00,2023-06-05,09:50,4,1,5
30,2023-06-05T09:50:00+10:00,2023-06-05,09:50,4,1,5
51,2023-06-05T09:50:00+10:00,2023-06-05,09:50,1,0,1
56,2023-06-05T09:50:00+10:00,2023-06-05,09:50,2,3,5
57,2023-06-05T09:50:00+10:00,2023-06-05,09:50,2,4,6
68,2023-06-05T09:50:00+10:00,2023-06-05,09:50,1,0,1
72,2023-06-05T09:50:00+10:00,2023-06-05,09:50,0,2,2
76,2023-06-05T09:50:00+10:00,2023-06-05,09:50,0,4,4
85,2023-06-05T09:50:00+10:00,2023-06-05,09:50,0,2,2
4,2023-06-05T09:50:00+10:00,2023-06-05,09:50,13,3,16
14,2023-06-05T09:50:00+10:00,2023-06-05,09:50,3,4,7
26,2023-06-05T09:50:00+10:00,2023-06-05,09:50,3,7,10
31,2023-06-05T09:50:00+10:00,2023-06-05,09:50,2,3,5
37,2023-06-05T09:50:00+10:00,2023-06-05,09:50,2,4,6
54,2023-06-05T09:50:00+10:00,2023-06-05,09:50,2,1,3
55,2023-06-05T09:50:00+10:00,2023-06-05,09:50,2,4,6
69,2023-06-05T09:50:00+10:00,2023-06-05,09:50,5,0,5
71,2023-06-05T09:50:00+10:00,2023-06-05,09:50,0,2,2
77,2023-06-05T09:50:00+10:00,2023-06-05,09:50,1,0,1
118,2023-06-05T09:50:00+10:00,2023-06-05,09:50,1,1,2
1,2023-06-05T09:50:00+10:00,2023-06-05,09:50,5,3,8
11,2023-06-05T09:50:00+10:00,2023-06-05,09:50,1,0,1
12,2023-06-05T09:50:00+10:00,2023-06-05,09:50,1,1,2
23,2023-06-05T09:50:00+10:00,2023-06-05,09:50,5,0,5
24,2023-06-05T09:50:00+10:00,2023-06-05,09:50,19,1,20
35,2023-06-05T09:50:00+10:00,2023-06-05,09:50,3,8,11
52,2023-06-05T09:50:00+10:00,2023-06-05,09:50,3,1,4
58,2023-06-05T09:50:00+10:00,2023-06-05,09:50,8,3,11
79,2023-06-05T09:50:00+10:00,2023-06-05,09:50,1,1,2
117,2023-06-05T09:50:00+10:00,2023-06-05,09:50,13,8,21
21,2023-06-05T09:50:00+10:00,2023-06-05,09:50,7,3,10
36,2023-06-05T09:50:00+10:00,2023-06-05,09:50,3,4,7
40,2023-06-05T09:50:00+10:00,2023-06-05,09:50,2,3,5
41,2023-06-05T09:50:00+10:00,2023-06-05,09:50,39,10,49
44,2023-06-05T09:50:00+10:00,2023-06-05,09:50,0,1,1
47,2023-06-05T09:50:00+10:00,2023-06-05,09:50,6,12,18
59,2023-06-05T09:50:00+10:00,2023-06-05,09:50,53,22,75
61,2023-06-05T09:50:00+10:00,2023-06-05,09:50,0,5,5
66,2023-06-05T09:50:00+10:00,2023-06-05,09:50,4,11,15
70,2023-06-05T09:50:00+10:00,2023-06-05,09:50,2,2,4
84,2023-06-05T09:50:00+10:00,2023-06-05,09:50,52,26,78
87,2023-06-05T09:50:00+10:00,2023-06-05,09:50,0,1,1
107,2023-06-05T09:50:00+10:00,2023-06-05,09:50,1,21,22
108,2023-06-05T09:50:00+10:00,2023-06-05,09:50,4,3,7
4,2023-06-05T09:49:00+10:00,2023-06-05,09:49,27,4,31
8,2023-06-05T09:49:00+10:00,2023-06-05,09:49,1,2,3
26,2023-06-05T09:49:00+10:00,2023-06-05,09:49,3,1,4
31,2023-06-05T09:49:00+10:00,2023-06-05,09:49,2,0,2
41,2023-06-05T09:49:00+10:00,2023-06-05,09:49,21,5,26
65,2023-06-05T09:49:00+10:00,2023-06-05,09:49,3,19,22
70,2023-06-05T09:49:00+10:00,2023-06-05,09:49,2,0,2
75,2023-06-05T09:49:00+10:00,2023-06-05,09:49,0,1,1
77,2023-06-05T09:49:00+10:00,2023-06-05,09:49,1,3,4
87,2023-06-05T09:49:00+10:00,2023-06-05,09:49,1,0,1
108,2023-06-05T09:49:00+10:00,2023-06-05,09:49,4,7,11
1,2023-06-05T09:49:00+10:00,2023-06-05,09:49,5,6,11
10,2023-06-05T09:49:00+10:00,2023-06-05,09:49,0,3,3
17,2023-06-05T09:49:00+10:00,2023-06-05,09:49,3,10,13
46,2023-06-05T09:49:00+10:00,2023-06-05,09:49,0,3,3
51,2023-06-05T09:49:00+10:00,2023-06-05,09:49,1,0,1
52,2023-06-05T09:49:00+10:00,2023-06-05,09:49,4,4,8
56,2023-06-05T09:49:00+10:00,2023-06-05,09:49,1,0,1
58,2023-06-05T09:49:00+10:00,2023-06-05,09:49,8,6,14
79,2023-06-05T09:49:00+10:00,2023-06-05,09:49,4,6,10
9,2023-06-05T09:49:00+10:00,2023-06-05,09:49,0,11,11
12,2023-06-05T09:49:00+10:00,2023-06-05,09:49,1,1,2
19,2023-06-05T09:49:00+10:00,2023-06-05,09:49,2,2,4
20,2023-06-05T09:49:00+10:00,2023-06-05,09:49,0,1,1
35,2023-06-05T09:49:00+10:00,2023-06-05,09:49,7,7,14
62,2023-06-05T09:49:00+10:00,2023-06-05,09:49,1,1,2
63,2023-06-05T09:49:00+10:00,2023-06-05,09:49,3,8,11
68,2023-06-05T09:49:00+10:00,2023-06-05,09:49,5,2,7
5,2023-06-05T09:49:00+10:00,2023-06-05,09:49,2,6,8
6,2023-06-05T09:49:00+10:00,2023-06-05,09:49,9,2,11
36,2023-06-05T09:49:00+10:00,2023-06-05,09:49,0,7,7
39,2023-06-05T09:49:00+10:00,2023-06-05,09:49,2,1,3
40,2023-06-05T09:49:00+10:00,2023-06-05,09:49,1,1,2
47,2023-06-05T09:49:00+10:00,2023-06-05,09:49,2,8,10
55,2023-06-05T09:49:00+10:00,2023-06-05,09:49,8,3,11
66,2023-06-05T09:49:00+10:00,2023-06-05,09:49,8,3,11
69,2023-06-05T09:49:00+10:00,2023-06-05,09:49,4,0,4
18,2023-06-05T09:49:00+10:00,2023-06-05,09:49,4,9,13
23,2023-06-05T09:49:00+10:00,2023-06-05,09:49,10,0,10
24,2023-06-05T09:49:00+10:00,2023-06-05,09:49,1,11,12
30,2023-06-05T09:49:00+10:00,2023-06-05,09:49,0,1,1
48,2023-06-05T09:49:00+10:00,2023-06-05,09:49,3,2,5
53,2023-06-05T09:49:00+10:00,2023-06-05,09:49,10,4,14
57,2023-06-05T09:49:00+10:00,2023-06-05,09:49,1,6,7
67,2023-06-05T09:49:00+10:00,2023-06-05,09:49,10,13,23
72,2023-06-05T09:49:00+10:00,2023-06-05,09:49,0,2,2
85,2023-06-05T09:49:00+10:00,2023-06-05,09:49,2,0,2
86,2023-06-05T09:49:00+10:00,2023-06-05,09:49,1,0,1
3,2023-06-05T09:49:00+10:00,2023-06-05,09:49,6,8,14
14,2023-06-05T09:49:00+10:00,2023-06-05,09:49,3,0,3
21,2023-06-05T09:49:00+10:00,2023-06-05,09:49,1,2,3
28,2023-06-05T09:49:00+10:00,2023-06-05,09:49,5,3,8
29,2023-06-05T09:49:00+10:00,2023-06-05,09:49,0,2,2
45,2023-06-05T09:49:00+10:00,2023-06-05,09:49,1,9,10
50,2023-06-05T09:49:00+10:00,2023-06-05,09:49,2,2,4
61,2023-06-05T09:49:00+10:00,2023-06-05,09:49,4,3,7
2,2023-06-05T09:49:00+10:00,2023-06-05,09:49,2,2,4
28,2023-06-05T09:48:00+10:00,2023-06-05,09:48,3,3,6
40,2023-06-05T09:48:00+10:00,2023-06-05,09:48,1,2,3
42,2023-06-05T09:48:00+10:00,2023-06-05,09:48,0,1,1
47,2023-06-05T09:48:00+10:00,2023-06-05,09:48,6,12,18
54,2023-06-05T09:48:00+10:00,2023-06-05,09:48,2,1,3
55,2023-06-05T09:48:00+10:00,2023-06-05,09:48,8,10,18
61,2023-06-05T09:48:00+10:00,2023-06-05,09:48,3,5,8
71,2023-06-05T09:48:00+10:00,2023-06-05,09:48,1,2,3
1,2023-06-05T09:48:00+10:00,2023-06-05,09:48,3,7,10
11,2023-06-05T09:48:00+10:00,2023-06-05,09:48,0,1,1
18,2023-06-05T09:48:00+10:00,2023-06-05,09:48,5,3,8
20,2023-06-05T09:48:00+10:00,2023-06-05,09:48,0,2,2
23,2023-06-05T09:48:00+10:00,2023-06-05,09:48,5,9,14
24,2023-06-05T09:48:00+10:00,2023-06-05,09:48,28,1,29
30,2023-06-05T09:48:00+10:00,2023-06-05,09:48,0,1,1
56,2023-06-05T09:48:00+10:00,2023-06-05,09:48,2,0,2
76,2023-06-05T09:48:00+10:00,2023-06-05,09:48,1,1,2
85,2023-06-05T09:48:00+10:00,2023-06-05,09:48,0,1,1
10,2023-06-05T09:48:00+10:00,2023-06-05,09:48,0,3,3
35,2023-06-05T09:48:00+10:00,2023-06-05,09:48,8,9,17
48,2023-06-05T09:48:00+10:00,2023-06-05,09:48,5,0,5
51,2023-06-05T09:48:00+10:00,2023-06-05,09:48,2,1,3
53,2023-06-05T09:48:00+10:00,2023-06-05,09:48,5,7,12
63,2023-06-05T09:48:00+10:00,2023-06-05,09:48,6,7,13
67,2023-06-05T09:48:00+10:00,2023-06-05,09:48,3,4,7
72,2023-06-05T09:48:00+10:00,2023-06-05,09:48,5,0,5
4,2023-06-05T09:48:00+10:00,2023-06-05,09:48,17,5,22
6,2023-06-05T09:48:00+10:00,2023-06-05,09:48,3,4,7
14,2023-06-05T09:48:00+10:00,2023-06-05,09:48,2,1,3
36,2023-06-05T09:48:00+10:00,2023-06-05,09:48,3,2,5
39,2023-06-05T09:48:00+10:00,2023-06-05,09:48,4,0,4
41,2023-06-05T09:48:00+10:00,2023-06-05,09:48,15,9,24
50,2023-06-05T09:48:00+10:00,2023-06-05,09:48,1,4,5
65,2023-06-05T09:48:00+10:00,2023-06-05,09:48,17,1,18
66,2023-06-05T09:48:00+10:00,2023-06-05,09:48,3,7,10
69,2023-06-05T09:48:00+10:00,2023-06-05,09:48,3,0,3
75,2023-06-05T09:48:00+10:00,2023-06-05,09:48,1,0,1
87,2023-06-05T09:48:00+10:00,2023-06-05,09:48,1,2,3
2,2023-06-05T09:48:00+10:00,2023-06-05,09:48,1,6,7
9,2023-06-05T09:48:00+10:00,2023-06-05,09:48,3,14,17
17,2023-06-05T09:48:00+10:00,2023-06-05,09:48,6,4,10
19,2023-06-05T09:48:00+10:00,2023-06-05,09:48,1,3,4
27,2023-06-05T09:48:00+10:00,2023-06-05,09:48,0,1,1
46,2023-06-05T09:48:00+10:00,2023-06-05,09:48,0,1,1
52,2023-06-05T09:48:00+10:00,2023-06-05,09:48,2,1,3
57,2023-06-05T09:48:00+10:00,2023-06-05,09:48,8,3,11
58,2023-06-05T09:48:00+10:00,2023-06-05,09:48,14,4,18
62,2023-06-05T09:48:00+10:00,2023-06-05,09:48,0,2,2
68,2023-06-05T09:48:00+10:00,2023-06-05,09:48,2,0,2
79,2023-06-05T09:48:00+10:00,2023-06-05,09:48,3,6,9
3,2023-06-05T09:48:00+10:00,2023-06-05,09:48,7,5,12
5,2023-06-05T09:48:00+10:00,2023-06-05,09:48,1,9,10
8,2023-06-05T09:48:00+10:00,2023-06-05,09:48,0,1,1
21,2023-06-05T09:48:00+10:00,2023-06-05,09:48,5,2,7
26,2023-06-05T09:48:00+10:00,2023-06-05,09:48,1,2,3
29,2023-06-05T09:48:00+10:00,2023-06-05,09:48,1,0,1
31,2023-06-05T09:48:00+10:00,2023-06-05,09:48,3,0,3
45,2023-06-05T09:48:00+10:00,2023-06-05,09:48,0,3,3
70,2023-06-05T09:48:00+10:00,2023-06-05,09:48,2,1,3
77,2023-06-05T09:48:00+10:00,2023-06-05,09:48,2,0,2
108,2023-06-05T09:48:00+10:00,2023-06-05,09:48,6,3,9
3,2023-06-05T09:47:00+10:00,2023-06-05,09:47,3,8,11
6,2023-06-05T09:47:00+10:00,2023-06-05,09:47,4,7,11
28,2023-06-05T09:47:00+10:00,2023-06-05,09:47,8,4,12
39,2023-06-05T09:47:00+10:00,2023-06-05,09:47,1,0,1
40,2023-06-05T09:47:00+10:00,2023-06-05,09:47,3,1,4
41,2023-06-05T09:47:00+10:00,2023-06-05,09:47,8,4,12
47,2023-06-05T09:47:00+10:00,2023-06-05,09:47,4,2,6
65,2023-06-05T09:47:00+10:00,2023-06-05,09:47,3,7,10
69,2023-06-05T09:47:00+10:00,2023-06-05,09:47,4,1,5
75,2023-06-05T09:47:00+10:00,2023-06-05,09:47,1,1,2
87,2023-06-05T09:47:00+10:00,2023-06-05,09:47,0,1,1
108,2023-06-05T09:47:00+10:00,2023-06-05,09:47,4,3,7
19,2023-06-05T09:47:00+10:00,2023-06-05,09:47,1,1,2
20,2023-06-05T09:47:00+10:00,2023-06-05,09:47,1,2,3
23,2023-06-05T09:47:00+10:00,2023-06-05,09:47,3,0,3
27,2023-06-05T09:47:00+10:00,2023-06-05,09:47,0,3,3
62,2023-06-05T09:47:00+10:00,2023-06-05,09:47,0,4,4
63,2023-06-05T09:47:00+10:00,2023-06-05,09:47,3,3,6
68,2023-06-05T09:47:00+10:00,2023-06-05,09:47,5,1,6
79,2023-06-05T09:47:00+10:00,2023-06-05,09:47,4,5,9
85,2023-06-05T09:47:00+10:00,2023-06-05,09:47,1,3,4
11,2023-06-05T09:47:00+10:00,2023-06-05,09:47,0,2,2
17,2023-06-05T09:47:00+10:00,2023-06-05,09:47,6,5,11
18,2023-06-05T09:47:00+10:00,2023-06-05,09:47,2,2,4
35,2023-06-05T09:47:00+10:00,2023-06-05,09:47,5,6,11
46,2023-06-05T09:47:00+10:00,2023-06-05,09:47,0,1,1
49,2023-06-05T09:47:00+10:00,2023-06-05,09:47,2,3,5
52,2023-06-05T09:47:00+10:00,2023-06-05,09:47,7,0,7
67,2023-06-05T09:47:00+10:00,2023-06-05,09:47,6,4,10
76,2023-06-05T09:47:00+10:00,2023-06-05,09:47,2,1,3
86,2023-06-05T09:47:00+10:00,2023-06-05,09:47,0,1,1
5,2023-06-05T09:47:00+10:00,2023-06-05,09:47,6,12,18
8,2023-06-05T09:47:00+10:00,2023-06-05,09:47,4,3,7
14,2023-06-05T09:47:00+10:00,2023-06-05,09:47,3,2,5
21,2023-06-05T09:47:00+10:00,2023-06-05,09:47,1,3,4
42,2023-06-05T09:47:00+10:00,2023-06-05,09:47,1,1,2
45,2023-06-05T09:47:00+10:00,2023-06-05,09:47,7,9,16
54,2023-06-05T09:47:00+10:00,2023-06-05,09:47,1,3,4
55,2023-06-05T09:47:00+10:00,2023-06-05,09:47,4,11,15
77,2023-06-05T09:47:00+10:00,2023-06-05,09:47,2,0,2
78,2023-06-05T09:47:00+10:00,2023-06-05,09:47,2,0,2
1,2023-06-05T09:47:00+10:00,2023-06-05,09:47,3,12,15
2,2023-06-05T09:47:00+10:00,2023-06-05,09:47,6,15,21
9,2023-06-05T09:47:00+10:00,2023-06-05,09:47,1,3,4
10,2023-06-05T09:47:00+10:00,2023-06-05,09:47,0,1,1
24,2023-06-05T09:47:00+10:00,2023-06-05,09:47,4,10,14
30,2023-06-05T09:47:00+10:00,2023-06-05,09:47,0,1,1
48,2023-06-05T09:47:00+10:00,2023-06-05,09:47,2,1,3
53,2023-06-05T09:47:00+10:00,2023-06-05,09:47,4,7,11
56,2023-06-05T09:47:00+10:00,2023-06-05,09:47,6,0,6
57,2023-06-05T09:47:00+10:00,2023-06-05,09:47,0,4,4
58,2023-06-05T09:47:00+10:00,2023-06-05,09:47,6,0,6
72,2023-06-05T09:47:00+10:00,2023-06-05,09:47,1,1,2
4,2023-06-05T09:47:00+10:00,2023-06-05,09:47,11,9,20
26,2023-06-05T09:47:00+10:00,2023-06-05,09:47,4,7,11
29,2023-06-05T09:47:00+10:00,2023-06-05,09:47,5,0,5
31,2023-06-05T09:47:00+10:00,2023-06-05,09:47,2,0,2
36,2023-06-05T09:47:00+10:00,2023-06-05,09:47,5,2,7
50,2023-06-05T09:47:00+10:00,2023-06-05,09:47,3,1,4
61,2023-06-05T09:47:00+10:00,2023-06-05,09:47,5,0,5
66,2023-06-05T09:47:00+10:00,2023-06-05,09:47,1,7,8
70,2023-06-05T09:47:00+10:00,2023-06-05,09:47,2,0,2
3,2023-06-05T09:46:00+10:00,2023-06-05,09:46,5,5,10
14,2023-06-05T09:46:00+10:00,2023-06-05,09:46,5,6,11
21,2023-06-05T09:46:00+10:00,2023-06-05,09:46,7,2,9
28,2023-06-05T09:46:00+10:00,2023-06-05,09:46,2,1,3
42,2023-06-05T09:46:00+10:00,2023-06-05,09:46,6,0,6
47,2023-06-05T09:46:00+10:00,2023-06-05,09:46,5,6,11
65,2023-06-05T09:46:00+10:00,2023-06-05,09:46,4,2,6
66,2023-06-05T09:46:00+10:00,2023-06-05,09:46,6,1,7
70,2023-06-05T09:46:00+10:00,2023-06-05,09:46,1,1,2
9,2023-06-05T09:46:00+10:00,2023-06-05,09:46,0,12,12
20,2023-06-05T09:46:00+10:00,2023-06-05,09:46,5,3,8
23,2023-06-05T09:46:00+10:00,2023-06-05,09:46,4,4,8
24,2023-06-05T09:46:00+10:00,2023-06-05,09:46,13,9,22
27,2023-06-05T09:46:00+10:00,2023-06-05,09:46,0,2,2
46,2023-06-05T09:46:00+10:00,2023-06-05,09:46,1,0,1
48,2023-06-05T09:46:00+10:00,2023-06-05,09:46,2,2,4
51,2023-06-05T09:46:00+10:00,2023-06-05,09:46,0,2,2
52,2023-06-05T09:46:00+10:00,2023-06-05,09:46,2,3,5
53,2023-06-05T09:46:00+10:00,2023-06-05,09:46,14,7,21
58,2023-06-05T09:46:00+10:00,2023-06-05,09:46,4,0,4
76,2023-06-05T09:46:00+10:00,2023-06-05,09:46,6,1,7
86,2023-06-05T09:46:00+10:00,2023-06-05,09:46,0,2,2
12,2023-06-05T09:46:00+10:00,2023-06-05,09:46,2,5,7
17,2023-06-05T09:46:00+10:00,2023-06-05,09:46,7,0,7
30,2023-06-05T09:46:00+10:00,2023-06-05,09:46,1,2,3
56,2023-06-05T09:46:00+10:00,2023-06-05,09:46,5,0,5
57,2023-06-05T09:46:00+10:00,2023-06-05,09:46,3,0,3
62,2023-06-05T09:46:00+10:00,2023-06-05,09:46,2,5,7
63,2023-06-05T09:46:00+10:00,2023-06-05,09:46,2,0,2
79,2023-06-05T09:46:00+10:00,2023-06-05,09:46,8,10,18
85,2023-06-05T09:46:00+10:00,2023-06-05,09:46,0,2,2
6,2023-06-05T09:46:00+10:00,2023-06-05,09:46,6,11,17
8,2023-06-05T09:46:00+10:00,2023-06-05,09:46,0,2,2
31,2023-06-05T09:46:00+10:00,2023-06-05,09:46,4,0,4
41,2023-06-05T09:46:00+10:00,2023-06-05,09:46,25,5,30
45,2023-06-05T09:46:00+10:00,2023-06-05,09:46,9,3,12
54,2023-06-05T09:46:00+10:00,2023-06-05,09:46,2,0,2
55,2023-06-05T09:46:00+10:00,2023-06-05,09:46,6,3,9
69,2023-06-05T09:46:00+10:00,2023-06-05,09:46,1,7,8
71,2023-06-05T09:46:00+10:00,2023-06-05,09:46,0,1,1
78,2023-06-05T09:46:00+10:00,2023-06-05,09:46,0,1,1
1,2023-06-05T09:46:00+10:00,2023-06-05,09:46,5,5,10
2,2023-06-05T09:46:00+10:00,2023-06-05,09:46,2,8,10
10,2023-06-05T09:46:00+10:00,2023-06-05,09:46,3,0,3
18,2023-06-05T09:46:00+10:00,2023-06-05,09:46,0,4,4
19,2023-06-05T09:46:00+10:00,2023-06-05,09:46,1,1,2
35,2023-06-05T09:46:00+10:00,2023-06-05,09:46,1,6,7
49,2023-06-05T09:46:00+10:00,2023-06-05,09:46,1,4,5
67,2023-06-05T09:46:00+10:00,2023-06-05,09:46,9,9,18
4,2023-06-05T09:46:00+10:00,2023-06-05,09:46,14,8,22
5,2023-06-05T09:46:00+10:00,2023-06-05,09:46,5,11,16
26,2023-06-05T09:46:00+10:00,2023-06-05,09:46,4,2,6
36,2023-06-05T09:46:00+10:00,2023-06-05,09:46,2,3,5
39,2023-06-05T09:46:00+10:00,2023-06-05,09:46,2,3,5
50,2023-06-05T09:46:00+10:00,2023-06-05,09:46,3,2,5
61,2023-06-05T09:46:00+10:00,2023-06-05,09:46,1,8,9
75,2023-06-05T09:46:00+10:00,2023-06-05,09:46,0,1,1
77,2023-06-05T09:46:00+10:00,2023-06-05,09:46,1,4,5
87,2023-06-05T09:46:00+10:00,2023-06-05,09:46,1,0,1
108,2023-06-05T09:46:00+10:00,2023-06-05,09:46,0,10,10
5,2023-06-05T09:45:00+10:00,2023-06-05,09:45,3,7,10
6,2023-06-05T09:45:00+10:00,2023-06-05,09:45,12,0,12
21,2023-06-05T09:45:00+10:00,2023-06-05,09:45,0,2,2
40,2023-06-05T09:45:00+10:00,2023-06-05,09:45,1,5,6
42,2023-06-05T09:45:00+10:00,2023-06-05,09:45,0,4,4
45,2023-06-05T09:45:00+10:00,2023-06-05,09:45,14,0,14
59,2023-06-05T09:45:00+10:00,2023-06-05,09:45,59,28,87
70,2023-06-05T09:45:00+10:00,2023-06-05,09:45,0,2,2
77,2023-06-05T09:45:00+10:00,2023-06-05,09:45,0,1,1
107,2023-06-05T09:45:00+10:00,2023-06-05,09:45,3,13,16
2,2023-06-05T09:45:00+10:00,2023-06-05,09:45,1,10,11
9,2023-06-05T09:45:00+10:00,2023-06-05,09:45,1,18,19
51,2023-06-05T09:45:00+10:00,2023-06-05,09:45,2,1,3
52,2023-06-05T09:45:00+10:00,2023-06-05,09:45,2,6,8
57,2023-06-05T09:45:00+10:00,2023-06-05,09:45,2,17,19
62,2023-06-05T09:45:00+10:00,2023-06-05,09:45,2,0,2
63,2023-06-05T09:45:00+10:00,2023-06-05,09:45,1,8,9
68,2023-06-05T09:45:00+10:00,2023-06-05,09:45,2,2,4
79,2023-06-05T09:45:00+10:00,2023-06-05,09:45,10,3,13
117,2023-06-05T09:45:00+10:00,2023-06-05,09:45,9,14,23
10,2023-06-05T09:45:00+10:00,2023-06-05,09:45,6,2,8
12,2023-06-05T09:45:00+10:00,2023-06-05,09:45,0,2,2
18,2023-06-05T09:45:00+10:00,2023-06-05,09:45,3,3,6
20,2023-06-05T09:45:00+10:00,2023-06-05,09:45,1,0,1
23,2023-06-05T09:45:00+10:00,2023-06-05,09:45,4,3,7
24,2023-06-05T09:45:00+10:00,2023-06-05,09:45,14,7,21
35,2023-06-05T09:45:00+10:00,2023-06-05,09:45,3,9,12
48,2023-06-05T09:45:00+10:00,2023-06-05,09:45,2,1,3
53,2023-06-05T09:45:00+10:00,2023-06-05,09:45,2,4,6
58,2023-06-05T09:45:00+10:00,2023-06-05,09:45,16,7,23
67,2023-06-05T09:45:00+10:00,2023-06-05,09:45,7,3,10
72,2023-06-05T09:45:00+10:00,2023-06-05,09:45,4,2,6
76,2023-06-05T09:45:00+10:00,2023-06-05,09:45,4,2,6
26,2023-06-05T09:45:00+10:00,2023-06-05,09:45,3,3,6
28,2023-06-05T09:45:00+10:00,2023-06-05,09:45,9,1,10
37,2023-06-05T09:45:00+10:00,2023-06-05,09:45,0,1,1
41,2023-06-05T09:45:00+10:00,2023-06-05,09:45,21,5,26
47,2023-06-05T09:45:00+10:00,2023-06-05,09:45,4,5,9
55,2023-06-05T09:45:00+10:00,2023-06-05,09:45,2,7,9
78,2023-06-05T09:45:00+10:00,2023-06-05,09:45,1,0,1
87,2023-06-05T09:45:00+10:00,2023-06-05,09:45,1,1,2
108,2023-06-05T09:45:00+10:00,2023-06-05,09:45,4,5,9
1,2023-06-05T09:45:00+10:00,2023-06-05,09:45,10,4,14
11,2023-06-05T09:45:00+10:00,2023-06-05,09:45,3,1,4
17,2023-06-05T09:45:00+10:00,2023-06-05,09:45,6,9,15
19,2023-06-05T09:45:00+10:00,2023-06-05,09:45,0,1,1
27,2023-06-05T09:45:00+10:00,2023-06-05,09:45,0,4,4
49,2023-06-05T09:45:00+10:00,2023-06-05,09:45,0,1,1
56,2023-06-05T09:45:00+10:00,2023-06-05,09:45,1,2,3
86,2023-06-05T09:45:00+10:00,2023-06-05,09:45,2,0,2
109,2023-06-05T09:45:00+10:00,2023-06-05,09:45,6,26,32
3,2023-06-05T09:45:00+10:00,2023-06-05,09:45,6,4,10
4,2023-06-05T09:45:00+10:00,2023-06-05,09:45,22,4,26
8,2023-06-05T09:45:00+10:00,2023-06-05,09:45,3,1,4
14,2023-06-05T09:45:00+10:00,2023-06-05,09:45,3,1,4
36,2023-06-05T09:45:00+10:00,2023-06-05,09:45,2,6,8
39,2023-06-05T09:45:00+10:00,2023-06-05,09:45,0,2,2
54,2023-06-05T09:45:00+10:00,2023-06-05,09:45,1,1,2
61,2023-06-05T09:45:00+10:00,2023-06-05,09:45,4,5,9
65,2023-06-05T09:45:00+10:00,2023-06-05,09:45,5,0,5
66,2023-06-05T09:45:00+10:00,2023-06-05,09:45,5,4,9
84,2023-06-05T09:45:00+10:00,2023-06-05,09:45,69,26,95
4,2023-06-05T09:44:00+10:00,2023-06-05,09:44,14,9,23
14,2023-06-05T09:44:00+10:00,2023-06-05,09:44,1,1,2
40,2023-06-05T09:44:00+10:00,2023-06-05,09:44,1,2,3
41,2023-06-05T09:44:00+10:00,2023-06-05,09:44,40,5,45
50,2023-06-05T09:44:00+10:00,2023-06-05,09:44,6,0,6
54,2023-06-05T09:44:00+10:00,2023-06-05,09:44,2,2,4
66,2023-06-05T09:44:00+10:00,2023-06-05,09:44,6,5,11
108,2023-06-05T09:44:00+10:00,2023-06-05,09:44,3,8,11
12,2023-06-05T09:44:00+10:00,2023-06-05,09:44,5,0,5
18,2023-06-05T09:44:00+10:00,2023-06-05,09:44,1,2,3
19,2023-06-05T09:44:00+10:00,2023-06-05,09:44,1,2,3
23,2023-06-05T09:44:00+10:00,2023-06-05,09:44,3,1,4
24,2023-06-05T09:44:00+10:00,2023-06-05,09:44,1,7,8
27,2023-06-05T09:44:00+10:00,2023-06-05,09:44,1,1,2
51,2023-06-05T09:44:00+10:00,2023-06-05,09:44,2,0,2
56,2023-06-05T09:44:00+10:00,2023-06-05,09:44,0,2,2
63,2023-06-05T09:44:00+10:00,2023-06-05,09:44,6,8,14
67,2023-06-05T09:44:00+10:00,2023-06-05,09:44,5,6,11
9,2023-06-05T09:44:00+10:00,2023-06-05,09:44,1,18,19
10,2023-06-05T09:44:00+10:00,2023-06-05,09:44,0,1,1
17,2023-06-05T09:44:00+10:00,2023-06-05,09:44,10,3,13
20,2023-06-05T09:44:00+10:00,2023-06-05,09:44,1,3,4
30,2023-06-05T09:44:00+10:00,2023-06-05,09:44,1,4,5
49,2023-06-05T09:44:00+10:00,2023-06-05,09:44,1,0,1
52,2023-06-05T09:44:00+10:00,2023-06-05,09:44,1,1,2
53,2023-06-05T09:44:00+10:00,2023-06-05,09:44,10,7,17
57,2023-06-05T09:44:00+10:00,2023-06-05,09:44,7,9,16
58,2023-06-05T09:44:00+10:00,2023-06-05,09:44,3,4,7
72,2023-06-05T09:44:00+10:00,2023-06-05,09:44,4,1,5
76,2023-06-05T09:44:00+10:00,2023-06-05,09:44,1,0,1
3,2023-06-05T09:44:00+10:00,2023-06-05,09:44,3,5,8
6,2023-06-05T09:44:00+10:00,2023-06-05,09:44,5,8,13
8,2023-06-05T09:44:00+10:00,2023-06-05,09:44,1,1,2
21,2023-06-05T09:44:00+10:00,2023-06-05,09:44,0,3,3
29,2023-06-05T09:44:00+10:00,2023-06-05,09:44,0,4,4
36,2023-06-05T09:44:00+10:00,2023-06-05,09:44,3,0,3
47,2023-06-05T09:44:00+10:00,2023-06-05,09:44,8,4,12
55,2023-06-05T09:44:00+10:00,2023-06-05,09:44,2,13,15
61,2023-06-05T09:44:00+10:00,2023-06-05,09:44,2,5,7
70,2023-06-05T09:44:00+10:00,2023-06-05,09:44,1,1,2
77,2023-06-05T09:44:00+10:00,2023-06-05,09:44,1,1,2
87,2023-06-05T09:44:00+10:00,2023-06-05,09:44,3,1,4
1,2023-06-05T09:44:00+10:00,2023-06-05,09:44,11,7,18
2,2023-06-05T09:44:00+10:00,2023-06-05,09:44,6,2,8
35,2023-06-05T09:44:00+10:00,2023-06-05,09:44,6,7,13
46,2023-06-05T09:44:00+10:00,2023-06-05,09:44,1,1,2
48,2023-06-05T09:44:00+10:00,2023-06-05,09:44,2,1,3
62,2023-06-05T09:44:00+10:00,2023-06-05,09:44,1,5,6
68,2023-06-05T09:44:00+10:00,2023-06-05,09:44,1,0,1
79,2023-06-05T09:44:00+10:00,2023-06-05,09:44,2,6,8
85,2023-06-05T09:44:00+10:00,2023-06-05,09:44,0,2,2
5,2023-06-05T09:44:00+10:00,2023-06-05,09:44,3,9,12
26,2023-06-05T09:44:00+10:00,2023-06-05,09:44,8,2,10
28,2023-06-05T09:44:00+10:00,2023-06-05,09:44,11,2,13
39,2023-06-05T09:44:00+10:00,2023-06-05,09:44,2,2,4
42,2023-06-05T09:44:00+10:00,2023-06-05,09:44,3,0,3
45,2023-06-05T09:44:00+10:00,2023-06-05,09:44,3,7,10
65,2023-06-05T09:44:00+10:00,2023-06-05,09:44,9,0,9
69,2023-06-05T09:44:00+10:00,2023-06-05,09:44,3,0,3
5,2023-06-05T09:43:00+10:00,2023-06-05,09:43,2,2,4
14,2023-06-05T09:43:00+10:00,2023-06-05,09:43,5,2,7
21,2023-06-05T09:43:00+10:00,2023-06-05,09:43,0,3,3
36,2023-06-05T09:43:00+10:00,2023-06-05,09:43,3,3,6
39,2023-06-05T09:43:00+10:00,2023-06-05,09:43,0,1,1
40,2023-06-05T09:43:00+10:00,2023-06-05,09:43,0,5,5
41,2023-06-05T09:43:00+10:00,2023-06-05,09:43,25,6,31
42,2023-06-05T09:43:00+10:00,2023-06-05,09:43,0,1,1
50,2023-06-05T09:43:00+10:00,2023-06-05,09:43,0,3,3
55,2023-06-05T09:43:00+10:00,2023-06-05,09:43,6,3,9
70,2023-06-05T09:43:00+10:00,2023-06-05,09:43,1,1,2
71,2023-06-05T09:43:00+10:00,2023-06-05,09:43,0,1,1
77,2023-06-05T09:43:00+10:00,2023-06-05,09:43,4,0,4
1,2023-06-05T09:43:00+10:00,2023-06-05,09:43,4,3,7
2,2023-06-05T09:43:00+10:00,2023-06-05,09:43,1,4,5
17,2023-06-05T09:43:00+10:00,2023-06-05,09:43,5,6,11
18,2023-06-05T09:43:00+10:00,2023-06-05,09:43,4,6,10
23,2023-06-05T09:43:00+10:00,2023-06-05,09:43,4,2,6
35,2023-06-05T09:43:00+10:00,2023-06-05,09:43,4,6,10
46,2023-06-05T09:43:00+10:00,2023-06-05,09:43,7,1,8
68,2023-06-05T09:43:00+10:00,2023-06-05,09:43,3,2,5
79,2023-06-05T09:43:00+10:00,2023-06-05,09:43,3,9,12
10,2023-06-05T09:43:00+10:00,2023-06-05,09:43,2,0,2
12,2023-06-05T09:43:00+10:00,2023-06-05,09:43,1,1,2
19,2023-06-05T09:43:00+10:00,2023-06-05,09:43,1,2,3
30,2023-06-05T09:43:00+10:00,2023-06-05,09:43,0,3,3
53,2023-06-05T09:43:00+10:00,2023-06-05,09:43,9,2,11
63,2023-06-05T09:43:00+10:00,2023-06-05,09:43,2,7,9
67,2023-06-05T09:43:00+10:00,2023-06-05,09:43,8,8,16
85,2023-06-05T09:43:00+10:00,2023-06-05,09:43,1,0,1
86,2023-06-05T09:43:00+10:00,2023-06-05,09:43,2,0,2
4,2023-06-05T09:43:00+10:00,2023-06-05,09:43,8,13,21
8,2023-06-05T09:43:00+10:00,2023-06-05,09:43,2,0,2
28,2023-06-05T09:43:00+10:00,2023-06-05,09:43,10,3,13
29,2023-06-05T09:43:00+10:00,2023-06-05,09:43,0,1,1
47,2023-06-05T09:43:00+10:00,2023-06-05,09:43,2,5,7
65,2023-06-05T09:43:00+10:00,2023-06-05,09:43,3,2,5
69,2023-06-05T09:43:00+10:00,2023-06-05,09:43,7,0,7
75,2023-06-05T09:43:00+10:00,2023-06-05,09:43,1,1,2
9,2023-06-05T09:43:00+10:00,2023-06-05,09:43,1,6,7
24,2023-06-05T09:43:00+10:00,2023-06-05,09:43,19,1,20
27,2023-06-05T09:43:00+10:00,2023-06-05,09:43,1,0,1
48,2023-06-05T09:43:00+10:00,2023-06-05,09:43,3,0,3
49,2023-06-05T09:43:00+10:00,2023-06-05,09:43,1,5,6
56,2023-06-05T09:43:00+10:00,2023-06-05,09:43,1,1,2
57,2023-06-05T09:43:00+10:00,2023-06-05,09:43,0,5,5
58,2023-06-05T09:43:00+10:00,2023-06-05,09:43,18,5,23
62,2023-06-05T09:43:00+10:00,2023-06-05,09:43,1,0,1
72,2023-06-05T09:43:00+10:00,2023-06-05,09:43,7,1,8
76,2023-06-05T09:43:00+10:00,2023-06-05,09:43,2,0,2
3,2023-06-05T09:43:00+10:00,2023-06-05,09:43,5,6,11
6,2023-06-05T09:43:00+10:00,2023-06-05,09:43,9,8,17
26,2023-06-05T09:43:00+10:00,2023-06-05,09:43,1,0,1
31,2023-06-05T09:43:00+10:00,2023-06-05,09:43,0,1,1
45,2023-06-05T09:43:00+10:00,2023-06-05,09:43,3,5,8
54,2023-06-05T09:43:00+10:00,2023-06-05,09:43,3,8,11
61,2023-06-05T09:43:00+10:00,2023-06-05,09:43,3,1,4
66,2023-06-05T09:43:00+10:00,2023-06-05,09:43,4,12,16
87,2023-06-05T09:43:00+10:00,2023-06-05,09:43,1,0,1
108,2023-06-05T09:43:00+10:00,2023-06-05,09:43,3,7,10
21,2023-06-05T09:42:00+10:00,2023-06-05,09:42,0,4,4
31,2023-06-05T09:42:00+10:00,2023-06-05,09:42,2,1,3
40,2023-06-05T09:42:00+10:00,2023-06-05,09:42,1,2,3
47,2023-06-05T09:42:00+10:00,2023-06-05,09:42,8,19,27
50,2023-06-05T09:42:00+10:00,2023-06-05,09:42,0,2,2
55,2023-06-05T09:42:00+10:00,2023-06-05,09:42,4,16,20
70,2023-06-05T09:42:00+10:00,2023-06-05,09:42,1,1,2
77,2023-06-05T09:42:00+10:00,2023-06-05,09:42,2,7,9
108,2023-06-05T09:42:00+10:00,2023-06-05,09:42,2,4,6
9,2023-06-05T09:42:00+10:00,2023-06-05,09:42,1,7,8
10,2023-06-05T09:42:00+10:00,2023-06-05,09:42,1,3,4
11,2023-06-05T09:42:00+10:00,2023-06-05,09:42,1,1,2
23,2023-06-05T09:42:00+10:00,2023-06-05,09:42,4,0,4
30,2023-06-05T09:42:00+10:00,2023-06-05,09:42,2,4,6
35,2023-06-05T09:42:00+10:00,2023-06-05,09:42,3,5,8
46,2023-06-05T09:42:00+10:00,2023-06-05,09:42,3,0,3
48,2023-06-05T09:42:00+10:00,2023-06-05,09:42,2,1,3
51,2023-06-05T09:42:00+10:00,2023-06-05,09:42,0,2,2
52,2023-06-05T09:42:00+10:00,2023-06-05,09:42,4,5,9
57,2023-06-05T09:42:00+10:00,2023-06-05,09:42,0,7,7
58,2023-06-05T09:42:00+10:00,2023-06-05,09:42,2,2,4
67,2023-06-05T09:42:00+10:00,2023-06-05,09:42,11,4,15
68,2023-06-05T09:42:00+10:00,2023-06-05,09:42,3,1,4
17,2023-06-05T09:42:00+10:00,2023-06-05,09:42,10,2,12
24,2023-06-05T09:42:00+10:00,2023-06-05,09:42,17,1,18
53,2023-06-05T09:42:00+10:00,2023-06-05,09:42,1,5,6
56,2023-06-05T09:42:00+10:00,2023-06-05,09:42,7,0,7
62,2023-06-05T09:42:00+10:00,2023-06-05,09:42,2,0,2
63,2023-06-05T09:42:00+10:00,2023-06-05,09:42,7,8,15
72,2023-06-05T09:42:00+10:00,2023-06-05,09:42,11,0,11
79,2023-06-05T09:42:00+10:00,2023-06-05,09:42,3,9,12
3,2023-06-05T09:42:00+10:00,2023-06-05,09:42,5,4,9
4,2023-06-05T09:42:00+10:00,2023-06-05,09:42,12,5,17
8,2023-06-05T09:42:00+10:00,2023-06-05,09:42,1,1,2
14,2023-06-05T09:42:00+10:00,2023-06-05,09:42,0,3,3
26,2023-06-05T09:42:00+10:00,2023-06-05,09:42,3,6,9
36,2023-06-05T09:42:00+10:00,2023-06-05,09:42,7,2,9
39,2023-06-05T09:42:00+10:00,2023-06-05,09:42,3,1,4
41,2023-06-05T09:42:00+10:00,2023-06-05,09:42,47,6,53
42,2023-06-05T09:42:00+10:00,2023-06-05,09:42,5,2,7
45,2023-06-05T09:42:00+10:00,2023-06-05,09:42,6,2,8
54,2023-06-05T09:42:00+10:00,2023-06-05,09:42,0,2,2
61,2023-06-05T09:42:00+10:00,2023-06-05,09:42,2,5,7
66,2023-06-05T09:42:00+10:00,2023-06-05,09:42,8,9,17
1,2023-06-05T09:42:00+10:00,2023-06-05,09:42,4,9,13
12,2023-06-05T09:42:00+10:00,2023-06-05,09:42,0,1,1
18,2023-06-05T09:42:00+10:00,2023-06-05,09:42,3,3,6
27,2023-06-05T09:42:00+10:00,2023-06-05,09:42,1,3,4
49,2023-06-05T09:42:00+10:00,2023-06-05,09:42,2,2,4
85,2023-06-05T09:42:00+10:00,2023-06-05,09:42,0,1,1
5,2023-06-05T09:42:00+10:00,2023-06-05,09:42,5,7,12
6,2023-06-05T09:42:00+10:00,2023-06-05,09:42,5,4,9
28,2023-06-05T09:42:00+10:00,2023-06-05,09:42,4,6,10
29,2023-06-05T09:42:00+10:00,2023-06-05,09:42,1,1,2
37,2023-06-05T09:42:00+10:00,2023-06-05,09:42,1,0,1
65,2023-06-05T09:42:00+10:00,2023-06-05,09:42,6,6,12
69,2023-06-05T09:42:00+10:00,2023-06-05,09:42,10,2,12
71,2023-06-05T09:42:00+10:00,2023-06-05,09:42,14,0,14
78,2023-06-05T09:42:00+10:00,2023-06-05,09:42,1,0,1
87,2023-06-05T09:42:00+10:00,2023-06-05,09:42,1,1,2
2,2023-06-05T09:42:00+10:00,2023-06-05,09:42,3,7,10
3,2023-06-05T09:41:00+10:00,2023-06-05,09:41,1,8,9
5,2023-06-05T09:41:00+10:00,2023-06-05,09:41,5,9,14
6,2023-06-05T09:41:00+10:00,2023-06-05,09:41,6,7,13
28,2023-06-05T09:41:00+10:00,2023-06-05,09:41,6,2,8
36,2023-06-05T09:41:00+10:00,2023-06-05,09:41,1,2,3
45,2023-06-05T09:41:00+10:00,2023-06-05,09:41,3,4,7
47,2023-06-05T09:41:00+10:00,2023-06-05,09:41,2,1,3
50,2023-06-05T09:41:00+10:00,2023-06-05,09:41,0,1,1
55,2023-06-05T09:41:00+10:00,2023-06-05,09:41,6,11,17
65,2023-06-05T09:41:00+10:00,2023-06-05,09:41,2,2,4
70,2023-06-05T09:41:00+10:00,2023-06-05,09:41,3,0,3
77,2023-06-05T09:41:00+10:00,2023-06-05,09:41,2,0,2
78,2023-06-05T09:41:00+10:00,2023-06-05,09:41,0,1,1
1,2023-06-05T09:41:00+10:00,2023-06-05,09:41,11,5,16
17,2023-06-05T09:41:00+10:00,2023-06-05,09:41,12,2,14
18,2023-06-05T09:41:00+10:00,2023-06-05,09:41,8,2,10
19,2023-06-05T09:41:00+10:00,2023-06-05,09:41,3,0,3
24,2023-06-05T09:41:00+10:00,2023-06-05,09:41,3,3,6
48,2023-06-05T09:41:00+10:00,2023-06-05,09:41,0,1,1
56,2023-06-05T09:41:00+10:00,2023-06-05,09:41,8,2,10
57,2023-06-05T09:41:00+10:00,2023-06-05,09:41,3,13,16
62,2023-06-05T09:41:00+10:00,2023-06-05,09:41,0,2,2
12,2023-06-05T09:41:00+10:00,2023-06-05,09:41,1,0,1
20,2023-06-05T09:41:00+10:00,2023-06-05,09:41,2,2,4
46,2023-06-05T09:41:00+10:00,2023-06-05,09:41,1,1,2
67,2023-06-05T09:41:00+10:00,2023-06-05,09:41,3,11,14
21,2023-06-05T09:41:00+10:00,2023-06-05,09:41,0,5,5
26,2023-06-05T09:41:00+10:00,2023-06-05,09:41,3,0,3
29,2023-06-05T09:41:00+10:00,2023-06-05,09:41,0,3,3
42,2023-06-05T09:41:00+10:00,2023-06-05,09:41,3,2,5
44,2023-06-05T09:41:00+10:00,2023-06-05,09:41,2,0,2
54,2023-06-05T09:41:00+10:00,2023-06-05,09:41,1,1,2
61,2023-06-05T09:41:00+10:00,2023-06-05,09:41,5,3,8
75,2023-06-05T09:41:00+10:00,2023-06-05,09:41,3,1,4
87,2023-06-05T09:41:00+10:00,2023-06-05,09:41,3,1,4
108,2023-06-05T09:41:00+10:00,2023-06-05,09:41,6,4,10
2,2023-06-05T09:41:00+10:00,2023-06-05,09:41,2,4,6
9,2023-06-05T09:41:00+10:00,2023-06-05,09:41,0,12,12
10,2023-06-05T09:41:00+10:00,2023-06-05,09:41,3,3,6
23,2023-06-05T09:41:00+10:00,2023-06-05,09:41,1,2,3
27,2023-06-05T09:41:00+10:00,2023-06-05,09:41,1,1,2
30,2023-06-05T09:41:00+10:00,2023-06-05,09:41,1,5,6
35,2023-06-05T09:41:00+10:00,2023-06-05,09:41,9,6,15
52,2023-06-05T09:41:00+10:00,2023-06-05,09:41,2,1,3
53,2023-06-05T09:41:00+10:00,2023-06-05,09:41,4,7,11
58,2023-06-05T09:41:00+10:00,2023-06-05,09:41,15,0,15
63,2023-06-05T09:41:00+10:00,2023-06-05,09:41,4,4,8
68,2023-06-05T09:41:00+10:00,2023-06-05,09:41,2,1,3
72,2023-06-05T09:41:00+10:00,2023-06-05,09:41,3,3,6
79,2023-06-05T09:41:00+10:00,2023-06-05,09:41,9,3,12
85,2023-06-05T09:41:00+10:00,2023-06-05,09:41,2,0,2
4,2023-06-05T09:41:00+10:00,2023-06-05,09:41,8,6,14
8,2023-06-05T09:41:00+10:00,2023-06-05,09:41,3,2,5
14,2023-06-05T09:41:00+10:00,2023-06-05,09:41,3,1,4
31,2023-06-05T09:41:00+10:00,2023-06-05,09:41,0,2,2
39,2023-06-05T09:41:00+10:00,2023-06-05,09:41,0,3,3
40,2023-06-05T09:41:00+10:00,2023-06-05,09:41,4,1,5
41,2023-06-05T09:41:00+10:00,2023-06-05,09:41,23,7,30
66,2023-06-05T09:41:00+10:00,2023-06-05,09:41,7,12,19
69,2023-06-05T09:41:00+10:00,2023-06-05,09:41,1,0,1
71,2023-06-05T09:41:00+10:00,2023-06-05,09:41,1,1,2
3,2023-06-05T09:40:00+10:00,2023-06-05,09:40,8,8,16
4,2023-06-05T09:40:00+10:00,2023-06-05,09:40,5,7,12
6,2023-06-05T09:40:00+10:00,2023-06-05,09:40,2,4,6
14,2023-06-05T09:40:00+10:00,2023-06-05,09:40,1,1,2
28,2023-06-05T09:40:00+10:00,2023-06-05,09:40,4,2,6
42,2023-06-05T09:40:00+10:00,2023-06-05,09:40,1,2,3
47,2023-06-05T09:40:00+10:00,2023-06-05,09:40,3,8,11
59,2023-06-05T09:40:00+10:00,2023-06-05,09:40,102,28,130
66,2023-06-05T09:40:00+10:00,2023-06-05,09:40,4,3,7
71,2023-06-05T09:40:00+10:00,2023-06-05,09:40,0,1,1
84,2023-06-05T09:40:00+10:00,2023-06-05,09:40,70,19,89
2,2023-06-05T09:40:00+10:00,2023-06-05,09:40,5,0,5
9,2023-06-05T09:40:00+10:00,2023-06-05,09:40,2,3,5
17,2023-06-05T09:40:00+10:00,2023-06-05,09:40,5,2,7
18,2023-06-05T09:40:00+10:00,2023-06-05,09:40,2,11,13
23,2023-06-05T09:40:00+10:00,2023-06-05,09:40,2,6,8
30,2023-06-05T09:40:00+10:00,2023-06-05,09:40,3,3,6
35,2023-06-05T09:40:00+10:00,2023-06-05,09:40,5,3,8
63,2023-06-05T09:40:00+10:00,2023-06-05,09:40,0,7,7
68,2023-06-05T09:40:00+10:00,2023-06-05,09:40,1,0,1
109,2023-06-05T09:40:00+10:00,2023-06-05,09:40,5,30,35
5,2023-06-05T09:40:00+10:00,2023-06-05,09:40,4,7,11
21,2023-06-05T09:40:00+10:00,2023-06-05,09:40,4,4,8
36,2023-06-05T09:40:00+10:00,2023-06-05,09:40,2,1,3
39,2023-06-05T09:40:00+10:00,2023-06-05,09:40,1,2,3
50,2023-06-05T09:40:00+10:00,2023-06-05,09:40,1,1,2
54,2023-06-05T09:40:00+10:00,2023-06-05,09:40,3,2,5
61,2023-06-05T09:40:00+10:00,2023-06-05,09:40,2,2,4
65,2023-06-05T09:40:00+10:00,2023-06-05,09:40,2,2,4
70,2023-06-05T09:40:00+10:00,2023-06-05,09:40,2,2,4
77,2023-06-05T09:40:00+10:00,2023-06-05,09:40,1,0,1
78,2023-06-05T09:40:00+10:00,2023-06-05,09:40,0,4,4
87,2023-06-05T09:40:00+10:00,2023-06-05,09:40,1,2,3
10,2023-06-05T09:40:00+10:00,2023-06-05,09:40,8,1,9
24,2023-06-05T09:40:00+10:00,2023-06-05,09:40,8,8,16
48,2023-06-05T09:40:00+10:00,2023-06-05,09:40,0,1,1
52,2023-06-05T09:40:00+10:00,2023-06-05,09:40,1,2,3
58,2023-06-05T09:40:00+10:00,2023-06-05,09:40,9,4,13
67,2023-06-05T09:40:00+10:00,2023-06-05,09:40,5,5,10
72,2023-06-05T09:40:00+10:00,2023-06-05,09:40,14,3,17
86,2023-06-05T09:40:00+10:00,2023-06-05,09:40,3,1,4
8,2023-06-05T09:40:00+10:00,2023-06-05,09:40,3,2,5
26,2023-06-05T09:40:00+10:00,2023-06-05,09:40,3,6,9
29,2023-06-05T09:40:00+10:00,2023-06-05,09:40,0,2,2
40,2023-06-05T09:40:00+10:00,2023-06-05,09:40,4,4,8
41,2023-06-05T09:40:00+10:00,2023-06-05,09:40,23,5,28
45,2023-06-05T09:40:00+10:00,2023-06-05,09:40,3,6,9
55,2023-06-05T09:40:00+10:00,2023-06-05,09:40,6,6,12
69,2023-06-05T09:40:00+10:00,2023-06-05,09:40,10,1,11
107,2023-06-05T09:40:00+10:00,2023-06-05,09:40,5,15,20
108,2023-06-05T09:40:00+10:00,2023-06-05,09:40,0,9,9
1,2023-06-05T09:40:00+10:00,2023-06-05,09:40,7,6,13
11,2023-06-05T09:40:00+10:00,2023-06-05,09:40,1,2,3
12,2023-06-05T09:40:00+10:00,2023-06-05,09:40,2,2,4
20,2023-06-05T09:40:00+10:00,2023-06-05,09:40,0,1,1
46,2023-06-05T09:40:00+10:00,2023-06-05,09:40,1,2,3
49,2023-06-05T09:40:00+10:00,2023-06-05,09:40,0,1,1
51,2023-06-05T09:40:00+10:00,2023-06-05,09:40,2,0,2
53,2023-06-05T09:40:00+10:00,2023-06-05,09:40,3,5,8
56,2023-06-05T09:40:00+10:00,2023-06-05,09:40,1,0,1
57,2023-06-05T09:40:00+10:00,2023-06-05,09:40,1,8,9
62,2023-06-05T09:40:00+10:00,2023-06-05,09:40,2,1,3
76,2023-06-05T09:40:00+10:00,2023-06-05,09:40,3,1,4
79,2023-06-05T09:40:00+10:00,2023-06-05,09:40,2,3,5
117,2023-06-05T09:40:00+10:00,2023-06-05,09:40,7,6,13
3,2023-06-05T09:39:00+10:00,2023-06-05,09:39,3,3,6
14,2023-06-05T09:39:00+10:00,2023-06-05,09:39,3,4,7
21,2023-06-05T09:39:00+10:00,2023-06-05,09:39,3,2,5
26,2023-06-05T09:39:00+10:00,2023-06-05,09:39,2,2,4
37,2023-06-05T09:39:00+10:00,2023-06-05,09:39,0,1,1
41,2023-06-05T09:39:00+10:00,2023-06-05,09:39,26,10,36
42,2023-06-05T09:39:00+10:00,2023-06-05,09:39,1,5,6
44,2023-06-05T09:39:00+10:00,2023-06-05,09:39,0,1,1
65,2023-06-05T09:39:00+10:00,2023-06-05,09:39,14,4,18
69,2023-06-05T09:39:00+10:00,2023-06-05,09:39,1,0,1
70,2023-06-05T09:39:00+10:00,2023-06-05,09:39,0,1,1
77,2023-06-05T09:39:00+10:00,2023-06-05,09:39,0,1,1
12,2023-06-05T09:39:00+10:00,2023-06-05,09:39,2,1,3
18,2023-06-05T09:39:00+10:00,2023-06-05,09:39,1,10,11
27,2023-06-05T09:39:00+10:00,2023-06-05,09:39,0,1,1
30,2023-06-05T09:39:00+10:00,2023-06-05,09:39,2,3,5
46,2023-06-05T09:39:00+10:00,2023-06-05,09:39,0,2,2
76,2023-06-05T09:39:00+10:00,2023-06-05,09:39,2,0,2
28,2023-06-05T09:39:00+10:00,2023-06-05,09:39,6,2,8
40,2023-06-05T09:39:00+10:00,2023-06-05,09:39,1,2,3
45,2023-06-05T09:39:00+10:00,2023-06-05,09:39,2,1,3
47,2023-06-05T09:39:00+10:00,2023-06-05,09:39,4,18,22
50,2023-06-05T09:39:00+10:00,2023-06-05,09:39,0,2,2
75,2023-06-05T09:39:00+10:00,2023-06-05,09:39,1,0,1
108,2023-06-05T09:39:00+10:00,2023-06-05,09:39,3,9,12
9,2023-06-05T09:39:00+10:00,2023-06-05,09:39,1,2,3
17,2023-06-05T09:39:00+10:00,2023-06-05,09:39,9,3,12
35,2023-06-05T09:39:00+10:00,2023-06-05,09:39,7,6,13
48,2023-06-05T09:39:00+10:00,2023-06-05,09:39,2,3,5
52,2023-06-05T09:39:00+10:00,2023-06-05,09:39,0,1,1
57,2023-06-05T09:39:00+10:00,2023-06-05,09:39,0,4,4
58,2023-06-05T09:39:00+10:00,2023-06-05,09:39,8,2,10
68,2023-06-05T09:39:00+10:00,2023-06-05,09:39,0,1,1
72,2023-06-05T09:39:00+10:00,2023-06-05,09:39,3,0,3
85,2023-06-05T09:39:00+10:00,2023-06-05,09:39,0,1,1
4,2023-06-05T09:39:00+10:00,2023-06-05,09:39,10,13,23
5,2023-06-05T09:39:00+10:00,2023-06-05,09:39,7,1,8
6,2023-06-05T09:39:00+10:00,2023-06-05,09:39,11,8,19
8,2023-06-05T09:39:00+10:00,2023-06-05,09:39,0,1,1
36,2023-06-05T09:39:00+10:00,2023-06-05,09:39,6,2,8
39,2023-06-05T09:39:00+10:00,2023-06-05,09:39,2,4,6
55,2023-06-05T09:39:00+10:00,2023-06-05,09:39,4,9,13
61,2023-06-05T09:39:00+10:00,2023-06-05,09:39,0,4,4
66,2023-06-05T09:39:00+10:00,2023-06-05,09:39,3,8,11
87,2023-06-05T09:39:00+10:00,2023-06-05,09:39,2,0,2
1,2023-06-05T09:39:00+10:00,2023-06-05,09:39,1,4,5
2,2023-06-05T09:39:00+10:00,2023-06-05,09:39,2,4,6
20,2023-06-05T09:39:00+10:00,2023-06-05,09:39,2,4,6
23,2023-06-05T09:39:00+10:00,2023-06-05,09:39,1,2,3
24,2023-06-05T09:39:00+10:00,2023-06-05,09:39,6,8,14
51,2023-06-05T09:39:00+10:00,2023-06-05,09:39,0,3,3
53,2023-06-05T09:39:00+10:00,2023-06-05,09:39,6,4,10
62,2023-06-05T09:39:00+10:00,2023-06-05,09:39,3,0,3
63,2023-06-05T09:39:00+10:00,2023-06-05,09:39,3,4,7
67,2023-06-05T09:39:00+10:00,2023-06-05,09:39,3,7,10
79,2023-06-05T09:39:00+10:00,2023-06-05,09:39,4,6,10
86,2023-06-05T09:39:00+10:00,2023-06-05,09:39,0,3,3
8,2023-06-05T09:38:00+10:00,2023-06-05,09:38,2,0,2
14,2023-06-05T09:38:00+10:00,2023-06-05,09:38,0,2,2
61,2023-06-05T09:38:00+10:00,2023-06-05,09:38,1,6,7
69,2023-06-05T09:38:00+10:00,2023-06-05,09:38,1,1,2
2,2023-06-05T09:38:00+10:00,2023-06-05,09:38,3,3,6
10,2023-06-05T09:38:00+10:00,2023-06-05,09:38,1,0,1
23,2023-06-05T09:38:00+10:00,2023-06-05,09:38,8,4,12
30,2023-06-05T09:38:00+10:00,2023-06-05,09:38,1,8,9
35,2023-06-05T09:38:00+10:00,2023-06-05,09:38,3,3,6
52,2023-06-05T09:38:00+10:00,2023-06-05,09:38,2,3,5
53,2023-06-05T09:38:00+10:00,2023-06-05,09:38,8,1,9
67,2023-06-05T09:38:00+10:00,2023-06-05,09:38,13,5,18
76,2023-06-05T09:38:00+10:00,2023-06-05,09:38,1,0,1
85,2023-06-05T09:38:00+10:00,2023-06-05,09:38,2,1,3
3,2023-06-05T09:38:00+10:00,2023-06-05,09:38,1,5,6
6,2023-06-05T09:38:00+10:00,2023-06-05,09:38,5,2,7
21,2023-06-05T09:38:00+10:00,2023-06-05,09:38,5,0,5
28,2023-06-05T09:38:00+10:00,2023-06-05,09:38,0,4,4
31,2023-06-05T09:38:00+10:00,2023-06-05,09:38,2,1,3
37,2023-06-05T09:38:00+10:00,2023-06-05,09:38,0,1,1
41,2023-06-05T09:38:00+10:00,2023-06-05,09:38,18,4,22
44,2023-06-05T09:38:00+10:00,2023-06-05,09:38,0,3,3
45,2023-06-05T09:38:00+10:00,2023-06-05,09:38,0,6,6
47,2023-06-05T09:38:00+10:00,2023-06-05,09:38,0,3,3
50,2023-06-05T09:38:00+10:00,2023-06-05,09:38,2,4,6
65,2023-06-05T09:38:00+10:00,2023-06-05,09:38,2,6,8
66,2023-06-05T09:38:00+10:00,2023-06-05,09:38,4,7,11
75,2023-06-05T09:38:00+10:00,2023-06-05,09:38,2,0,2
77,2023-06-05T09:38:00+10:00,2023-06-05,09:38,1,0,1
78,2023-06-05T09:38:00+10:00,2023-06-05,09:38,1,1,2
87,2023-06-05T09:38:00+10:00,2023-06-05,09:38,0,2,2
108,2023-06-05T09:38:00+10:00,2023-06-05,09:38,2,4,6
1,2023-06-05T09:38:00+10:00,2023-06-05,09:38,1,4,5
9,2023-06-05T09:38:00+10:00,2023-06-05,09:38,3,12,15
17,2023-06-05T09:38:00+10:00,2023-06-05,09:38,0,2,2
18,2023-06-05T09:38:00+10:00,2023-06-05,09:38,1,4,5
48,2023-06-05T09:38:00+10:00,2023-06-05,09:38,2,0,2
51,2023-06-05T09:38:00+10:00,2023-06-05,09:38,1,2,3
56,2023-06-05T09:38:00+10:00,2023-06-05,09:38,2,0,2
63,2023-06-05T09:38:00+10:00,2023-06-05,09:38,1,3,4
79,2023-06-05T09:38:00+10:00,2023-06-05,09:38,11,4,15
4,2023-06-05T09:38:00+10:00,2023-06-05,09:38,7,4,11
5,2023-06-05T09:38:00+10:00,2023-06-05,09:38,2,12,14
26,2023-06-05T09:38:00+10:00,2023-06-05,09:38,2,3,5
29,2023-06-05T09:38:00+10:00,2023-06-05,09:38,1,2,3
36,2023-06-05T09:38:00+10:00,2023-06-05,09:38,5,1,6
39,2023-06-05T09:38:00+10:00,2023-06-05,09:38,0,2,2
40,2023-06-05T09:38:00+10:00,2023-06-05,09:38,4,0,4
42,2023-06-05T09:38:00+10:00,2023-06-05,09:38,0,2,2
54,2023-06-05T09:38:00+10:00,2023-06-05,09:38,0,1,1
55,2023-06-05T09:38:00+10:00,2023-06-05,09:38,5,5,10
70,2023-06-05T09:38:00+10:00,2023-06-05,09:38,0,2,2
71,2023-06-05T09:38:00+10:00,2023-06-05,09:38,0,1,1
19,2023-06-05T09:38:00+10:00,2023-06-05,09:38,2,0,2
20,2023-06-05T09:38:00+10:00,2023-06-05,09:38,2,3,5
24,2023-06-05T09:38:00+10:00,2023-06-05,09:38,14,16,30
27,2023-06-05T09:38:00+10:00,2023-06-05,09:38,3,0,3
46,2023-06-05T09:38:00+10:00,2023-06-05,09:38,1,1,2
57,2023-06-05T09:38:00+10:00,2023-06-05,09:38,3,3,6
58,2023-06-05T09:38:00+10:00,2023-06-05,09:38,11,2,13
68,2023-06-05T09:38:00+10:00,2023-06-05,09:38,1,2,3
72,2023-06-05T09:38:00+10:00,2023-06-05,09:38,2,1,3
4,2023-06-05T09:37:00+10:00,2023-06-05,09:37,16,6,22
14,2023-06-05T09:37:00+10:00,2023-06-05,09:37,2,3,5
21,2023-06-05T09:37:00+10:00,2023-06-05,09:37,2,4,6
26,2023-06-05T09:37:00+10:00,2023-06-05,09:37,0,3,3
28,2023-06-05T09:37:00+10:00,2023-06-05,09:37,3,5,8
29,2023-06-05T09:37:00+10:00,2023-06-05,09:37,1,1,2
31,2023-06-05T09:37:00+10:00,2023-06-05,09:37,0,2,2
40,2023-06-05T09:37:00+10:00,2023-06-05,09:37,2,2,4
42,2023-06-05T09:37:00+10:00,2023-06-05,09:37,2,0,2
44,2023-06-05T09:37:00+10:00,2023-06-05,09:37,0,1,1
45,2023-06-05T09:37:00+10:00,2023-06-05,09:37,4,2,6
54,2023-06-05T09:37:00+10:00,2023-06-05,09:37,2,0,2
75,2023-06-05T09:37:00+10:00,2023-06-05,09:37,0,2,2
1,2023-06-05T09:37:00+10:00,2023-06-05,09:37,11,6,17
17,2023-06-05T09:37:00+10:00,2023-06-05,09:37,10,2,12
24,2023-06-05T09:37:00+10:00,2023-06-05,09:37,13,1,14
35,2023-06-05T09:37:00+10:00,2023-06-05,09:37,3,5,8
46,2023-06-05T09:37:00+10:00,2023-06-05,09:37,1,2,3
49,2023-06-05T09:37:00+10:00,2023-06-05,09:37,0,3,3
53,2023-06-05T09:37:00+10:00,2023-06-05,09:37,3,14,17
58,2023-06-05T09:37:00+10:00,2023-06-05,09:37,8,1,9
62,2023-06-05T09:37:00+10:00,2023-06-05,09:37,2,0,2
63,2023-06-05T09:37:00+10:00,2023-06-05,09:37,1,0,1
72,2023-06-05T09:37:00+10:00,2023-06-05,09:37,4,0,4
76,2023-06-05T09:37:00+10:00,2023-06-05,09:37,0,2,2
85,2023-06-05T09:37:00+10:00,2023-06-05,09:37,4,1,5
5,2023-06-05T09:37:00+10:00,2023-06-05,09:37,5,4,9
41,2023-06-05T09:37:00+10:00,2023-06-05,09:37,15,10,25
66,2023-06-05T09:37:00+10:00,2023-06-05,09:37,7,1,8
71,2023-06-05T09:37:00+10:00,2023-06-05,09:37,1,1,2
77,2023-06-05T09:37:00+10:00,2023-06-05,09:37,1,2,3
9,2023-06-05T09:37:00+10:00,2023-06-05,09:37,3,16,19
10,2023-06-05T09:37:00+10:00,2023-06-05,09:37,3,2,5
11,2023-06-05T09:37:00+10:00,2023-06-05,09:37,0,1,1
18,2023-06-05T09:37:00+10:00,2023-06-05,09:37,2,2,4
52,2023-06-05T09:37:00+10:00,2023-06-05,09:37,1,5,6
56,2023-06-05T09:37:00+10:00,2023-06-05,09:37,0,2,2
67,2023-06-05T09:37:00+10:00,2023-06-05,09:37,5,4,9
86,2023-06-05T09:37:00+10:00,2023-06-05,09:37,1,1,2
3,2023-06-05T09:37:00+10:00,2023-06-05,09:37,7,10,17
6,2023-06-05T09:37:00+10:00,2023-06-05,09:37,12,9,21
36,2023-06-05T09:37:00+10:00,2023-06-05,09:37,2,4,6
37,2023-06-05T09:37:00+10:00,2023-06-05,09:37,2,0,2
39,2023-06-05T09:37:00+10:00,2023-06-05,09:37,1,3,4
47,2023-06-05T09:37:00+10:00,2023-06-05,09:37,2,9,11
50,2023-06-05T09:37:00+10:00,2023-06-05,09:37,1,0,1
55,2023-06-05T09:37:00+10:00,2023-06-05,09:37,4,4,8
61,2023-06-05T09:37:00+10:00,2023-06-05,09:37,0,7,7
65,2023-06-05T09:37:00+10:00,2023-06-05,09:37,6,0,6
70,2023-06-05T09:37:00+10:00,2023-06-05,09:37,0,1,1
78,2023-06-05T09:37:00+10:00,2023-06-05,09:37,1,0,1
87,2023-06-05T09:37:00+10:00,2023-06-05,09:37,1,4,5
108,2023-06-05T09:37:00+10:00,2023-06-05,09:37,2,11,13
2,2023-06-05T09:37:00+10:00,2023-06-05,09:37,8,7,15
19,2023-06-05T09:37:00+10:00,2023-06-05,09:37,1,2,3
23,2023-06-05T09:37:00+10:00,2023-06-05,09:37,2,2,4
27,2023-06-05T09:37:00+10:00,2023-06-05,09:37,1,0,1
30,2023-06-05T09:37:00+10:00,2023-06-05,09:37,1,4,5
48,2023-06-05T09:37:00+10:00,2023-06-05,09:37,6,0,6
51,2023-06-05T09:37:00+10:00,2023-06-05,09:37,0,2,2
57,2023-06-05T09:37:00+10:00,2023-06-05,09:37,4,8,12
68,2023-06-05T09:37:00+10:00,2023-06-05,09:37,3,0,3
79,2023-06-05T09:37:00+10:00,2023-06-05,09:37,1,3,4
26,2023-06-05T09:36:00+10:00,2023-06-05,09:36,0,4,4
31,2023-06-05T09:36:00+10:00,2023-06-05,09:36,2,4,6
36,2023-06-05T09:36:00+10:00,2023-06-05,09:36,2,7,9
42,2023-06-05T09:36:00+10:00,2023-06-05,09:36,2,3,5
45,2023-06-05T09:36:00+10:00,2023-06-05,09:36,2,3,5
47,2023-06-05T09:36:00+10:00,2023-06-05,09:36,6,15,21
70,2023-06-05T09:36:00+10:00,2023-06-05,09:36,1,2,3
10,2023-06-05T09:36:00+10:00,2023-06-05,09:36,0,1,1
11,2023-06-05T09:36:00+10:00,2023-06-05,09:36,3,0,3
17,2023-06-05T09:36:00+10:00,2023-06-05,09:36,10,1,11
24,2023-06-05T09:36:00+10:00,2023-06-05,09:36,19,1,20
53,2023-06-05T09:36:00+10:00,2023-06-05,09:36,8,2,10
62,2023-06-05T09:36:00+10:00,2023-06-05,09:36,4,0,4
72,2023-06-05T09:36:00+10:00,2023-06-05,09:36,0,1,1
8,2023-06-05T09:36:00+10:00,2023-06-05,09:36,2,1,3
14,2023-06-05T09:36:00+10:00,2023-06-05,09:36,3,2,5
40,2023-06-05T09:36:00+10:00,2023-06-05,09:36,1,3,4
55,2023-06-05T09:36:00+10:00,2023-06-05,09:36,7,3,10
61,2023-06-05T09:36:00+10:00,2023-06-05,09:36,4,2,6
65,2023-06-05T09:36:00+10:00,2023-06-05,09:36,2,2,4
66,2023-06-05T09:36:00+10:00,2023-06-05,09:36,7,4,11
69,2023-06-05T09:36:00+10:00,2023-06-05,09:36,1,1,2
2,2023-06-05T09:36:00+10:00,2023-06-05,09:36,4,2,6
9,2023-06-05T09:36:00+10:00,2023-06-05,09:36,4,8,12
49,2023-06-05T09:36:00+10:00,2023-06-05,09:36,2,0,2
51,2023-06-05T09:36:00+10:00,2023-06-05,09:36,1,0,1
52,2023-06-05T09:36:00+10:00,2023-06-05,09:36,5,2,7
56,2023-06-05T09:36:00+10:00,2023-06-05,09:36,2,1,3
57,2023-06-05T09:36:00+10:00,2023-06-05,09:36,2,8,10
67,2023-06-05T09:36:00+10:00,2023-06-05,09:36,12,7,19
68,2023-06-05T09:36:00+10:00,2023-06-05,09:36,2,3,5
76,2023-06-05T09:36:00+10:00,2023-06-05,09:36,0,4,4
79,2023-06-05T09:36:00+10:00,2023-06-05,09:36,9,1,10
3,2023-06-05T09:36:00+10:00,2023-06-05,09:36,4,10,14
4,2023-06-05T09:36:00+10:00,2023-06-05,09:36,18,5,23
5,2023-06-05T09:36:00+10:00,2023-06-05,09:36,4,6,10
6,2023-06-05T09:36:00+10:00,2023-06-05,09:36,8,5,13
21,2023-06-05T09:36:00+10:00,2023-06-05,09:36,2,4,6
28,2023-06-05T09:36:00+10:00,2023-06-05,09:36,2,2,4
41,2023-06-05T09:36:00+10:00,2023-06-05,09:36,11,15,26
44,2023-06-05T09:36:00+10:00,2023-06-05,09:36,0,3,3
50,2023-06-05T09:36:00+10:00,2023-06-05,09:36,2,0,2
54,2023-06-05T09:36:00+10:00,2023-06-05,09:36,0,1,1
71,2023-06-05T09:36:00+10:00,2023-06-05,09:36,1,1,2
77,2023-06-05T09:36:00+10:00,2023-06-05,09:36,5,2,7
87,2023-06-05T09:36:00+10:00,2023-06-05,09:36,1,0,1
108,2023-06-05T09:36:00+10:00,2023-06-05,09:36,3,0,3
1,2023-06-05T09:36:00+10:00,2023-06-05,09:36,5,8,13
12,2023-06-05T09:36:00+10:00,2023-06-05,09:36,1,1,2
18,2023-06-05T09:36:00+10:00,2023-06-05,09:36,2,5,7
19,2023-06-05T09:36:00+10:00,2023-06-05,09:36,3,1,4
20,2023-06-05T09:36:00+10:00,2023-06-05,09:36,1,1,2
23,2023-06-05T09:36:00+10:00,2023-06-05,09:36,4,2,6
30,2023-06-05T09:36:00+10:00,2023-06-05,09:36,0,1,1
35,2023-06-05T09:36:00+10:00,2023-06-05,09:36,8,4,12
46,2023-06-05T09:36:00+10:00,2023-06-05,09:36,0,5,5
48,2023-06-05T09:36:00+10:00,2023-06-05,09:36,3,0,3
58,2023-06-05T09:36:00+10:00,2023-06-05,09:36,10,2,12
63,2023-06-05T09:36:00+10:00,2023-06-05,09:36,0,6,6
86,2023-06-05T09:36:00+10:00,2023-06-05,09:36,3,0,3
3,2023-06-05T09:35:00+10:00,2023-06-05,09:35,1,6,7
8,2023-06-05T09:35:00+10:00,2023-06-05,09:35,1,4,5
14,2023-06-05T09:35:00+10:00,2023-06-05,09:35,1,1,2
21,2023-06-05T09:35:00+10:00,2023-06-05,09:35,0,1,1
37,2023-06-05T09:35:00+10:00,2023-06-05,09:35,2,3,5
39,2023-06-05T09:35:00+10:00,2023-06-05,09:35,2,3,5
50,2023-06-05T09:35:00+10:00,2023-06-05,09:35,3,1,4
65,2023-06-05T09:35:00+10:00,2023-06-05,09:35,4,2,6
66,2023-06-05T09:35:00+10:00,2023-06-05,09:35,3,4,7
69,2023-06-05T09:35:00+10:00,2023-06-05,09:35,1,0,1
77,2023-06-05T09:35:00+10:00,2023-06-05,09:35,0,1,1
87,2023-06-05T09:35:00+10:00,2023-06-05,09:35,2,1,3
108,2023-06-05T09:35:00+10:00,2023-06-05,09:35,1,4,5
118,2023-06-05T09:35:00+10:00,2023-06-05,09:35,4,3,7
10,2023-06-05T09:35:00+10:00,2023-06-05,09:35,0,1,1
11,2023-06-05T09:35:00+10:00,2023-06-05,09:35,4,1,5
18,2023-06-05T09:35:00+10:00,2023-06-05,09:35,2,5,7
19,2023-06-05T09:35:00+10:00,2023-06-05,09:35,1,1,2
46,2023-06-05T09:35:00+10:00,2023-06-05,09:35,1,2,3
4,2023-06-05T09:35:00+10:00,2023-06-05,09:35,6,4,10
5,2023-06-05T09:35:00+10:00,2023-06-05,09:35,1,1,2
26,2023-06-05T09:35:00+10:00,2023-06-05,09:35,4,2,6
28,2023-06-05T09:35:00+10:00,2023-06-05,09:35,10,5,15
36,2023-06-05T09:35:00+10:00,2023-06-05,09:35,3,2,5
40,2023-06-05T09:35:00+10:00,2023-06-05,09:35,0,3,3
41,2023-06-05T09:35:00+10:00,2023-06-05,09:35,23,9,32
42,2023-06-05T09:35:00+10:00,2023-06-05,09:35,3,1,4
45,2023-06-05T09:35:00+10:00,2023-06-05,09:35,2,1,3
54,2023-06-05T09:35:00+10:00,2023-06-05,09:35,1,0,1
55,2023-06-05T09:35:00+10:00,2023-06-05,09:35,1,2,3
61,2023-06-05T09:35:00+10:00,2023-06-05,09:35,2,9,11
70,2023-06-05T09:35:00+10:00,2023-06-05,09:35,4,1,5
84,2023-06-05T09:35:00+10:00,2023-06-05,09:35,56,17,73
1,2023-06-05T09:35:00+10:00,2023-06-05,09:35,3,1,4
9,2023-06-05T09:35:00+10:00,2023-06-05,09:35,3,17,20
12,2023-06-05T09:35:00+10:00,2023-06-05,09:35,0,1,1
17,2023-06-05T09:35:00+10:00,2023-06-05,09:35,14,4,18
30,2023-06-05T09:35:00+10:00,2023-06-05,09:35,1,6,7
35,2023-06-05T09:35:00+10:00,2023-06-05,09:35,6,5,11
48,2023-06-05T09:35:00+10:00,2023-06-05,09:35,1,1,2
49,2023-06-05T09:35:00+10:00,2023-06-05,09:35,2,0,2
51,2023-06-05T09:35:00+10:00,2023-06-05,09:35,0,3,3
52,2023-06-05T09:35:00+10:00,2023-06-05,09:35,1,2,3
58,2023-06-05T09:35:00+10:00,2023-06-05,09:35,13,5,18
62,2023-06-05T09:35:00+10:00,2023-06-05,09:35,6,5,11
63,2023-06-05T09:35:00+10:00,2023-06-05,09:35,1,3,4
72,2023-06-05T09:35:00+10:00,2023-06-05,09:35,7,0,7
76,2023-06-05T09:35:00+10:00,2023-06-05,09:35,0,1,1
79,2023-06-05T09:35:00+10:00,2023-06-05,09:35,2,2,4
85,2023-06-05T09:35:00+10:00,2023-06-05,09:35,2,1,3
109,2023-06-05T09:35:00+10:00,2023-06-05,09:35,6,19,25
6,2023-06-05T09:35:00+10:00,2023-06-05,09:35,7,6,13
29,2023-06-05T09:35:00+10:00,2023-06-05,09:35,3,2,5
31,2023-06-05T09:35:00+10:00,2023-06-05,09:35,1,0,1
47,2023-06-05T09:35:00+10:00,2023-06-05,09:35,0,8,8
59,2023-06-05T09:35:00+10:00,2023-06-05,09:35,69,24,93
107,2023-06-05T09:35:00+10:00,2023-06-05,09:35,5,22,27
2,2023-06-05T09:35:00+10:00,2023-06-05,09:35,1,4,5
20,2023-06-05T09:35:00+10:00,2023-06-05,09:35,2,0,2
23,2023-06-05T09:35:00+10:00,2023-06-05,09:35,9,0,9
24,2023-06-05T09:35:00+10:00,2023-06-05,09:35,24,2,26
53,2023-06-05T09:35:00+10:00,2023-06-05,09:35,3,2,5
56,2023-06-05T09:35:00+10:00,2023-06-05,09:35,4,1,5
57,2023-06-05T09:35:00+10:00,2023-06-05,09:35,2,2,4
67,2023-06-05T09:35:00+10:00,2023-06-05,09:35,4,3,7
68,2023-06-05T09:35:00+10:00,2023-06-05,09:35,2,3,5
117,2023-06-05T09:35:00+10:00,2023-06-05,09:35,20,15,35
3,2023-06-05T09:34:00+10:00,2023-06-05,09:34,6,2,8
5,2023-06-05T09:34:00+10:00,2023-06-05,09:34,0,3,3
8,2023-06-05T09:34:00+10:00,2023-06-05,09:34,5,0,5
21,2023-06-05T09:34:00+10:00,2023-06-05,09:34,1,0,1
26,2023-06-05T09:34:00+10:00,2023-06-05,09:34,6,4,10
29,2023-06-05T09:34:00+10:00,2023-06-05,09:34,0,3,3
39,2023-06-05T09:34:00+10:00,2023-06-05,09:34,0,1,1
41,2023-06-05T09:34:00+10:00,2023-06-05,09:34,21,9,30
45,2023-06-05T09:34:00+10:00,2023-06-05,09:34,2,2,4
50,2023-06-05T09:34:00+10:00,2023-06-05,09:34,0,1,1
54,2023-06-05T09:34:00+10:00,2023-06-05,09:34,1,0,1
61,2023-06-05T09:34:00+10:00,2023-06-05,09:34,6,1,7
71,2023-06-05T09:34:00+10:00,2023-06-05,09:34,2,1,3
75,2023-06-05T09:34:00+10:00,2023-06-05,09:34,1,2,3
108,2023-06-05T09:34:00+10:00,2023-06-05,09:34,7,8,15
1,2023-06-05T09:34:00+10:00,2023-06-05,09:34,1,3,4
27,2023-06-05T09:34:00+10:00,2023-06-05,09:34,1,2,3
35,2023-06-05T09:34:00+10:00,2023-06-05,09:34,7,2,9
48,2023-06-05T09:34:00+10:00,2023-06-05,09:34,1,0,1
53,2023-06-05T09:34:00+10:00,2023-06-05,09:34,7,10,17
57,2023-06-05T09:34:00+10:00,2023-06-05,09:34,0,3,3
67,2023-06-05T09:34:00+10:00,2023-06-05,09:34,8,6,14
72,2023-06-05T09:34:00+10:00,2023-06-05,09:34,4,4,8
85,2023-06-05T09:34:00+10:00,2023-06-05,09:34,1,0,1
6,2023-06-05T09:34:00+10:00,2023-06-05,09:34,1,2,3
31,2023-06-05T09:34:00+10:00,2023-06-05,09:34,1,0,1
37,2023-06-05T09:34:00+10:00,2023-06-05,09:34,0,1,1
40,2023-06-05T09:34:00+10:00,2023-06-05,09:34,1,4,5
47,2023-06-05T09:34:00+10:00,2023-06-05,09:34,2,6,8
65,2023-06-05T09:34:00+10:00,2023-06-05,09:34,2,0,2
87,2023-06-05T09:34:00+10:00,2023-06-05,09:34,3,0,3
2,2023-06-05T09:34:00+10:00,2023-06-05,09:34,2,3,5
9,2023-06-05T09:34:00+10:00,2023-06-05,09:34,2,13,15
10,2023-06-05T09:34:00+10:00,2023-06-05,09:34,0,3,3
12,2023-06-05T09:34:00+10:00,2023-06-05,09:34,3,0,3
19,2023-06-05T09:34:00+10:00,2023-06-05,09:34,5,1,6
23,2023-06-05T09:34:00+10:00,2023-06-05,09:34,0,5,5
24,2023-06-05T09:34:00+10:00,2023-06-05,09:34,6,6,12
30,2023-06-05T09:34:00+10:00,2023-06-05,09:34,3,2,5
51,2023-06-05T09:34:00+10:00,2023-06-05,09:34,4,1,5
56,2023-06-05T09:34:00+10:00,2023-06-05,09:34,4,0,4
58,2023-06-05T09:34:00+10:00,2023-06-05,09:34,8,5,13
86,2023-06-05T09:34:00+10:00,2023-06-05,09:34,1,0,1
4,2023-06-05T09:34:00+10:00,2023-06-05,09:34,24,3,27
14,2023-06-05T09:34:00+10:00,2023-06-05,09:34,4,3,7
28,2023-06-05T09:34:00+10:00,2023-06-05,09:34,7,0,7
36,2023-06-05T09:34:00+10:00,2023-06-05,09:34,0,4,4
42,2023-06-05T09:34:00+10:00,2023-06-05,09:34,0,1,1
55,2023-06-05T09:34:00+10:00,2023-06-05,09:34,1,2,3
66,2023-06-05T09:34:00+10:00,2023-06-05,09:34,2,1,3
69,2023-06-05T09:34:00+10:00,2023-06-05,09:34,1,0,1
70,2023-06-05T09:34:00+10:00,2023-06-05,09:34,1,0,1
77,2023-06-05T09:34:00+10:00,2023-06-05,09:34,0,4,4
78,2023-06-05T09:34:00+10:00,2023-06-05,09:34,0,1,1
17,2023-06-05T09:34:00+10:00,2023-06-05,09:34,6,1,7
18,2023-06-05T09:34:00+10:00,2023-06-05,09:34,3,4,7
20,2023-06-05T09:34:00+10:00,2023-06-05,09:34,0,2,2
52,2023-06-05T09:34:00+10:00,2023-06-05,09:34,2,2,4
62,2023-06-05T09:34:00+10:00,2023-06-05,09:34,0,3,3
63,2023-06-05T09:34:00+10:00,2023-06-05,09:34,2,3,5
68,2023-06-05T09:34:00+10:00,2023-06-05,09:34,4,1,5
76,2023-06-05T09:34:00+10:00,2023-06-05,09:34,0,2,2
79,2023-06-05T09:34:00+10:00,2023-06-05,09:34,0,9,9
3,2023-06-05T09:33:00+10:00,2023-06-05,09:33,7,9,16
14,2023-06-05T09:33:00+10:00,2023-06-05,09:33,2,2,4
39,2023-06-05T09:33:00+10:00,2023-06-05,09:33,1,0,1
41,2023-06-05T09:33:00+10:00,2023-06-05,09:33,21,8,29
55,2023-06-05T09:33:00+10:00,2023-06-05,09:33,12,11,23
61,2023-06-05T09:33:00+10:00,2023-06-05,09:33,6,5,11
70,2023-06-05T09:33:00+10:00,2023-06-05,09:33,0,2,2
75,2023-06-05T09:33:00+10:00,2023-06-05,09:33,1,1,2
87,2023-06-05T09:33:00+10:00,2023-06-05,09:33,1,0,1
2,2023-06-05T09:33:00+10:00,2023-06-05,09:33,3,5,8
9,2023-06-05T09:33:00+10:00,2023-06-05,09:33,5,16,21
17,2023-06-05T09:33:00+10:00,2023-06-05,09:33,9,2,11
18,2023-06-05T09:33:00+10:00,2023-06-05,09:33,3,7,10
19,2023-06-05T09:33:00+10:00,2023-06-05,09:33,0,1,1
46,2023-06-05T09:33:00+10:00,2023-06-05,09:33,0,1,1
48,2023-06-05T09:33:00+10:00,2023-06-05,09:33,4,1,5
53,2023-06-05T09:33:00+10:00,2023-06-05,09:33,5,1,6
67,2023-06-05T09:33:00+10:00,2023-06-05,09:33,4,4,8
68,2023-06-05T09:33:00+10:00,2023-06-05,09:33,3,2,5
76,2023-06-05T09:33:00+10:00,2023-06-05,09:33,0,1,1
4,2023-06-05T09:33:00+10:00,2023-06-05,09:33,8,5,13
5,2023-06-05T09:33:00+10:00,2023-06-05,09:33,1,6,7
6,2023-06-05T09:33:00+10:00,2023-06-05,09:33,7,3,10
21,2023-06-05T09:33:00+10:00,2023-06-05,09:33,2,0,2
28,2023-06-05T09:33:00+10:00,2023-06-05,09:33,6,6,12
29,2023-06-05T09:33:00+10:00,2023-06-05,09:33,3,1,4
31,2023-06-05T09:33:00+10:00,2023-06-05,09:33,0,2,2
40,2023-06-05T09:33:00+10:00,2023-06-05,09:33,2,2,4
44,2023-06-05T09:33:00+10:00,2023-06-05,09:33,1,2,3
45,2023-06-05T09:33:00+10:00,2023-06-05,09:33,3,2,5
50,2023-06-05T09:33:00+10:00,2023-06-05,09:33,2,2,4
65,2023-06-05T09:33:00+10:00,2023-06-05,09:33,5,4,9
66,2023-06-05T09:33:00+10:00,2023-06-05,09:33,8,18,26
69,2023-06-05T09:33:00+10:00,2023-06-05,09:33,2,3,5
71,2023-06-05T09:33:00+10:00,2023-06-05,09:33,1,0,1
77,2023-06-05T09:33:00+10:00,2023-06-05,09:33,4,2,6
1,2023-06-05T09:33:00+10:00,2023-06-05,09:33,0,5,5
10,2023-06-05T09:33:00+10:00,2023-06-05,09:33,2,0,2
12,2023-06-05T09:33:00+10:00,2023-06-05,09:33,0,1,1
23,2023-06-05T09:33:00+10:00,2023-06-05,09:33,2,2,4
27,2023-06-05T09:33:00+10:00,2023-06-05,09:33,3,0,3
30,2023-06-05T09:33:00+10:00,2023-06-05,09:33,0,1,1
35,2023-06-05T09:33:00+10:00,2023-06-05,09:33,8,5,13
51,2023-06-05T09:33:00+10:00,2023-06-05,09:33,1,0,1
57,2023-06-05T09:33:00+10:00,2023-06-05,09:33,5,5,10
62,2023-06-05T09:33:00+10:00,2023-06-05,09:33,0,1,1
79,2023-06-05T09:33:00+10:00,2023-06-05,09:33,5,5,10
85,2023-06-05T09:33:00+10:00,2023-06-05,09:33,2,2,4
86,2023-06-05T09:33:00+10:00,2023-06-05,09:33,1,0,1
8,2023-06-05T09:33:00+10:00,2023-06-05,09:33,6,0,6
26,2023-06-05T09:33:00+10:00,2023-06-05,09:33,2,3,5
36,2023-06-05T09:33:00+10:00,2023-06-05,09:33,4,0,4
47,2023-06-05T09:33:00+10:00,2023-06-05,09:33,2,12,14
54,2023-06-05T09:33:00+10:00,2023-06-05,09:33,1,0,1
108,2023-06-05T09:33:00+10:00,2023-06-05,09:33,5,8,13
24,2023-06-05T09:33:00+10:00,2023-06-05,09:33,16,13,29
49,2023-06-05T09:33:00+10:00,2023-06-05,09:33,0,3,3
52,2023-06-05T09:33:00+10:00,2023-06-05,09:33,0,9,9
56,2023-06-05T09:33:00+10:00,2023-06-05,09:33,2,0,2
58,2023-06-05T09:33:00+10:00,2023-06-05,09:33,4,7,11
63,2023-06-05T09:33:00+10:00,2023-06-05,09:33,4,1,5
72,2023-06-05T09:33:00+10:00,2023-06-05,09:33,11,2,13
39,2023-06-05T09:32:00+10:00,2023-06-05,09:32,4,3,7
40,2023-06-05T09:32:00+10:00,2023-06-05,09:32,2,0,2
41,2023-06-05T09:32:00+10:00,2023-06-05,09:32,12,7,19
75,2023-06-05T09:32:00+10:00,2023-06-05,09:32,0,2,2
78,2023-06-05T09:32:00+10:00,2023-06-05,09:32,0,2,2
19,2023-06-05T09:32:00+10:00,2023-06-05,09:32,6,1,7
20,2023-06-05T09:32:00+10:00,2023-06-05,09:32,0,4,4
35,2023-06-05T09:32:00+10:00,2023-06-05,09:32,6,7,13
46,2023-06-05T09:32:00+10:00,2023-06-05,09:32,0,7,7
49,2023-06-05T09:32:00+10:00,2023-06-05,09:32,2,2,4
51,2023-06-05T09:32:00+10:00,2023-06-05,09:32,1,0,1
53,2023-06-05T09:32:00+10:00,2023-06-05,09:32,8,0,8
56,2023-06-05T09:32:00+10:00,2023-06-05,09:32,5,1,6
57,2023-06-05T09:32:00+10:00,2023-06-05,09:32,4,4,8
67,2023-06-05T09:32:00+10:00,2023-06-05,09:32,3,1,4
68,2023-06-05T09:32:00+10:00,2023-06-05,09:32,3,1,4
79,2023-06-05T09:32:00+10:00,2023-06-05,09:32,5,12,17
3,2023-06-05T09:32:00+10:00,2023-06-05,09:32,3,9,12
5,2023-06-05T09:32:00+10:00,2023-06-05,09:32,3,6,9
6,2023-06-05T09:32:00+10:00,2023-06-05,09:32,5,0,5
8,2023-06-05T09:32:00+10:00,2023-06-05,09:32,4,1,5
14,2023-06-05T09:32:00+10:00,2023-06-05,09:32,2,2,4
21,2023-06-05T09:32:00+10:00,2023-06-05,09:32,1,1,2
28,2023-06-05T09:32:00+10:00,2023-06-05,09:32,3,3,6
44,2023-06-05T09:32:00+10:00,2023-06-05,09:32,0,1,1
50,2023-06-05T09:32:00+10:00,2023-06-05,09:32,0,2,2
55,2023-06-05T09:32:00+10:00,2023-06-05,09:32,5,8,13
61,2023-06-05T09:32:00+10:00,2023-06-05,09:32,2,5,7
66,2023-06-05T09:32:00+10:00,2023-06-05,09:32,6,8,14
69,2023-06-05T09:32:00+10:00,2023-06-05,09:32,2,1,3
70,2023-06-05T09:32:00+10:00,2023-06-05,09:32,1,2,3
108,2023-06-05T09:32:00+10:00,2023-06-05,09:32,1,7,8
9,2023-06-05T09:32:00+10:00,2023-06-05,09:32,4,8,12
17,2023-06-05T09:32:00+10:00,2023-06-05,09:32,17,1,18
24,2023-06-05T09:32:00+10:00,2023-06-05,09:32,14,2,16
27,2023-06-05T09:32:00+10:00,2023-06-05,09:32,0,1,1
48,2023-06-05T09:32:00+10:00,2023-06-05,09:32,3,1,4
52,2023-06-05T09:32:00+10:00,2023-06-05,09:32,3,3,6
58,2023-06-05T09:32:00+10:00,2023-06-05,09:32,11,3,14
62,2023-06-05T09:32:00+10:00,2023-06-05,09:32,2,1,3
63,2023-06-05T09:32:00+10:00,2023-06-05,09:32,5,1,6
4,2023-06-05T09:32:00+10:00,2023-06-05,09:32,8,8,16
26,2023-06-05T09:32:00+10:00,2023-06-05,09:32,3,9,12
29,2023-06-05T09:32:00+10:00,2023-06-05,09:32,0,2,2
36,2023-06-05T09:32:00+10:00,2023-06-05,09:32,7,1,8
37,2023-06-05T09:32:00+10:00,2023-06-05,09:32,1,0,1
45,2023-06-05T09:32:00+10:00,2023-06-05,09:32,7,4,11
47,2023-06-05T09:32:00+10:00,2023-06-05,09:32,1,13,14
65,2023-06-05T09:32:00+10:00,2023-06-05,09:32,0,2,2
77,2023-06-05T09:32:00+10:00,2023-06-05,09:32,0,2,2
87,2023-06-05T09:32:00+10:00,2023-06-05,09:32,0,1,1
1,2023-06-05T09:32:00+10:00,2023-06-05,09:32,2,3,5
2,2023-06-05T09:32:00+10:00,2023-06-05,09:32,2,4,6
12,2023-06-05T09:32:00+10:00,2023-06-05,09:32,1,2,3
18,2023-06-05T09:32:00+10:00,2023-06-05,09:32,0,7,7
23,2023-06-05T09:32:00+10:00,2023-06-05,09:32,3,3,6
30,2023-06-05T09:32:00+10:00,2023-06-05,09:32,2,2,4
72,2023-06-05T09:32:00+10:00,2023-06-05,09:32,2,0,2
76,2023-06-05T09:32:00+10:00,2023-06-05,09:32,0,1,1
85,2023-06-05T09:32:00+10:00,2023-06-05,09:32,0,2,2
86,2023-06-05T09:32:00+10:00,2023-06-05,09:32,0,1,1
4,2023-06-05T09:31:00+10:00,2023-06-05,09:31,8,9,17
6,2023-06-05T09:31:00+10:00,2023-06-05,09:31,8,8,16
21,2023-06-05T09:31:00+10:00,2023-06-05,09:31,4,1,5
26,2023-06-05T09:31:00+10:00,2023-06-05,09:31,4,3,7
29,2023-06-05T09:31:00+10:00,2023-06-05,09:31,2,2,4
37,2023-06-05T09:31:00+10:00,2023-06-05,09:31,1,1,2
39,2023-06-05T09:31:00+10:00,2023-06-05,09:31,1,0,1
44,2023-06-05T09:31:00+10:00,2023-06-05,09:31,1,2,3
61,2023-06-05T09:31:00+10:00,2023-06-05,09:31,3,5,8
71,2023-06-05T09:31:00+10:00,2023-06-05,09:31,0,2,2
78,2023-06-05T09:31:00+10:00,2023-06-05,09:31,0,1,1
12,2023-06-05T09:31:00+10:00,2023-06-05,09:31,4,0,4
18,2023-06-05T09:31:00+10:00,2023-06-05,09:31,1,12,13
23,2023-06-05T09:31:00+10:00,2023-06-05,09:31,2,1,3
24,2023-06-05T09:31:00+10:00,2023-06-05,09:31,21,3,24
72,2023-06-05T09:31:00+10:00,2023-06-05,09:31,2,1,3
79,2023-06-05T09:31:00+10:00,2023-06-05,09:31,4,4,8
86,2023-06-05T09:31:00+10:00,2023-06-05,09:31,1,0,1
41,2023-06-05T09:31:00+10:00,2023-06-05,09:31,26,5,31
54,2023-06-05T09:31:00+10:00,2023-06-05,09:31,1,0,1
65,2023-06-05T09:31:00+10:00,2023-06-05,09:31,4,6,10
75,2023-06-05T09:31:00+10:00,2023-06-05,09:31,1,1,2
77,2023-06-05T09:31:00+10:00,2023-06-05,09:31,1,2,3
1,2023-06-05T09:31:00+10:00,2023-06-05,09:31,5,1,6
9,2023-06-05T09:31:00+10:00,2023-06-05,09:31,6,6,12
10,2023-06-05T09:31:00+10:00,2023-06-05,09:31,1,1,2
17,2023-06-05T09:31:00+10:00,2023-06-05,09:31,5,6,11
19,2023-06-05T09:31:00+10:00,2023-06-05,09:31,6,1,7
27,2023-06-05T09:31:00+10:00,2023-06-05,09:31,0,1,1
30,2023-06-05T09:31:00+10:00,2023-06-05,09:31,2,0,2
35,2023-06-05T09:31:00+10:00,2023-06-05,09:31,3,4,7
56,2023-06-05T09:31:00+10:00,2023-06-05,09:31,0,1,1
57,2023-06-05T09:31:00+10:00,2023-06-05,09:31,9,3,12
58,2023-06-05T09:31:00+10:00,2023-06-05,09:31,14,3,17
63,2023-06-05T09:31:00+10:00,2023-06-05,09:31,2,3,5
67,2023-06-05T09:31:00+10:00,2023-06-05,09:31,3,5,8
76,2023-06-05T09:31:00+10:00,2023-06-05,09:31,3,1,4
3,2023-06-05T09:31:00+10:00,2023-06-05,09:31,4,6,10
5,2023-06-05T09:31:00+10:00,2023-06-05,09:31,3,6,9
8,2023-06-05T09:31:00+10:00,2023-06-05,09:31,0,5,5
14,2023-06-05T09:31:00+10:00,2023-06-05,09:31,2,0,2
28,2023-06-05T09:31:00+10:00,2023-06-05,09:31,5,12,17
36,2023-06-05T09:31:00+10:00,2023-06-05,09:31,3,1,4
40,2023-06-05T09:31:00+10:00,2023-06-05,09:31,3,3,6
42,2023-06-05T09:31:00+10:00,2023-06-05,09:31,0,2,2
45,2023-06-05T09:31:00+10:00,2023-06-05,09:31,5,3,8
47,2023-06-05T09:31:00+10:00,2023-06-05,09:31,3,3,6
55,2023-06-05T09:31:00+10:00,2023-06-05,09:31,4,4,8
66,2023-06-05T09:31:00+10:00,2023-06-05,09:31,10,1,11
69,2023-06-05T09:31:00+10:00,2023-06-05,09:31,3,0,3
87,2023-06-05T09:31:00+10:00,2023-06-05,09:31,2,0,2
108,2023-06-05T09:31:00+10:00,2023-06-05,09:31,1,3,4
2,2023-06-05T09:31:00+10:00,2023-06-05,09:31,3,3,6
46,2023-06-05T09:31:00+10:00,2023-06-05,09:31,2,0,2
48,2023-06-05T09:31:00+10:00,2023-06-05,09:31,2,0,2
51,2023-06-05T09:31:00+10:00,2023-06-05,09:31,1,0,1
52,2023-06-05T09:31:00+10:00,2023-06-05,09:31,6,4,10
53,2023-06-05T09:31:00+10:00,2023-06-05,09:31,10,9,19
62,2023-06-05T09:31:00+10:00,2023-06-05,09:31,1,4,5
68,2023-06-05T09:31:00+10:00,2023-06-05,09:31,1,2,3
85,2023-06-05T09:31:00+10:00,2023-06-05,09:31,2,0,2
8,2023-06-05T09:30:00+10:00,2023-06-05,09:30,0,2,2
14,2023-06-05T09:30:00+10:00,2023-06-05,09:30,4,0,4
21,2023-06-05T09:30:00+10:00,2023-06-05,09:30,2,3,5
26,2023-06-05T09:30:00+10:00,2023-06-05,09:30,2,0,2
29,2023-06-05T09:30:00+10:00,2023-06-05,09:30,2,0,2
40,2023-06-05T09:30:00+10:00,2023-06-05,09:30,1,1,2
59,2023-06-05T09:30:00+10:00,2023-06-05,09:30,77,26,103
66,2023-06-05T09:30:00+10:00,2023-06-05,09:30,2,5,7
108,2023-06-05T09:30:00+10:00,2023-06-05,09:30,3,7,10
118,2023-06-05T09:30:00+10:00,2023-06-05,09:30,2,1,3
18,2023-06-05T09:30:00+10:00,2023-06-05,09:30,0,8,8
19,2023-06-05T09:30:00+10:00,2023-06-05,09:30,1,4,5
56,2023-06-05T09:30:00+10:00,2023-06-05,09:30,0,2,2
57,2023-06-05T09:30:00+10:00,2023-06-05,09:30,1,4,5
58,2023-06-05T09:30:00+10:00,2023-06-05,09:30,19,4,23
28,2023-06-05T09:30:00+10:00,2023-06-05,09:30,4,15,19
36,2023-06-05T09:30:00+10:00,2023-06-05,09:30,1,3,4
39,2023-06-05T09:30:00+10:00,2023-06-05,09:30,2,0,2
41,2023-06-05T09:30:00+10:00,2023-06-05,09:30,17,12,29
42,2023-06-05T09:30:00+10:00,2023-06-05,09:30,1,0,1
47,2023-06-05T09:30:00+10:00,2023-06-05,09:30,5,7,12
61,2023-06-05T09:30:00+10:00,2023-06-05,09:30,0,3,3
65,2023-06-05T09:30:00+10:00,2023-06-05,09:30,15,0,15
69,2023-06-05T09:30:00+10:00,2023-06-05,09:30,1,1,2
77,2023-06-05T09:30:00+10:00,2023-06-05,09:30,2,3,5
87,2023-06-05T09:30:00+10:00,2023-06-05,09:30,3,1,4
107,2023-06-05T09:30:00+10:00,2023-06-05,09:30,7,26,33
1,2023-06-05T09:30:00+10:00,2023-06-05,09:30,4,2,6
10,2023-06-05T09:30:00+10:00,2023-06-05,09:30,1,1,2
11,2023-06-05T09:30:00+10:00,2023-06-05,09:30,2,1,3
12,2023-06-05T09:30:00+10:00,2023-06-05,09:30,3,0,3
23,2023-06-05T09:30:00+10:00,2023-06-05,09:30,7,5,12
24,2023-06-05T09:30:00+10:00,2023-06-05,09:30,35,3,38
27,2023-06-05T09:30:00+10:00,2023-06-05,09:30,0,1,1
35,2023-06-05T09:30:00+10:00,2023-06-05,09:30,4,12,16
46,2023-06-05T09:30:00+10:00,2023-06-05,09:30,1,2,3
48,2023-06-05T09:30:00+10:00,2023-06-05,09:30,2,1,3
51,2023-06-05T09:30:00+10:00,2023-06-05,09:30,1,3,4
63,2023-06-05T09:30:00+10:00,2023-06-05,09:30,2,1,3
67,2023-06-05T09:30:00+10:00,2023-06-05,09:30,9,5,14
68,2023-06-05T09:30:00+10:00,2023-06-05,09:30,3,3,6
72,2023-06-05T09:30:00+10:00,2023-06-05,09:30,5,1,6
76,2023-06-05T09:30:00+10:00,2023-06-05,09:30,3,0,3
117,2023-06-05T09:30:00+10:00,2023-06-05,09:30,12,9,21
3,2023-06-05T09:30:00+10:00,2023-06-05,09:30,8,8,16
4,2023-06-05T09:30:00+10:00,2023-06-05,09:30,13,3,16
5,2023-06-05T09:30:00+10:00,2023-06-05,09:30,4,3,7
6,2023-06-05T09:30:00+10:00,2023-06-05,09:30,5,9,14
37,2023-06-05T09:30:00+10:00,2023-06-05,09:30,1,0,1
44,2023-06-05T09:30:00+10:00,2023-06-05,09:30,0,3,3
45,2023-06-05T09:30:00+10:00,2023-06-05,09:30,4,3,7
50,2023-06-05T09:30:00+10:00,2023-06-05,09:30,1,1,2
54,2023-06-05T09:30:00+10:00,2023-06-05,09:30,3,0,3
55,2023-06-05T09:30:00+10:00,2023-06-05,09:30,3,8,11
70,2023-06-05T09:30:00+10:00,2023-06-05,09:30,0,2,2
71,2023-06-05T09:30:00+10:00,2023-06-05,09:30,0,3,3
84,2023-06-05T09:30:00+10:00,2023-06-05,09:30,61,13,74
9,2023-06-05T09:30:00+10:00,2023-06-05,09:30,2,5,7
17,2023-06-05T09:30:00+10:00,2023-06-05,09:30,7,7,14
20,2023-06-05T09:30:00+10:00,2023-06-05,09:30,4,2,6
30,2023-06-05T09:30:00+10:00,2023-06-05,09:30,2,0,2
52,2023-06-05T09:30:00+10:00,2023-06-05,09:30,3,5,8
53,2023-06-05T09:30:00+10:00,2023-06-05,09:30,7,7,14
79,2023-06-05T09:30:00+10:00,2023-06-05,09:30,2,2,4
86,2023-06-05T09:30:00+10:00,2023-06-05,09:30,0,3,3
109,2023-06-05T09:30:00+10:00,2023-06-05,09:30,10,29,39
4,2023-06-05T09:29:00+10:00,2023-06-05,09:29,9,2,11
26,2023-06-05T09:29:00+10:00,2023-06-05,09:29,0,4,4
36,2023-06-05T09:29:00+10:00,2023-06-05,09:29,6,0,6
39,2023-06-05T09:29:00+10:00,2023-06-05,09:29,1,2,3
50,2023-06-05T09:29:00+10:00,2023-06-05,09:29,1,2,3
54,2023-06-05T09:29:00+10:00,2023-06-05,09:29,2,0,2
55,2023-06-05T09:29:00+10:00,2023-06-05,09:29,7,11,18
61,2023-06-05T09:29:00+10:00,2023-06-05,09:29,2,6,8
65,2023-06-05T09:29:00+10:00,2023-06-05,09:29,5,1,6
77,2023-06-05T09:29:00+10:00,2023-06-05,09:29,0,2,2
108,2023-06-05T09:29:00+10:00,2023-06-05,09:29,2,6,8
1,2023-06-05T09:29:00+10:00,2023-06-05,09:29,1,5,6
2,2023-06-05T09:29:00+10:00,2023-06-05,09:29,6,1,7
11,2023-06-05T09:29:00+10:00,2023-06-05,09:29,0,1,1
12,2023-06-05T09:29:00+10:00,2023-06-05,09:29,0,3,3
20,2023-06-05T09:29:00+10:00,2023-06-05,09:29,1,1,2
24,2023-06-05T09:29:00+10:00,2023-06-05,09:29,7,8,15
48,2023-06-05T09:29:00+10:00,2023-06-05,09:29,2,2,4
63,2023-06-05T09:29:00+10:00,2023-06-05,09:29,1,0,1
67,2023-06-05T09:29:00+10:00,2023-06-05,09:29,8,11,19
86,2023-06-05T09:29:00+10:00,2023-06-05,09:29,0,1,1
6,2023-06-05T09:29:00+10:00,2023-06-05,09:29,3,1,4
28,2023-06-05T09:29:00+10:00,2023-06-05,09:29,11,4,15
42,2023-06-05T09:29:00+10:00,2023-06-05,09:29,2,1,3
44,2023-06-05T09:29:00+10:00,2023-06-05,09:29,0,1,1
45,2023-06-05T09:29:00+10:00,2023-06-05,09:29,0,1,1
70,2023-06-05T09:29:00+10:00,2023-06-05,09:29,1,4,5
71,2023-06-05T09:29:00+10:00,2023-06-05,09:29,1,1,2
17,2023-06-05T09:29:00+10:00,2023-06-05,09:29,21,4,25
27,2023-06-05T09:29:00+10:00,2023-06-05,09:29,2,2,4
46,2023-06-05T09:29:00+10:00,2023-06-05,09:29,0,2,2
52,2023-06-05T09:29:00+10:00,2023-06-05,09:29,2,1,3
56,2023-06-05T09:29:00+10:00,2023-06-05,09:29,5,2,7
57,2023-06-05T09:29:00+10:00,2023-06-05,09:29,2,6,8
62,2023-06-05T09:29:00+10:00,2023-06-05,09:29,1,1,2
68,2023-06-05T09:29:00+10:00,2023-06-05,09:29,3,4,7
72,2023-06-05T09:29:00+10:00,2023-06-05,09:29,5,2,7
79,2023-06-05T09:29:00+10:00,2023-06-05,09:29,2,1,3
85,2023-06-05T09:29:00+10:00,2023-06-05,09:29,0,1,1
3,2023-06-05T09:29:00+10:00,2023-06-05,09:29,3,0,3
5,2023-06-05T09:29:00+10:00,2023-06-05,09:29,1,8,9
8,2023-06-05T09:29:00+10:00,2023-06-05,09:29,2,0,2
14,2023-06-05T09:29:00+10:00,2023-06-05,09:29,2,2,4
21,2023-06-05T09:29:00+10:00,2023-06-05,09:29,4,2,6
29,2023-06-05T09:29:00+10:00,2023-06-05,09:29,0,3,3
40,2023-06-05T09:29:00+10:00,2023-06-05,09:29,5,2,7
41,2023-06-05T09:29:00+10:00,2023-06-05,09:29,29,9,38
47,2023-06-05T09:29:00+10:00,2023-06-05,09:29,1,5,6
66,2023-06-05T09:29:00+10:00,2023-06-05,09:29,4,3,7
69,2023-06-05T09:29:00+10:00,2023-06-05,09:29,4,0,4
87,2023-06-05T09:29:00+10:00,2023-06-05,09:29,1,0,1
9,2023-06-05T09:29:00+10:00,2023-06-05,09:29,1,8,9
18,2023-06-05T09:29:00+10:00,2023-06-05,09:29,0,16,16
19,2023-06-05T09:29:00+10:00,2023-06-05,09:29,1,0,1
23,2023-06-05T09:29:00+10:00,2023-06-05,09:29,1,4,5
30,2023-06-05T09:29:00+10:00,2023-06-05,09:29,2,0,2
35,2023-06-05T09:29:00+10:00,2023-06-05,09:29,9,7,16
49,2023-06-05T09:29:00+10:00,2023-06-05,09:29,0,2,2
51,2023-06-05T09:29:00+10:00,2023-06-05,09:29,1,0,1
53,2023-06-05T09:29:00+10:00,2023-06-05,09:29,12,2,14
58,2023-06-05T09:29:00+10:00,2023-06-05,09:29,5,2,7
4,2023-06-05T09:28:00+10:00,2023-06-05,09:28,7,5,12
29,2023-06-05T09:28:00+10:00,2023-06-05,09:28,0,1,1
37,2023-06-05T09:28:00+10:00,2023-06-05,09:28,1,2,3
41,2023-06-05T09:28:00+10:00,2023-06-05,09:28,40,7,47
70,2023-06-05T09:28:00+10:00,2023-06-05,09:28,2,0,2
77,2023-06-05T09:28:00+10:00,2023-06-05,09:28,2,2,4
12,2023-06-05T09:28:00+10:00,2023-06-05,09:28,1,0,1
18,2023-06-05T09:28:00+10:00,2023-06-05,09:28,0,15,15
20,2023-06-05T09:28:00+10:00,2023-06-05,09:28,2,1,3
35,2023-06-05T09:28:00+10:00,2023-06-05,09:28,2,6,8
46,2023-06-05T09:28:00+10:00,2023-06-05,09:28,0,1,1
48,2023-06-05T09:28:00+10:00,2023-06-05,09:28,2,3,5
51,2023-06-05T09:28:00+10:00,2023-06-05,09:28,1,1,2
53,2023-06-05T09:28:00+10:00,2023-06-05,09:28,10,2,12
56,2023-06-05T09:28:00+10:00,2023-06-05,09:28,3,3,6
58,2023-06-05T09:28:00+10:00,2023-06-05,09:28,15,2,17
72,2023-06-05T09:28:00+10:00,2023-06-05,09:28,2,2,4
8,2023-06-05T09:28:00+10:00,2023-06-05,09:28,1,1,2
21,2023-06-05T09:28:00+10:00,2023-06-05,09:28,3,0,3
40,2023-06-05T09:28:00+10:00,2023-06-05,09:28,3,1,4
45,2023-06-05T09:28:00+10:00,2023-06-05,09:28,5,6,11
54,2023-06-05T09:28:00+10:00,2023-06-05,09:28,2,2,4
66,2023-06-05T09:28:00+10:00,2023-06-05,09:28,2,8,10
69,2023-06-05T09:28:00+10:00,2023-06-05,09:28,7,0,7
2,2023-06-05T09:28:00+10:00,2023-06-05,09:28,2,5,7
10,2023-06-05T09:28:00+10:00,2023-06-05,09:28,1,4,5
19,2023-06-05T09:28:00+10:00,2023-06-05,09:28,0,3,3
23,2023-06-05T09:28:00+10:00,2023-06-05,09:28,5,6,11
24,2023-06-05T09:28:00+10:00,2023-06-05,09:28,28,2,30
30,2023-06-05T09:28:00+10:00,2023-06-05,09:28,1,1,2
62,2023-06-05T09:28:00+10:00,2023-06-05,09:28,2,4,6
67,2023-06-05T09:28:00+10:00,2023-06-05,09:28,7,7,14
68,2023-06-05T09:28:00+10:00,2023-06-05,09:28,2,1,3
76,2023-06-05T09:28:00+10:00,2023-06-05,09:28,1,2,3
79,2023-06-05T09:28:00+10:00,2023-06-05,09:28,7,4,11
86,2023-06-05T09:28:00+10:00,2023-06-05,09:28,1,0,1
3,2023-06-05T09:28:00+10:00,2023-06-05,09:28,3,1,4
5,2023-06-05T09:28:00+10:00,2023-06-05,09:28,2,6,8
6,2023-06-05T09:28:00+10:00,2023-06-05,09:28,6,11,17
14,2023-06-05T09:28:00+10:00,2023-06-05,09:28,2,1,3
26,2023-06-05T09:28:00+10:00,2023-06-05,09:28,2,0,2
28,2023-06-05T09:28:00+10:00,2023-06-05,09:28,8,4,12
31,2023-06-05T09:28:00+10:00,2023-06-05,09:28,3,0,3
36,2023-06-05T09:28:00+10:00,2023-06-05,09:28,4,2,6
39,2023-06-05T09:28:00+10:00,2023-06-05,09:28,0,1,1
42,2023-06-05T09:28:00+10:00,2023-06-05,09:28,3,3,6
44,2023-06-05T09:28:00+10:00,2023-06-05,09:28,1,2,3
47,2023-06-05T09:28:00+10:00,2023-06-05,09:28,9,12,21
50,2023-06-05T09:28:00+10:00,2023-06-05,09:28,2,5,7
55,2023-06-05T09:28:00+10:00,2023-06-05,09:28,1,3,4
61,2023-06-05T09:28:00+10:00,2023-06-05,09:28,2,8,10
65,2023-06-05T09:28:00+10:00,2023-06-05,09:28,5,1,6
75,2023-06-05T09:28:00+10:00,2023-06-05,09:28,1,0,1
87,2023-06-05T09:28:00+10:00,2023-06-05,09:28,3,1,4
108,2023-06-05T09:28:00+10:00,2023-06-05,09:28,6,5,11
1,2023-06-05T09:28:00+10:00,2023-06-05,09:28,8,3,11
9,2023-06-05T09:28:00+10:00,2023-06-05,09:28,1,13,14
17,2023-06-05T09:28:00+10:00,2023-06-05,09:28,8,5,13
27,2023-06-05T09:28:00+10:00,2023-06-05,09:28,0,1,1
49,2023-06-05T09:28:00+10:00,2023-06-05,09:28,2,0,2
52,2023-06-05T09:28:00+10:00,2023-06-05,09:28,4,2,6
57,2023-06-05T09:28:00+10:00,2023-06-05,09:28,2,5,7
63,2023-06-05T09:28:00+10:00,2023-06-05,09:28,1,0,1
4,2023-06-05T09:27:00+10:00,2023-06-05,09:27,10,7,17
8,2023-06-05T09:27:00+10:00,2023-06-05,09:27,3,0,3
14,2023-06-05T09:27:00+10:00,2023-06-05,09:27,2,2,4
31,2023-06-05T09:27:00+10:00,2023-06-05,09:27,0,4,4
36,2023-06-05T09:27:00+10:00,2023-06-05,09:27,2,1,3
37,2023-06-05T09:27:00+10:00,2023-06-05,09:27,0,1,1
42,2023-06-05T09:27:00+10:00,2023-06-05,09:27,1,3,4
45,2023-06-05T09:27:00+10:00,2023-06-05,09:27,1,5,6
47,2023-06-05T09:27:00+10:00,2023-06-05,09:27,6,11,17
54,2023-06-05T09:27:00+10:00,2023-06-05,09:27,1,0,1
69,2023-06-05T09:27:00+10:00,2023-06-05,09:27,3,1,4
70,2023-06-05T09:27:00+10:00,2023-06-05,09:27,2,3,5
71,2023-06-05T09:27:00+10:00,2023-06-05,09:27,0,2,2
77,2023-06-05T09:27:00+10:00,2023-06-05,09:27,1,1,2
78,2023-06-05T09:27:00+10:00,2023-06-05,09:27,0,1,1
108,2023-06-05T09:27:00+10:00,2023-06-05,09:27,1,6,7
9,2023-06-05T09:27:00+10:00,2023-06-05,09:27,3,10,13
10,2023-06-05T09:27:00+10:00,2023-06-05,09:27,0,1,1
11,2023-06-05T09:27:00+10:00,2023-06-05,09:27,0,3,3
12,2023-06-05T09:27:00+10:00,2023-06-05,09:27,3,2,5
27,2023-06-05T09:27:00+10:00,2023-06-05,09:27,1,1,2
51,2023-06-05T09:27:00+10:00,2023-06-05,09:27,0,2,2
56,2023-06-05T09:27:00+10:00,2023-06-05,09:27,0,2,2
85,2023-06-05T09:27:00+10:00,2023-06-05,09:27,4,0,4
6,2023-06-05T09:27:00+10:00,2023-06-05,09:27,10,5,15
21,2023-06-05T09:27:00+10:00,2023-06-05,09:27,5,1,6
26,2023-06-05T09:27:00+10:00,2023-06-05,09:27,0,1,1
28,2023-06-05T09:27:00+10:00,2023-06-05,09:27,2,2,4
29,2023-06-05T09:27:00+10:00,2023-06-05,09:27,2,3,5
41,2023-06-05T09:27:00+10:00,2023-06-05,09:27,27,6,33
44,2023-06-05T09:27:00+10:00,2023-06-05,09:27,1,1,2
66,2023-06-05T09:27:00+10:00,2023-06-05,09:27,4,4,8
20,2023-06-05T09:27:00+10:00,2023-06-05,09:27,1,0,1
30,2023-06-05T09:27:00+10:00,2023-06-05,09:27,2,0,2
35,2023-06-05T09:27:00+10:00,2023-06-05,09:27,3,5,8
46,2023-06-05T09:27:00+10:00,2023-06-05,09:27,3,1,4
49,2023-06-05T09:27:00+10:00,2023-06-05,09:27,0,2,2
53,2023-06-05T09:27:00+10:00,2023-06-05,09:27,8,8,16
57,2023-06-05T09:27:00+10:00,2023-06-05,09:27,4,6,10
62,2023-06-05T09:27:00+10:00,2023-06-05,09:27,1,0,1
68,2023-06-05T09:27:00+10:00,2023-06-05,09:27,4,4,8
79,2023-06-05T09:27:00+10:00,2023-06-05,09:27,8,6,14
86,2023-06-05T09:27:00+10:00,2023-06-05,09:27,0,1,1
3,2023-06-05T09:27:00+10:00,2023-06-05,09:27,4,2,6
5,2023-06-05T09:27:00+10:00,2023-06-05,09:27,2,8,10
39,2023-06-05T09:27:00+10:00,2023-06-05,09:27,1,1,2
40,2023-06-05T09:27:00+10:00,2023-06-05,09:27,3,2,5
50,2023-06-05T09:27:00+10:00,2023-06-05,09:27,1,3,4
55,2023-06-05T09:27:00+10:00,2023-06-05,09:27,7,4,11
61,2023-06-05T09:27:00+10:00,2023-06-05,09:27,2,2,4
65,2023-06-05T09:27:00+10:00,2023-06-05,09:27,5,7,12
75,2023-06-05T09:27:00+10:00,2023-06-05,09:27,1,0,1
87,2023-06-05T09:27:00+10:00,2023-06-05,09:27,0,3,3
1,2023-06-05T09:27:00+10:00,2023-06-05,09:27,5,0,5
2,2023-06-05T09:27:00+10:00,2023-06-05,09:27,1,1,2
17,2023-06-05T09:27:00+10:00,2023-06-05,09:27,6,8,14
18,2023-06-05T09:27:00+10:00,2023-06-05,09:27,1,5,6
19,2023-06-05T09:27:00+10:00,2023-06-05,09:27,0,2,2
23,2023-06-05T09:27:00+10:00,2023-06-05,09:27,6,2,8
24,2023-06-05T09:27:00+10:00,2023-06-05,09:27,14,8,22
48,2023-06-05T09:27:00+10:00,2023-06-05,09:27,7,0,7
52,2023-06-05T09:27:00+10:00,2023-06-05,09:27,1,3,4
58,2023-06-05T09:27:00+10:00,2023-06-05,09:27,20,1,21
63,2023-06-05T09:27:00+10:00,2023-06-05,09:27,1,3,4
67,2023-06-05T09:27:00+10:00,2023-06-05,09:27,7,4,11
72,2023-06-05T09:27:00+10:00,2023-06-05,09:27,1,0,1
76,2023-06-05T09:27:00+10:00,2023-06-05,09:27,3,1,4
4,2023-06-05T09:26:00+10:00,2023-06-05,09:26,10,10,20
21,2023-06-05T09:26:00+10:00,2023-06-05,09:26,1,3,4
28,2023-06-05T09:26:00+10:00,2023-06-05,09:26,11,2,13
36,2023-06-05T09:26:00+10:00,2023-06-05,09:26,7,1,8
40,2023-06-05T09:26:00+10:00,2023-06-05,09:26,1,2,3
41,2023-06-05T09:26:00+10:00,2023-06-05,09:26,24,8,32
50,2023-06-05T09:26:00+10:00,2023-06-05,09:26,0,2,2
55,2023-06-05T09:26:00+10:00,2023-06-05,09:26,1,6,7
66,2023-06-05T09:26:00+10:00,2023-06-05,09:26,6,16,22
70,2023-06-05T09:26:00+10:00,2023-06-05,09:26,2,1,3
87,2023-06-05T09:26:00+10:00,2023-06-05,09:26,1,1,2
108,2023-06-05T09:26:00+10:00,2023-06-05,09:26,0,6,6
10,2023-06-05T09:26:00+10:00,2023-06-05,09:26,0,2,2
46,2023-06-05T09:26:00+10:00,2023-06-05,09:26,1,0,1
51,2023-06-05T09:26:00+10:00,2023-06-05,09:26,3,0,3
53,2023-06-05T09:26:00+10:00,2023-06-05,09:26,6,4,10
56,2023-06-05T09:26:00+10:00,2023-06-05,09:26,3,2,5
62,2023-06-05T09:26:00+10:00,2023-06-05,09:26,0,1,1
63,2023-06-05T09:26:00+10:00,2023-06-05,09:26,3,2,5
72,2023-06-05T09:26:00+10:00,2023-06-05,09:26,1,2,3
3,2023-06-05T09:26:00+10:00,2023-06-05,09:26,1,5,6
5,2023-06-05T09:26:00+10:00,2023-06-05,09:26,6,8,14
8,2023-06-05T09:26:00+10:00,2023-06-05,09:26,4,1,5
26,2023-06-05T09:26:00+10:00,2023-06-05,09:26,4,0,4
29,2023-06-05T09:26:00+10:00,2023-06-05,09:26,2,0,2
39,2023-06-05T09:26:00+10:00,2023-06-05,09:26,4,0,4
54,2023-06-05T09:26:00+10:00,2023-06-05,09:26,0,2,2
65,2023-06-05T09:26:00+10:00,2023-06-05,09:26,4,10,14
71,2023-06-05T09:26:00+10:00,2023-06-05,09:26,1,0,1
77,2023-06-05T09:26:00+10:00,2023-06-05,09:26,1,0,1
2,2023-06-05T09:26:00+10:00,2023-06-05,09:26,4,1,5
9,2023-06-05T09:26:00+10:00,2023-06-05,09:26,2,17,19
17,2023-06-05T09:26:00+10:00,2023-06-05,09:26,4,4,8
18,2023-06-05T09:26:00+10:00,2023-06-05,09:26,1,1,2
19,2023-06-05T09:26:00+10:00,2023-06-05,09:26,1,1,2
20,2023-06-05T09:26:00+10:00,2023-06-05,09:26,1,2,3
23,2023-06-05T09:26:00+10:00,2023-06-05,09:26,0,4,4
24,2023-06-05T09:26:00+10:00,2023-06-05,09:26,16,3,19
27,2023-06-05T09:26:00+10:00,2023-06-05,09:26,1,2,3
48,2023-06-05T09:26:00+10:00,2023-06-05,09:26,0,2,2
52,2023-06-05T09:26:00+10:00,2023-06-05,09:26,3,0,3
57,2023-06-05T09:26:00+10:00,2023-06-05,09:26,1,5,6
67,2023-06-05T09:26:00+10:00,2023-06-05,09:26,8,3,11
68,2023-06-05T09:26:00+10:00,2023-06-05,09:26,3,0,3
79,2023-06-05T09:26:00+10:00,2023-06-05,09:26,5,2,7
6,2023-06-05T09:26:00+10:00,2023-06-05,09:26,3,4,7
14,2023-06-05T09:26:00+10:00,2023-06-05,09:26,4,4,8
44,2023-06-05T09:26:00+10:00,2023-06-05,09:26,0,1,1
45,2023-06-05T09:26:00+10:00,2023-06-05,09:26,1,2,3
47,2023-06-05T09:26:00+10:00,2023-06-05,09:26,1,17,18
61,2023-06-05T09:26:00+10:00,2023-06-05,09:26,4,7,11
69,2023-06-05T09:26:00+10:00,2023-06-05,09:26,2,1,3
78,2023-06-05T09:26:00+10:00,2023-06-05,09:26,1,1,2
1,2023-06-05T09:26:00+10:00,2023-06-05,09:26,5,1,6
30,2023-06-05T09:26:00+10:00,2023-06-05,09:26,2,0,2
35,2023-06-05T09:26:00+10:00,2023-06-05,09:26,4,6,10
58,2023-06-05T09:26:00+10:00,2023-06-05,09:26,10,6,16
76,2023-06-05T09:26:00+10:00,2023-06-05,09:26,1,1,2
85,2023-06-05T09:26:00+10:00,2023-06-05,09:26,0,2,2
86,2023-06-05T09:26:00+10:00,2023-06-05,09:26,1,1,2
14,2023-06-05T09:25:00+10:00,2023-06-05,09:25,1,4,5
26,2023-06-05T09:25:00+10:00,2023-06-05,09:25,1,1,2
37,2023-06-05T09:25:00+10:00,2023-06-05,09:25,1,2,3
41,2023-06-05T09:25:00+10:00,2023-06-05,09:25,21,9,30
45,2023-06-05T09:25:00+10:00,2023-06-05,09:25,3,2,5
54,2023-06-05T09:25:00+10:00,2023-06-05,09:25,0,2,2
55,2023-06-05T09:25:00+10:00,2023-06-05,09:25,18,2,20
70,2023-06-05T09:25:00+10:00,2023-06-05,09:25,3,0,3
75,2023-06-05T09:25:00+10:00,2023-06-05,09:25,1,1,2
84,2023-06-05T09:25:00+10:00,2023-06-05,09:25,74,24,98
11,2023-06-05T09:25:00+10:00,2023-06-05,09:25,5,2,7
23,2023-06-05T09:25:00+10:00,2023-06-05,09:25,17,2,19
30,2023-06-05T09:25:00+10:00,2023-06-05,09:25,4,4,8
52,2023-06-05T09:25:00+10:00,2023-06-05,09:25,5,2,7
57,2023-06-05T09:25:00+10:00,2023-06-05,09:25,4,5,9
58,2023-06-05T09:25:00+10:00,2023-06-05,09:25,24,2,26
62,2023-06-05T09:25:00+10:00,2023-06-05,09:25,3,0,3
68,2023-06-05T09:25:00+10:00,2023-06-05,09:25,4,3,7
76,2023-06-05T09:25:00+10:00,2023-06-05,09:25,1,0,1
86,2023-06-05T09:25:00+10:00,2023-06-05,09:25,1,0,1
117,2023-06-05T09:25:00+10:00,2023-06-05,09:25,18,4,22
3,2023-06-05T09:25:00+10:00,2023-06-05,09:25,9,6,15
6,2023-06-05T09:25:00+10:00,2023-06-05,09:25,11,4,15
21,2023-06-05T09:25:00+10:00,2023-06-05,09:25,6,0,6
28,2023-06-05T09:25:00+10:00,2023-06-05,09:25,5,4,9
36,2023-06-05T09:25:00+10:00,2023-06-05,09:25,5,0,5
47,2023-06-05T09:25:00+10:00,2023-06-05,09:25,5,6,11
50,2023-06-05T09:25:00+10:00,2023-06-05,09:25,0,1,1
59,2023-06-05T09:25:00+10:00,2023-06-05,09:25,45,14,59
61,2023-06-05T09:25:00+10:00,2023-06-05,09:25,3,1,4
66,2023-06-05T09:25:00+10:00,2023-06-05,09:25,2,7,9
78,2023-06-05T09:25:00+10:00,2023-06-05,09:25,0,2,2
87,2023-06-05T09:25:00+10:00,2023-06-05,09:25,2,0,2
107,2023-06-05T09:25:00+10:00,2023-06-05,09:25,5,12,17
108,2023-06-05T09:25:00+10:00,2023-06-05,09:25,13,5,18
118,2023-06-05T09:25:00+10:00,2023-06-05,09:25,4,0,4
1,2023-06-05T09:25:00+10:00,2023-06-05,09:25,2,2,4
2,2023-06-05T09:25:00+10:00,2023-06-05,09:25,2,2,4
12,2023-06-05T09:25:00+10:00,2023-06-05,09:25,4,2,6
17,2023-06-05T09:25:00+10:00,2023-06-05,09:25,10,1,11
35,2023-06-05T09:25:00+10:00,2023-06-05,09:25,4,9,13
51,2023-06-05T09:25:00+10:00,2023-06-05,09:25,2,1,3
56,2023-06-05T09:25:00+10:00,2023-06-05,09:25,4,2,6
63,2023-06-05T09:25:00+10:00,2023-06-05,09:25,1,2,3
109,2023-06-05T09:25:00+10:00,2023-06-05,09:25,11,27,38
4,2023-06-05T09:25:00+10:00,2023-06-05,09:25,5,4,9
5,2023-06-05T09:25:00+10:00,2023-06-05,09:25,3,8,11
8,2023-06-05T09:25:00+10:00,2023-06-05,09:25,5,2,7
39,2023-06-05T09:25:00+10:00,2023-06-05,09:25,2,3,5
40,2023-06-05T09:25:00+10:00,2023-06-05,09:25,1,9,10
44,2023-06-05T09:25:00+10:00,2023-06-05,09:25,0,1,1
65,2023-06-05T09:25:00+10:00,2023-06-05,09:25,4,3,7
71,2023-06-05T09:25:00+10:00,2023-06-05,09:25,0,2,2
77,2023-06-05T09:25:00+10:00,2023-06-05,09:25,0,5,5
9,2023-06-05T09:25:00+10:00,2023-06-05,09:25,1,11,12
10,2023-06-05T09:25:00+10:00,2023-06-05,09:25,0,2,2
18,2023-06-05T09:25:00+10:00,2023-06-05,09:25,1,9,10
19,2023-06-05T09:25:00+10:00,2023-06-05,09:25,1,1,2
24,2023-06-05T09:25:00+10:00,2023-06-05,09:25,13,7,20
46,2023-06-05T09:25:00+10:00,2023-06-05,09:25,0,2,2
48,2023-06-05T09:25:00+10:00,2023-06-05,09:25,1,0,1
49,2023-06-05T09:25:00+10:00,2023-06-05,09:25,1,0,1
53,2023-06-05T09:25:00+10:00,2023-06-05,09:25,1,4,5
67,2023-06-05T09:25:00+10:00,2023-06-05,09:25,8,4,12
72,2023-06-05T09:25:00+10:00,2023-06-05,09:25,1,0,1
79,2023-06-05T09:25:00+10:00,2023-06-05,09:25,8,1,9
85,2023-06-05T09:25:00+10:00,2023-06-05,09:25,2,0,2
4,2023-06-05T09:24:00+10:00,2023-06-05,09:24,4,4,8
8,2023-06-05T09:24:00+10:00,2023-06-05,09:24,4,0,4
21,2023-06-05T09:24:00+10:00,2023-06-05,09:24,0,2,2
29,2023-06-05T09:24:00+10:00,2023-06-05,09:24,2,2,4
40,2023-06-05T09:24:00+10:00,2023-06-05,09:24,6,1,7
41,2023-06-05T09:24:00+10:00,2023-06-05,09:24,34,5,39
54,2023-06-05T09:24:00+10:00,2023-06-05,09:24,1,0,1
65,2023-06-05T09:24:00+10:00,2023-06-05,09:24,11,1,12
69,2023-06-05T09:24:00+10:00,2023-06-05,09:24,1,1,2
70,2023-06-05T09:24:00+10:00,2023-06-05,09:24,0,1,1
75,2023-06-05T09:24:00+10:00,2023-06-05,09:24,0,1,1
1,2023-06-05T09:24:00+10:00,2023-06-05,09:24,3,3,6
2,2023-06-05T09:24:00+10:00,2023-06-05,09:24,3,2,5
19,2023-06-05T09:24:00+10:00,2023-06-05,09:24,1,2,3
68,2023-06-05T09:24:00+10:00,2023-06-05,09:24,2,2,4
85,2023-06-05T09:24:00+10:00,2023-06-05,09:24,1,3,4
3,2023-06-05T09:24:00+10:00,2023-06-05,09:24,5,2,7
28,2023-06-05T09:24:00+10:00,2023-06-05,09:24,5,5,10
42,2023-06-05T09:24:00+10:00,2023-06-05,09:24,4,1,5
61,2023-06-05T09:24:00+10:00,2023-06-05,09:24,5,5,10
66,2023-06-05T09:24:00+10:00,2023-06-05,09:24,3,6,9
71,2023-06-05T09:24:00+10:00,2023-06-05,09:24,1,0,1
108,2023-06-05T09:24:00+10:00,2023-06-05,09:24,4,11,15
9,2023-06-05T09:24:00+10:00,2023-06-05,09:24,0,18,18
10,2023-06-05T09:24:00+10:00,2023-06-05,09:24,2,3,5
12,2023-06-05T09:24:00+10:00,2023-06-05,09:24,1,1,2
18,2023-06-05T09:24:00+10:00,2023-06-05,09:24,4,8,12
48,2023-06-05T09:24:00+10:00,2023-06-05,09:24,1,2,3
49,2023-06-05T09:24:00+10:00,2023-06-05,09:24,2,1,3
53,2023-06-05T09:24:00+10:00,2023-06-05,09:24,4,3,7
57,2023-06-05T09:24:00+10:00,2023-06-05,09:24,2,4,6
58,2023-06-05T09:24:00+10:00,2023-06-05,09:24,1,0,1
62,2023-06-05T09:24:00+10:00,2023-06-05,09:24,1,3,4
72,2023-06-05T09:24:00+10:00,2023-06-05,09:24,1,1,2
86,2023-06-05T09:24:00+10:00,2023-06-05,09:24,2,0,2
5,2023-06-05T09:24:00+10:00,2023-06-05,09:24,4,2,6
6,2023-06-05T09:24:00+10:00,2023-06-05,09:24,4,7,11
14,2023-06-05T09:24:00+10:00,2023-06-05,09:24,5,1,6
26,2023-06-05T09:24:00+10:00,2023-06-05,09:24,1,1,2
36,2023-06-05T09:24:00+10:00,2023-06-05,09:24,8,2,10
37,2023-06-05T09:24:00+10:00,2023-06-05,09:24,0,1,1
39,2023-06-05T09:24:00+10:00,2023-06-05,09:24,1,1,2
44,2023-06-05T09:24:00+10:00,2023-06-05,09:24,0,1,1
45,2023-06-05T09:24:00+10:00,2023-06-05,09:24,1,1,2
47,2023-06-05T09:24:00+10:00,2023-06-05,09:24,3,12,15
50,2023-06-05T09:24:00+10:00,2023-06-05,09:24,1,3,4
55,2023-06-05T09:24:00+10:00,2023-06-05,09:24,9,10,19
87,2023-06-05T09:24:00+10:00,2023-06-05,09:24,0,4,4
17,2023-06-05T09:24:00+10:00,2023-06-05,09:24,5,2,7
20,2023-06-05T09:24:00+10:00,2023-06-05,09:24,3,0,3
23,2023-06-05T09:24:00+10:00,2023-06-05,09:24,2,6,8
24,2023-06-05T09:24:00+10:00,2023-06-05,09:24,5,4,9
27,2023-06-05T09:24:00+10:00,2023-06-05,09:24,0,3,3
30,2023-06-05T09:24:00+10:00,2023-06-05,09:24,0,3,3
35,2023-06-05T09:24:00+10:00,2023-06-05,09:24,2,4,6
46,2023-06-05T09:24:00+10:00,2023-06-05,09:24,2,2,4
51,2023-06-05T09:24:00+10:00,2023-06-05,09:24,0,1,1
52,2023-06-05T09:24:00+10:00,2023-06-05,09:24,2,5,7
63,2023-06-05T09:24:00+10:00,2023-06-05,09:24,0,1,1
67,2023-06-05T09:24:00+10:00,2023-06-05,09:24,9,8,17
76,2023-06-05T09:24:00+10:00,2023-06-05,09:24,1,1,2
79,2023-06-05T09:24:00+10:00,2023-06-05,09:24,5,5,10
3,2023-06-05T09:23:00+10:00,2023-06-05,09:23,9,1,10
4,2023-06-05T09:23:00+10:00,2023-06-05,09:23,10,6,16
26,2023-06-05T09:23:00+10:00,2023-06-05,09:23,4,0,4
28,2023-06-05T09:23:00+10:00,2023-06-05,09:23,2,2,4
44,2023-06-05T09:23:00+10:00,2023-06-05,09:23,0,1,1
47,2023-06-05T09:23:00+10:00,2023-06-05,09:23,4,5,9
50,2023-06-05T09:23:00+10:00,2023-06-05,09:23,1,2,3
2,2023-06-05T09:23:00+10:00,2023-06-05,09:23,4,5,9
10,2023-06-05T09:23:00+10:00,2023-06-05,09:23,0,1,1
17,2023-06-05T09:23:00+10:00,2023-06-05,09:23,15,2,17
23,2023-06-05T09:23:00+10:00,2023-06-05,09:23,10,0,10
24,2023-06-05T09:23:00+10:00,2023-06-05,09:23,21,3,24
30,2023-06-05T09:23:00+10:00,2023-06-05,09:23,0,3,3
49,2023-06-05T09:23:00+10:00,2023-06-05,09:23,1,2,3
51,2023-06-05T09:23:00+10:00,2023-06-05,09:23,6,5,11
52,2023-06-05T09:23:00+10:00,2023-06-05,09:23,1,3,4
53,2023-06-05T09:23:00+10:00,2023-06-05,09:23,11,6,17
58,2023-06-05T09:23:00+10:00,2023-06-05,09:23,17,3,20
63,2023-06-05T09:23:00+10:00,2023-06-05,09:23,1,1,2
67,2023-06-05T09:23:00+10:00,2023-06-05,09:23,5,9,14
6,2023-06-05T09:23:00+10:00,2023-06-05,09:23,6,3,9
14,2023-06-05T09:23:00+10:00,2023-06-05,09:23,2,2,4
29,2023-06-05T09:23:00+10:00,2023-06-05,09:23,1,2,3
36,2023-06-05T09:23:00+10:00,2023-06-05,09:23,3,2,5
39,2023-06-05T09:23:00+10:00,2023-06-05,09:23,1,0,1
41,2023-06-05T09:23:00+10:00,2023-06-05,09:23,42,12,54
42,2023-06-05T09:23:00+10:00,2023-06-05,09:23,2,0,2
45,2023-06-05T09:23:00+10:00,2023-06-05,09:23,4,12,16
61,2023-06-05T09:23:00+10:00,2023-06-05,09:23,1,0,1
66,2023-06-05T09:23:00+10:00,2023-06-05,09:23,8,8,16
77,2023-06-05T09:23:00+10:00,2023-06-05,09:23,3,0,3
78,2023-06-05T09:23:00+10:00,2023-06-05,09:23,1,0,1
12,2023-06-05T09:23:00+10:00,2023-06-05,09:23,3,0,3
27,2023-06-05T09:23:00+10:00,2023-06-05,09:23,0,1,1
46,2023-06-05T09:23:00+10:00,2023-06-05,09:23,0,1,1
56,2023-06-05T09:23:00+10:00,2023-06-05,09:23,1,0,1
57,2023-06-05T09:23:00+10:00,2023-06-05,09:23,2,10,12
62,2023-06-05T09:23:00+10:00,2023-06-05,09:23,4,0,4
72,2023-06-05T09:23:00+10:00,2023-06-05,09:23,9,0,9
79,2023-06-05T09:23:00+10:00,2023-06-05,09:23,4,4,8
85,2023-06-05T09:23:00+10:00,2023-06-05,09:23,2,1,3
5,2023-06-05T09:23:00+10:00,2023-06-05,09:23,5,4,9
8,2023-06-05T09:23:00+10:00,2023-06-05,09:23,4,2,6
21,2023-06-05T09:23:00+10:00,2023-06-05,09:23,0,2,2
37,2023-06-05T09:23:00+10:00,2023-06-05,09:23,1,0,1
40,2023-06-05T09:23:00+10:00,2023-06-05,09:23,2,2,4
54,2023-06-05T09:23:00+10:00,2023-06-05,09:23,1,0,1
55,2023-06-05T09:23:00+10:00,2023-06-05,09:23,1,9,10
65,2023-06-05T09:23:00+10:00,2023-06-05,09:23,12,1,13
69,2023-06-05T09:23:00+10:00,2023-06-05,09:23,2,1,3
108,2023-06-05T09:23:00+10:00,2023-06-05,09:23,7,4,11
1,2023-06-05T09:23:00+10:00,2023-06-05,09:23,3,1,4
9,2023-06-05T09:23:00+10:00,2023-06-05,09:23,0,29,29
20,2023-06-05T09:23:00+10:00,2023-06-05,09:23,3,0,3
35,2023-06-05T09:23:00+10:00,2023-06-05,09:23,2,6,8
48,2023-06-05T09:23:00+10:00,2023-06-05,09:23,2,1,3
68,2023-06-05T09:23:00+10:00,2023-06-05,09:23,4,6,10
86,2023-06-05T09:23:00+10:00,2023-06-05,09:23,0,2,2
4,2023-06-05T09:22:00+10:00,2023-06-05,09:22,7,6,13
6,2023-06-05T09:22:00+10:00,2023-06-05,09:22,2,6,8
31,2023-06-05T09:22:00+10:00,2023-06-05,09:22,1,0,1
36,2023-06-05T09:22:00+10:00,2023-06-05,09:22,2,4,6
45,2023-06-05T09:22:00+10:00,2023-06-05,09:22,3,6,9
47,2023-06-05T09:22:00+10:00,2023-06-05,09:22,7,1,8
54,2023-06-05T09:22:00+10:00,2023-06-05,09:22,1,0,1
55,2023-06-05T09:22:00+10:00,2023-06-05,09:22,2,2,4
65,2023-06-05T09:22:00+10:00,2023-06-05,09:22,2,7,9
70,2023-06-05T09:22:00+10:00,2023-06-05,09:22,0,1,1
75,2023-06-05T09:22:00+10:00,2023-06-05,09:22,4,1,5
77,2023-06-05T09:22:00+10:00,2023-06-05,09:22,1,1,2
12,2023-06-05T09:22:00+10:00,2023-06-05,09:22,1,1,2
35,2023-06-05T09:22:00+10:00,2023-06-05,09:22,4,11,15
46,2023-06-05T09:22:00+10:00,2023-06-05,09:22,1,2,3
48,2023-06-05T09:22:00+10:00,2023-06-05,09:22,2,0,2
49,2023-06-05T09:22:00+10:00,2023-06-05,09:22,2,1,3
51,2023-06-05T09:22:00+10:00,2023-06-05,09:22,3,1,4
52,2023-06-05T09:22:00+10:00,2023-06-05,09:22,7,1,8
53,2023-06-05T09:22:00+10:00,2023-06-05,09:22,7,4,11
56,2023-06-05T09:22:00+10:00,2023-06-05,09:22,1,1,2
68,2023-06-05T09:22:00+10:00,2023-06-05,09:22,4,4,8
76,2023-06-05T09:22:00+10:00,2023-06-05,09:22,5,0,5
5,2023-06-05T09:22:00+10:00,2023-06-05,09:22,1,6,7
28,2023-06-05T09:22:00+10:00,2023-06-05,09:22,9,2,11
29,2023-06-05T09:22:00+10:00,2023-06-05,09:22,0,2,2
37,2023-06-05T09:22:00+10:00,2023-06-05,09:22,0,2,2
39,2023-06-05T09:22:00+10:00,2023-06-05,09:22,0,1,1
50,2023-06-05T09:22:00+10:00,2023-06-05,09:22,2,4,6
66,2023-06-05T09:22:00+10:00,2023-06-05,09:22,5,6,11
78,2023-06-05T09:22:00+10:00,2023-06-05,09:22,3,0,3
2,2023-06-05T09:22:00+10:00,2023-06-05,09:22,1,0,1
11,2023-06-05T09:22:00+10:00,2023-06-05,09:22,0,3,3
18,2023-06-05T09:22:00+10:00,2023-06-05,09:22,1,13,14
23,2023-06-05T09:22:00+10:00,2023-06-05,09:22,6,3,9
30,2023-06-05T09:22:00+10:00,2023-06-05,09:22,0,1,1
57,2023-06-05T09:22:00+10:00,2023-06-05,09:22,4,5,9
62,2023-06-05T09:22:00+10:00,2023-06-05,09:22,5,1,6
63,2023-06-05T09:22:00+10:00,2023-06-05,09:22,3,2,5
67,2023-06-05T09:22:00+10:00,2023-06-05,09:22,15,4,19
79,2023-06-05T09:22:00+10:00,2023-06-05,09:22,2,6,8
3,2023-06-05T09:22:00+10:00,2023-06-05,09:22,2,1,3
8,2023-06-05T09:22:00+10:00,2023-06-05,09:22,2,1,3
14,2023-06-05T09:22:00+10:00,2023-06-05,09:22,4,2,6
26,2023-06-05T09:22:00+10:00,2023-06-05,09:22,0,4,4
40,2023-06-05T09:22:00+10:00,2023-06-05,09:22,0,2,2
41,2023-06-05T09:22:00+10:00,2023-06-05,09:22,18,6,24
61,2023-06-05T09:22:00+10:00,2023-06-05,09:22,2,7,9
69,2023-06-05T09:22:00+10:00,2023-06-05,09:22,5,3,8
87,2023-06-05T09:22:00+10:00,2023-06-05,09:22,1,0,1
108,2023-06-05T09:22:00+10:00,2023-06-05,09:22,0,11,11
1,2023-06-05T09:22:00+10:00,2023-06-05,09:22,1,8,9
9,2023-06-05T09:22:00+10:00,2023-06-05,09:22,3,15,18
10,2023-06-05T09:22:00+10:00,2023-06-05,09:22,2,6,8
17,2023-06-05T09:22:00+10:00,2023-06-05,09:22,5,1,6
19,2023-06-05T09:22:00+10:00,2023-06-05,09:22,2,0,2
24,2023-06-05T09:22:00+10:00,2023-06-05,09:22,14,9,23
27,2023-06-05T09:22:00+10:00,2023-06-05,09:22,1,0,1
58,2023-06-05T09:22:00+10:00,2023-06-05,09:22,4,1,5
72,2023-06-05T09:22:00+10:00,2023-06-05,09:22,2,1,3
85,2023-06-05T09:22:00+10:00,2023-06-05,09:22,3,0,3
3,2023-06-05T09:21:00+10:00,2023-06-05,09:21,2,4,6
4,2023-06-05T09:21:00+10:00,2023-06-05,09:21,13,10,23
26,2023-06-05T09:21:00+10:00,2023-06-05,09:21,6,3,9
39,2023-06-05T09:21:00+10:00,2023-06-05,09:21,3,4,7
41,2023-06-05T09:21:00+10:00,2023-06-05,09:21,10,9,19
61,2023-06-05T09:21:00+10:00,2023-06-05,09:21,2,4,6
71,2023-06-05T09:21:00+10:00,2023-06-05,09:21,2,0,2
2,2023-06-05T09:21:00+10:00,2023-06-05,09:21,1,2,3
9,2023-06-05T09:21:00+10:00,2023-06-05,09:21,2,20,22
12,2023-06-05T09:21:00+10:00,2023-06-05,09:21,1,1,2
18,2023-06-05T09:21:00+10:00,2023-06-05,09:21,4,17,21
19,2023-06-05T09:21:00+10:00,2023-06-05,09:21,1,0,1
24,2023-06-05T09:21:00+10:00,2023-06-05,09:21,23,10,33
30,2023-06-05T09:21:00+10:00,2023-06-05,09:21,0,1,1
35,2023-06-05T09:21:00+10:00,2023-06-05,09:21,8,4,12
52,2023-06-05T09:21:00+10:00,2023-06-05,09:21,2,3,5
58,2023-06-05T09:21:00+10:00,2023-06-05,09:21,15,0,15
67,2023-06-05T09:21:00+10:00,2023-06-05,09:21,7,3,10
72,2023-06-05T09:21:00+10:00,2023-06-05,09:21,3,1,4
79,2023-06-05T09:21:00+10:00,2023-06-05,09:21,8,4,12
85,2023-06-05T09:21:00+10:00,2023-06-05,09:21,2,0,2
86,2023-06-05T09:21:00+10:00,2023-06-05,09:21,1,1,2
6,2023-06-05T09:21:00+10:00,2023-06-05,09:21,7,12,19
8,2023-06-05T09:21:00+10:00,2023-06-05,09:21,3,1,4
14,2023-06-05T09:21:00+10:00,2023-06-05,09:21,2,0,2
29,2023-06-05T09:21:00+10:00,2023-06-05,09:21,2,0,2
36,2023-06-05T09:21:00+10:00,2023-06-05,09:21,5,4,9
40,2023-06-05T09:21:00+10:00,2023-06-05,09:21,1,2,3
42,2023-06-05T09:21:00+10:00,2023-06-05,09:21,1,3,4
45,2023-06-05T09:21:00+10:00,2023-06-05,09:21,6,5,11
47,2023-06-05T09:21:00+10:00,2023-06-05,09:21,6,18,24
54,2023-06-05T09:21:00+10:00,2023-06-05,09:21,2,0,2
66,2023-06-05T09:21:00+10:00,2023-06-05,09:21,3,11,14
77,2023-06-05T09:21:00+10:00,2023-06-05,09:21,1,1,2
78,2023-06-05T09:21:00+10:00,2023-06-05,09:21,1,0,1
1,2023-06-05T09:21:00+10:00,2023-06-05,09:21,8,2,10
17,2023-06-05T09:21:00+10:00,2023-06-05,09:21,15,2,17
23,2023-06-05T09:21:00+10:00,2023-06-05,09:21,14,4,18
48,2023-06-05T09:21:00+10:00,2023-06-05,09:21,0,1,1
51,2023-06-05T09:21:00+10:00,2023-06-05,09:21,1,1,2
57,2023-06-05T09:21:00+10:00,2023-06-05,09:21,4,6,10
68,2023-06-05T09:21:00+10:00,2023-06-05,09:21,2,2,4
5,2023-06-05T09:21:00+10:00,2023-06-05,09:21,4,10,14
21,2023-06-05T09:21:00+10:00,2023-06-05,09:21,1,2,3
28,2023-06-05T09:21:00+10:00,2023-06-05,09:21,1,4,5
31,2023-06-05T09:21:00+10:00,2023-06-05,09:21,1,1,2
50,2023-06-05T09:21:00+10:00,2023-06-05,09:21,2,1,3
55,2023-06-05T09:21:00+10:00,2023-06-05,09:21,8,9,17
65,2023-06-05T09:21:00+10:00,2023-06-05,09:21,4,1,5
69,2023-06-05T09:21:00+10:00,2023-06-05,09:21,2,1,3
70,2023-06-05T09:21:00+10:00,2023-06-05,09:21,0,1,1
87,2023-06-05T09:21:00+10:00,2023-06-05,09:21,1,1,2
108,2023-06-05T09:21:00+10:00,2023-06-05,09:21,6,5,11
10,2023-06-05T09:21:00+10:00,2023-06-05,09:21,6,3,9
11,2023-06-05T09:21:00+10:00,2023-06-05,09:21,1,0,1
27,2023-06-05T09:21:00+10:00,2023-06-05,09:21,0,1,1
49,2023-06-05T09:21:00+10:00,2023-06-05,09:21,2,0,2
53,2023-06-05T09:21:00+10:00,2023-06-05,09:21,7,2,9
62,2023-06-05T09:21:00+10:00,2023-06-05,09:21,0,3,3
63,2023-06-05T09:21:00+10:00,2023-06-05,09:21,1,2,3
76,2023-06-05T09:21:00+10:00,2023-06-05,09:21,0,2,2
14,2023-06-05T09:20:00+10:00,2023-06-05,09:20,2,2,4
29,2023-06-05T09:20:00+10:00,2023-06-05,09:20,3,0,3
36,2023-06-05T09:20:00+10:00,2023-06-05,09:20,9,6,15
45,2023-06-05T09:20:00+10:00,2023-06-05,09:20,3,5,8
47,2023-06-05T09:20:00+10:00,2023-06-05,09:20,2,19,21
54,2023-06-05T09:20:00+10:00,2023-06-05,09:20,1,0,1
55,2023-06-05T09:20:00+10:00,2023-06-05,09:20,6,4,10
59,2023-06-05T09:20:00+10:00,2023-06-05,09:20,44,18,62
65,2023-06-05T09:20:00+10:00,2023-06-05,09:20,11,4,15
77,2023-06-05T09:20:00+10:00,2023-06-05,09:20,0,3,3
11,2023-06-05T09:20:00+10:00,2023-06-05,09:20,5,2,7
17,2023-06-05T09:20:00+10:00,2023-06-05,09:20,11,1,12
20,2023-06-05T09:20:00+10:00,2023-06-05,09:20,0,2,2
46,2023-06-05T09:20:00+10:00,2023-06-05,09:20,3,3,6
51,2023-06-05T09:20:00+10:00,2023-06-05,09:20,2,0,2
52,2023-06-05T09:20:00+10:00,2023-06-05,09:20,1,1,2
53,2023-06-05T09:20:00+10:00,2023-06-05,09:20,4,5,9
56,2023-06-05T09:20:00+10:00,2023-06-05,09:20,1,1,2
58,2023-06-05T09:20:00+10:00,2023-06-05,09:20,20,3,23
63,2023-06-05T09:20:00+10:00,2023-06-05,09:20,6,1,7
67,2023-06-05T09:20:00+10:00,2023-06-05,09:20,9,8,17
109,2023-06-05T09:20:00+10:00,2023-06-05,09:20,5,36,41
117,2023-06-05T09:20:00+10:00,2023-06-05,09:20,11,1,12
3,2023-06-05T09:20:00+10:00,2023-06-05,09:20,2,4,6
5,2023-06-05T09:20:00+10:00,2023-06-05,09:20,2,3,5
8,2023-06-05T09:20:00+10:00,2023-06-05,09:20,1,1,2
26,2023-06-05T09:20:00+10:00,2023-06-05,09:20,3,5,8
31,2023-06-05T09:20:00+10:00,2023-06-05,09:20,2,1,3
42,2023-06-05T09:20:00+10:00,2023-06-05,09:20,0,4,4
50,2023-06-05T09:20:00+10:00,2023-06-05,09:20,5,2,7
61,2023-06-05T09:20:00+10:00,2023-06-05,09:20,3,1,4
69,2023-06-05T09:20:00+10:00,2023-06-05,09:20,11,3,14
84,2023-06-05T09:20:00+10:00,2023-06-05,09:20,57,15,72
87,2023-06-05T09:20:00+10:00,2023-06-05,09:20,1,0,1
107,2023-06-05T09:20:00+10:00,2023-06-05,09:20,4,18,22
118,2023-06-05T09:20:00+10:00,2023-06-05,09:20,3,0,3
1,2023-06-05T09:20:00+10:00,2023-06-05,09:20,8,5,13
18,2023-06-05T09:20:00+10:00,2023-06-05,09:20,1,12,13
24,2023-06-05T09:20:00+10:00,2023-06-05,09:20,15,0,15
48,2023-06-05T09:20:00+10:00,2023-06-05,09:20,2,0,2
49,2023-06-05T09:20:00+10:00,2023-06-05,09:20,0,1,1
68,2023-06-05T09:20:00+10:00,2023-06-05,09:20,4,0,4
72,2023-06-05T09:20:00+10:00,2023-06-05,09:20,7,2,9
79,2023-06-05T09:20:00+10:00,2023-06-05,09:20,7,6,13
85,2023-06-05T09:20:00+10:00,2023-06-05,09:20,2,3,5
4,2023-06-05T09:20:00+10:00,2023-06-05,09:20,17,8,25
6,2023-06-05T09:20:00+10:00,2023-06-05,09:20,12,13,25
21,2023-06-05T09:20:00+10:00,2023-06-05,09:20,4,0,4
28,2023-06-05T09:20:00+10:00,2023-06-05,09:20,5,1,6
40,2023-06-05T09:20:00+10:00,2023-06-05,09:20,1,6,7
41,2023-06-05T09:20:00+10:00,2023-06-05,09:20,18,5,23
66,2023-06-05T09:20:00+10:00,2023-06-05,09:20,1,10,11
70,2023-06-05T09:20:00+10:00,2023-06-05,09:20,1,2,3
71,2023-06-05T09:20:00+10:00,2023-06-05,09:20,1,0,1
75,2023-06-05T09:20:00+10:00,2023-06-05,09:20,0,1,1
108,2023-06-05T09:20:00+10:00,2023-06-05,09:20,5,11,16
2,2023-06-05T09:20:00+10:00,2023-06-05,09:20,1,1,2
9,2023-06-05T09:20:00+10:00,2023-06-05,09:20,4,19,23
10,2023-06-05T09:20:00+10:00,2023-06-05,09:20,1,5,6
12,2023-06-05T09:20:00+10:00,2023-06-05,09:20,3,4,7
23,2023-06-05T09:20:00+10:00,2023-06-05,09:20,3,3,6
27,2023-06-05T09:20:00+10:00,2023-06-05,09:20,1,1,2
30,2023-06-05T09:20:00+10:00,2023-06-05,09:20,5,1,6
35,2023-06-05T09:20:00+10:00,2023-06-05,09:20,4,3,7
57,2023-06-05T09:20:00+10:00,2023-06-05,09:20,5,9,14
62,2023-06-05T09:20:00+10:00,2023-06-05,09:20,0,3,3
76,2023-06-05T09:20:00+10:00,2023-06-05,09:20,1,0,1
3,2023-06-05T09:19:00+10:00,2023-06-05,09:19,1,3,4
21,2023-06-05T09:19:00+10:00,2023-06-05,09:19,2,1,3
29,2023-06-05T09:19:00+10:00,2023-06-05,09:19,0,2,2
44,2023-06-05T09:19:00+10:00,2023-06-05,09:19,0,1,1
55,2023-06-05T09:19:00+10:00,2023-06-05,09:19,5,5,10
61,2023-06-05T09:19:00+10:00,2023-06-05,09:19,3,10,13
65,2023-06-05T09:19:00+10:00,2023-06-05,09:19,33,2,35
75,2023-06-05T09:19:00+10:00,2023-06-05,09:19,1,0,1
77,2023-06-05T09:19:00+10:00,2023-06-05,09:19,1,1,2
78,2023-06-05T09:19:00+10:00,2023-06-05,09:19,0,1,1
1,2023-06-05T09:19:00+10:00,2023-06-05,09:19,3,5,8
2,2023-06-05T09:19:00+10:00,2023-06-05,09:19,0,2,2
9,2023-06-05T09:19:00+10:00,2023-06-05,09:19,3,15,18
19,2023-06-05T09:19:00+10:00,2023-06-05,09:19,4,0,4
30,2023-06-05T09:19:00+10:00,2023-06-05,09:19,0,8,8
46,2023-06-05T09:19:00+10:00,2023-06-05,09:19,0,1,1
58,2023-06-05T09:19:00+10:00,2023-06-05,09:19,2,0,2
62,2023-06-05T09:19:00+10:00,2023-06-05,09:19,0,3,3
68,2023-06-05T09:19:00+10:00,2023-06-05,09:19,1,2,3
86,2023-06-05T09:19:00+10:00,2023-06-05,09:19,1,2,3
6,2023-06-05T09:19:00+10:00,2023-06-05,09:19,8,5,13
8,2023-06-05T09:19:00+10:00,2023-06-05,09:19,2,0,2
28,2023-06-05T09:19:00+10:00,2023-06-05,09:19,2,3,5
37,2023-06-05T09:19:00+10:00,2023-06-05,09:19,2,1,3
40,2023-06-05T09:19:00+10:00,2023-06-05,09:19,4,3,7
41,2023-06-05T09:19:00+10:00,2023-06-05,09:19,9,4,13
42,2023-06-05T09:19:00+10:00,2023-06-05,09:19,2,0,2
47,2023-06-05T09:19:00+10:00,2023-06-05,09:19,1,11,12
54,2023-06-05T09:19:00+10:00,2023-06-05,09:19,2,0,2
66,2023-06-05T09:19:00+10:00,2023-06-05,09:19,4,6,10
70,2023-06-05T09:19:00+10:00,2023-06-05,09:19,1,1,2
71,2023-06-05T09:19:00+10:00,2023-06-05,09:19,0,1,1
108,2023-06-05T09:19:00+10:00,2023-06-05,09:19,3,4,7
12,2023-06-05T09:19:00+10:00,2023-06-05,09:19,2,2,4
23,2023-06-05T09:19:00+10:00,2023-06-05,09:19,4,5,9
35,2023-06-05T09:19:00+10:00,2023-06-05,09:19,4,7,11
49,2023-06-05T09:19:00+10:00,2023-06-05,09:19,0,1,1
53,2023-06-05T09:19:00+10:00,2023-06-05,09:19,2,2,4
57,2023-06-05T09:19:00+10:00,2023-06-05,09:19,3,7,10
63,2023-06-05T09:19:00+10:00,2023-06-05,09:19,1,1,2
79,2023-06-05T09:19:00+10:00,2023-06-05,09:19,4,3,7
4,2023-06-05T09:19:00+10:00,2023-06-05,09:19,8,9,17
5,2023-06-05T09:19:00+10:00,2023-06-05,09:19,2,6,8
14,2023-06-05T09:19:00+10:00,2023-06-05,09:19,1,7,8
26,2023-06-05T09:19:00+10:00,2023-06-05,09:19,2,1,3
36,2023-06-05T09:19:00+10:00,2023-06-05,09:19,3,3,6
45,2023-06-05T09:19:00+10:00,2023-06-05,09:19,6,1,7
50,2023-06-05T09:19:00+10:00,2023-06-05,09:19,0,1,1
69,2023-06-05T09:19:00+10:00,2023-06-05,09:19,3,1,4
10,2023-06-05T09:19:00+10:00,2023-06-05,09:19,2,0,2
17,2023-06-05T09:19:00+10:00,2023-06-05,09:19,13,0,13
18,2023-06-05T09:19:00+10:00,2023-06-05,09:19,2,13,15
24,2023-06-05T09:19:00+10:00,2023-06-05,09:19,8,3,11
48,2023-06-05T09:19:00+10:00,2023-06-05,09:19,1,1,2
51,2023-06-05T09:19:00+10:00,2023-06-05,09:19,1,0,1
52,2023-06-05T09:19:00+10:00,2023-06-05,09:19,0,2,2
56,2023-06-05T09:19:00+10:00,2023-06-05,09:19,2,0,2
67,2023-06-05T09:19:00+10:00,2023-06-05,09:19,12,5,17
72,2023-06-05T09:19:00+10:00,2023-06-05,09:19,1,5,6
3,2023-06-05T09:18:00+10:00,2023-06-05,09:18,3,6,9
8,2023-06-05T09:18:00+10:00,2023-06-05,09:18,3,3,6
21,2023-06-05T09:18:00+10:00,2023-06-05,09:18,1,1,2
29,2023-06-05T09:18:00+10:00,2023-06-05,09:18,0,2,2
50,2023-06-05T09:18:00+10:00,2023-06-05,09:18,1,2,3
61,2023-06-05T09:18:00+10:00,2023-06-05,09:18,10,2,12
65,2023-06-05T09:18:00+10:00,2023-06-05,09:18,20,6,26
70,2023-06-05T09:18:00+10:00,2023-06-05,09:18,1,0,1
75,2023-06-05T09:18:00+10:00,2023-06-05,09:18,1,0,1
87,2023-06-05T09:18:00+10:00,2023-06-05,09:18,2,1,3
108,2023-06-05T09:18:00+10:00,2023-06-05,09:18,3,9,12
20,2023-06-05T09:18:00+10:00,2023-06-05,09:18,1,0,1
24,2023-06-05T09:18:00+10:00,2023-06-05,09:18,20,16,36
57,2023-06-05T09:18:00+10:00,2023-06-05,09:18,2,2,4
58,2023-06-05T09:18:00+10:00,2023-06-05,09:18,23,1,24
4,2023-06-05T09:18:00+10:00,2023-06-05,09:18,10,8,18
6,2023-06-05T09:18:00+10:00,2023-06-05,09:18,5,4,9
14,2023-06-05T09:18:00+10:00,2023-06-05,09:18,3,3,6
26,2023-06-05T09:18:00+10:00,2023-06-05,09:18,3,0,3
36,2023-06-05T09:18:00+10:00,2023-06-05,09:18,4,2,6
37,2023-06-05T09:18:00+10:00,2023-06-05,09:18,0,2,2
39,2023-06-05T09:18:00+10:00,2023-06-05,09:18,4,1,5
40,2023-06-05T09:18:00+10:00,2023-06-05,09:18,3,1,4
41,2023-06-05T09:18:00+10:00,2023-06-05,09:18,21,8,29
44,2023-06-05T09:18:00+10:00,2023-06-05,09:18,0,1,1
45,2023-06-05T09:18:00+10:00,2023-06-05,09:18,1,7,8
47,2023-06-05T09:18:00+10:00,2023-06-05,09:18,2,4,6
66,2023-06-05T09:18:00+10:00,2023-06-05,09:18,0,7,7
12,2023-06-05T09:18:00+10:00,2023-06-05,09:18,3,1,4
18,2023-06-05T09:18:00+10:00,2023-06-05,09:18,6,9,15
27,2023-06-05T09:18:00+10:00,2023-06-05,09:18,3,0,3
35,2023-06-05T09:18:00+10:00,2023-06-05,09:18,6,20,26
53,2023-06-05T09:18:00+10:00,2023-06-05,09:18,3,6,9
56,2023-06-05T09:18:00+10:00,2023-06-05,09:18,1,1,2
63,2023-06-05T09:18:00+10:00,2023-06-05,09:18,3,3,6
67,2023-06-05T09:18:00+10:00,2023-06-05,09:18,9,5,14
72,2023-06-05T09:18:00+10:00,2023-06-05,09:18,7,2,9
76,2023-06-05T09:18:00+10:00,2023-06-05,09:18,0,3,3
5,2023-06-05T09:18:00+10:00,2023-06-05,09:18,2,1,3
28,2023-06-05T09:18:00+10:00,2023-06-05,09:18,10,2,12
31,2023-06-05T09:18:00+10:00,2023-06-05,09:18,0,1,1
42,2023-06-05T09:18:00+10:00,2023-06-05,09:18,3,1,4
55,2023-06-05T09:18:00+10:00,2023-06-05,09:18,6,3,9
69,2023-06-05T09:18:00+10:00,2023-06-05,09:18,0,3,3
77,2023-06-05T09:18:00+10:00,2023-06-05,09:18,1,1,2
1,2023-06-05T09:18:00+10:00,2023-06-05,09:18,7,5,12
2,2023-06-05T09:18:00+10:00,2023-06-05,09:18,4,2,6
9,2023-06-05T09:18:00+10:00,2023-06-05,09:18,1,10,11
10,2023-06-05T09:18:00+10:00,2023-06-05,09:18,1,0,1
11,2023-06-05T09:18:00+10:00,2023-06-05,09:18,2,0,2
17,2023-06-05T09:18:00+10:00,2023-06-05,09:18,9,1,10
19,2023-06-05T09:18:00+10:00,2023-06-05,09:18,2,2,4
23,2023-06-05T09:18:00+10:00,2023-06-05,09:18,12,1,13
46,2023-06-05T09:18:00+10:00,2023-06-05,09:18,1,1,2
48,2023-06-05T09:18:00+10:00,2023-06-05,09:18,0,4,4
52,2023-06-05T09:18:00+10:00,2023-06-05,09:18,2,5,7
62,2023-06-05T09:18:00+10:00,2023-06-05,09:18,0,1,1
68,2023-06-05T09:18:00+10:00,2023-06-05,09:18,2,1,3
79,2023-06-05T09:18:00+10:00,2023-06-05,09:18,9,7,16
4,2023-06-05T09:17:00+10:00,2023-06-05,09:17,8,1,9
14,2023-06-05T09:17:00+10:00,2023-06-05,09:17,7,5,12
26,2023-06-05T09:17:00+10:00,2023-06-05,09:17,1,3,4
28,2023-06-05T09:17:00+10:00,2023-06-05,09:17,5,3,8
31,2023-06-05T09:17:00+10:00,2023-06-05,09:17,0,2,2
37,2023-06-05T09:17:00+10:00,2023-06-05,09:17,0,1,1
42,2023-06-05T09:17:00+10:00,2023-06-05,09:17,1,1,2
45,2023-06-05T09:17:00+10:00,2023-06-05,09:17,0,5,5
47,2023-06-05T09:17:00+10:00,2023-06-05,09:17,4,15,19
55,2023-06-05T09:17:00+10:00,2023-06-05,09:17,3,4,7
61,2023-06-05T09:17:00+10:00,2023-06-05,09:17,5,9,14
77,2023-06-05T09:17:00+10:00,2023-06-05,09:17,3,5,8
108,2023-06-05T09:17:00+10:00,2023-06-05,09:17,0,14,14
17,2023-06-05T09:17:00+10:00,2023-06-05,09:17,9,1,10
18,2023-06-05T09:17:00+10:00,2023-06-05,09:17,5,13,18
24,2023-06-05T09:17:00+10:00,2023-06-05,09:17,13,7,20
46,2023-06-05T09:17:00+10:00,2023-06-05,09:17,0,3,3
48,2023-06-05T09:17:00+10:00,2023-06-05,09:17,2,1,3
51,2023-06-05T09:17:00+10:00,2023-06-05,09:17,2,5,7
52,2023-06-05T09:17:00+10:00,2023-06-05,09:17,2,6,8
58,2023-06-05T09:17:00+10:00,2023-06-05,09:17,33,2,35
67,2023-06-05T09:17:00+10:00,2023-06-05,09:17,6,9,15
41,2023-06-05T09:17:00+10:00,2023-06-05,09:17,35,4,39
44,2023-06-05T09:17:00+10:00,2023-06-05,09:17,1,2,3
50,2023-06-05T09:17:00+10:00,2023-06-05,09:17,2,1,3
65,2023-06-05T09:17:00+10:00,2023-06-05,09:17,14,5,19
66,2023-06-05T09:17:00+10:00,2023-06-05,09:17,5,10,15
71,2023-06-05T09:17:00+10:00,2023-06-05,09:17,0,2,2
1,2023-06-05T09:17:00+10:00,2023-06-05,09:17,8,5,13
2,2023-06-05T09:17:00+10:00,2023-06-05,09:17,3,1,4
10,2023-06-05T09:17:00+10:00,2023-06-05,09:17,1,3,4
23,2023-06-05T09:17:00+10:00,2023-06-05,09:17,2,4,6
27,2023-06-05T09:17:00+10:00,2023-06-05,09:17,0,1,1
30,2023-06-05T09:17:00+10:00,2023-06-05,09:17,1,1,2
49,2023-06-05T09:17:00+10:00,2023-06-05,09:17,1,0,1
53,2023-06-05T09:17:00+10:00,2023-06-05,09:17,9,6,15
62,2023-06-05T09:17:00+10:00,2023-06-05,09:17,2,1,3
68,2023-06-05T09:17:00+10:00,2023-06-05,09:17,1,1,2
72,2023-06-05T09:17:00+10:00,2023-06-05,09:17,2,0,2
79,2023-06-05T09:17:00+10:00,2023-06-05,09:17,10,8,18
3,2023-06-05T09:17:00+10:00,2023-06-05,09:17,2,6,8
5,2023-06-05T09:17:00+10:00,2023-06-05,09:17,1,2,3
6,2023-06-05T09:17:00+10:00,2023-06-05,09:17,3,7,10
8,2023-06-05T09:17:00+10:00,2023-06-05,09:17,2,0,2
21,2023-06-05T09:17:00+10:00,2023-06-05,09:17,4,0,4
36,2023-06-05T09:17:00+10:00,2023-06-05,09:17,10,1,11
39,2023-06-05T09:17:00+10:00,2023-06-05,09:17,0,1,1
40,2023-06-05T09:17:00+10:00,2023-06-05,09:17,2,6,8
54,2023-06-05T09:17:00+10:00,2023-06-05,09:17,1,0,1
75,2023-06-05T09:17:00+10:00,2023-06-05,09:17,1,0,1
9,2023-06-05T09:17:00+10:00,2023-06-05,09:17,3,30,33
12,2023-06-05T09:17:00+10:00,2023-06-05,09:17,4,1,5
20,2023-06-05T09:17:00+10:00,2023-06-05,09:17,0,1,1
35,2023-06-05T09:17:00+10:00,2023-06-05,09:17,7,11,18
56,2023-06-05T09:17:00+10:00,2023-06-05,09:17,1,1,2
57,2023-06-05T09:17:00+10:00,2023-06-05,09:17,1,4,5
63,2023-06-05T09:17:00+10:00,2023-06-05,09:17,1,6,7
85,2023-06-05T09:17:00+10:00,2023-06-05,09:17,1,2,3
86,2023-06-05T09:17:00+10:00,2023-06-05,09:17,1,0,1
5,2023-06-05T09:16:00+10:00,2023-06-05,09:16,4,5,9
8,2023-06-05T09:16:00+10:00,2023-06-05,09:16,0,1,1
36,2023-06-05T09:16:00+10:00,2023-06-05,09:16,1,1,2
37,2023-06-05T09:16:00+10:00,2023-06-05,09:16,2,1,3
39,2023-06-05T09:16:00+10:00,2023-06-05,09:16,2,1,3
40,2023-06-05T09:16:00+10:00,2023-06-05,09:16,0,1,1
55,2023-06-05T09:16:00+10:00,2023-06-05,09:16,7,7,14
69,2023-06-05T09:16:00+10:00,2023-06-05,09:16,0,4,4
70,2023-06-05T09:16:00+10:00,2023-06-05,09:16,1,0,1
12,2023-06-05T09:16:00+10:00,2023-06-05,09:16,2,4,6
18,2023-06-05T09:16:00+10:00,2023-06-05,09:16,1,4,5
27,2023-06-05T09:16:00+10:00,2023-06-05,09:16,0,2,2
46,2023-06-05T09:16:00+10:00,2023-06-05,09:16,2,5,7
48,2023-06-05T09:16:00+10:00,2023-06-05,09:16,2,0,2
72,2023-06-05T09:16:00+10:00,2023-06-05,09:16,1,3,4
79,2023-06-05T09:16:00+10:00,2023-06-05,09:16,10,5,15
3,2023-06-05T09:16:00+10:00,2023-06-05,09:16,1,9,10
4,2023-06-05T09:16:00+10:00,2023-06-05,09:16,9,5,14
21,2023-06-05T09:16:00+10:00,2023-06-05,09:16,5,0,5
28,2023-06-05T09:16:00+10:00,2023-06-05,09:16,2,1,3
41,2023-06-05T09:16:00+10:00,2023-06-05,09:16,29,5,34
42,2023-06-05T09:16:00+10:00,2023-06-05,09:16,5,0,5
54,2023-06-05T09:16:00+10:00,2023-06-05,09:16,1,1,2
61,2023-06-05T09:16:00+10:00,2023-06-05,09:16,2,0,2
65,2023-06-05T09:16:00+10:00,2023-06-05,09:16,10,1,11
66,2023-06-05T09:16:00+10:00,2023-06-05,09:16,3,3,6
71,2023-06-05T09:16:00+10:00,2023-06-05,09:16,0,1,1
78,2023-06-05T09:16:00+10:00,2023-06-05,09:16,1,0,1
1,2023-06-05T09:16:00+10:00,2023-06-05,09:16,3,5,8
23,2023-06-05T09:16:00+10:00,2023-06-05,09:16,5,4,9
24,2023-06-05T09:16:00+10:00,2023-06-05,09:16,27,10,37
51,2023-06-05T09:16:00+10:00,2023-06-05,09:16,3,1,4
53,2023-06-05T09:16:00+10:00,2023-06-05,09:16,8,3,11
58,2023-06-05T09:16:00+10:00,2023-06-05,09:16,4,4,8
6,2023-06-05T09:16:00+10:00,2023-06-05,09:16,12,18,30
14,2023-06-05T09:16:00+10:00,2023-06-05,09:16,2,6,8
26,2023-06-05T09:16:00+10:00,2023-06-05,09:16,4,3,7
29,2023-06-05T09:16:00+10:00,2023-06-05,09:16,5,1,6
31,2023-06-05T09:16:00+10:00,2023-06-05,09:16,0,1,1
47,2023-06-05T09:16:00+10:00,2023-06-05,09:16,3,7,10
75,2023-06-05T09:16:00+10:00,2023-06-05,09:16,1,1,2
77,2023-06-05T09:16:00+10:00,2023-06-05,09:16,2,2,4
87,2023-06-05T09:16:00+10:00,2023-06-05,09:16,1,2,3
108,2023-06-05T09:16:00+10:00,2023-06-05,09:16,1,17,18
2,2023-06-05T09:16:00+10:00,2023-06-05,09:16,2,6,8
9,2023-06-05T09:16:00+10:00,2023-06-05,09:16,4,42,46
10,2023-06-05T09:16:00+10:00,2023-06-05,09:16,1,3,4
11,2023-06-05T09:16:00+10:00,2023-06-05,09:16,1,0,1
17,2023-06-05T09:16:00+10:00,2023-06-05,09:16,13,4,17
20,2023-06-05T09:16:00+10:00,2023-06-05,09:16,0,1,1
30,2023-06-05T09:16:00+10:00,2023-06-05,09:16,3,1,4
35,2023-06-05T09:16:00+10:00,2023-06-05,09:16,3,10,13
52,2023-06-05T09:16:00+10:00,2023-06-05,09:16,4,3,7
56,2023-06-05T09:16:00+10:00,2023-06-05,09:16,0,1,1
57,2023-06-05T09:16:00+10:00,2023-06-05,09:16,5,16,21
62,2023-06-05T09:16:00+10:00,2023-06-05,09:16,1,1,2
63,2023-06-05T09:16:00+10:00,2023-06-05,09:16,5,3,8
67,2023-06-05T09:16:00+10:00,2023-06-05,09:16,12,4,16
68,2023-06-05T09:16:00+10:00,2023-06-05,09:16,6,2,8
86,2023-06-05T09:16:00+10:00,2023-06-05,09:16,0,1,1
3,2023-06-05T09:15:00+10:00,2023-06-05,09:15,14,4,18
4,2023-06-05T09:15:00+10:00,2023-06-05,09:15,14,4,18
21,2023-06-05T09:15:00+10:00,2023-06-05,09:15,1,3,4
47,2023-06-05T09:15:00+10:00,2023-06-05,09:15,5,3,8
55,2023-06-05T09:15:00+10:00,2023-06-05,09:15,8,11,19
69,2023-06-05T09:15:00+10:00,2023-06-05,09:15,3,0,3
75,2023-06-05T09:15:00+10:00,2023-06-05,09:15,2,0,2
108,2023-06-05T09:15:00+10:00,2023-06-05,09:15,4,10,14
11,2023-06-05T09:15:00+10:00,2023-06-05,09:15,1,2,3
12,2023-06-05T09:15:00+10:00,2023-06-05,09:15,7,0,7
27,2023-06-05T09:15:00+10:00,2023-06-05,09:15,1,2,3
46,2023-06-05T09:15:00+10:00,2023-06-05,09:15,0,4,4
51,2023-06-05T09:15:00+10:00,2023-06-05,09:15,0,1,1
72,2023-06-05T09:15:00+10:00,2023-06-05,09:15,10,0,10
109,2023-06-05T09:15:00+10:00,2023-06-05,09:15,4,40,44
5,2023-06-05T09:15:00+10:00,2023-06-05,09:15,6,5,11
14,2023-06-05T09:15:00+10:00,2023-06-05,09:15,2,4,6
26,2023-06-05T09:15:00+10:00,2023-06-05,09:15,8,2,10
28,2023-06-05T09:15:00+10:00,2023-06-05,09:15,5,1,6
36,2023-06-05T09:15:00+10:00,2023-06-05,09:15,3,8,11
37,2023-06-05T09:15:00+10:00,2023-06-05,09:15,0,2,2
39,2023-06-05T09:15:00+10:00,2023-06-05,09:15,0,3,3
41,2023-06-05T09:15:00+10:00,2023-06-05,09:15,26,4,30
50,2023-06-05T09:15:00+10:00,2023-06-05,09:15,0,1,1
70,2023-06-05T09:15:00+10:00,2023-06-05,09:15,3,1,4
84,2023-06-05T09:15:00+10:00,2023-06-05,09:15,61,29,90
87,2023-06-05T09:15:00+10:00,2023-06-05,09:15,1,1,2
107,2023-06-05T09:15:00+10:00,2023-06-05,09:15,4,11,15
2,2023-06-05T09:15:00+10:00,2023-06-05,09:15,2,4,6
9,2023-06-05T09:15:00+10:00,2023-06-05,09:15,0,12,12
17,2023-06-05T09:15:00+10:00,2023-06-05,09:15,7,1,8
18,2023-06-05T09:15:00+10:00,2023-06-05,09:15,5,6,11
19,2023-06-05T09:15:00+10:00,2023-06-05,09:15,1,0,1
23,2023-06-05T09:15:00+10:00,2023-06-05,09:15,6,0,6
53,2023-06-05T09:15:00+10:00,2023-06-05,09:15,3,3,6
56,2023-06-05T09:15:00+10:00,2023-06-05,09:15,4,0,4
76,2023-06-05T09:15:00+10:00,2023-06-05,09:15,1,2,3
79,2023-06-05T09:15:00+10:00,2023-06-05,09:15,3,9,12
85,2023-06-05T09:15:00+10:00,2023-06-05,09:15,2,2,4
117,2023-06-05T09:15:00+10:00,2023-06-05,09:15,14,12,26
6,2023-06-05T09:15:00+10:00,2023-06-05,09:15,7,17,24
8,2023-06-05T09:15:00+10:00,2023-06-05,09:15,5,3,8
40,2023-06-05T09:15:00+10:00,2023-06-05,09:15,0,2,2
42,2023-06-05T09:15:00+10:00,2023-06-05,09:15,1,0,1
44,2023-06-05T09:15:00+10:00,2023-06-05,09:15,0,1,1
45,2023-06-05T09:15:00+10:00,2023-06-05,09:15,1,3,4
59,2023-06-05T09:15:00+10:00,2023-06-05,09:15,34,13,47
61,2023-06-05T09:15:00+10:00,2023-06-05,09:15,1,2,3
65,2023-06-05T09:15:00+10:00,2023-06-05,09:15,7,4,11
66,2023-06-05T09:15:00+10:00,2023-06-05,09:15,1,8,9
77,2023-06-05T09:15:00+10:00,2023-06-05,09:15,1,0,1
118,2023-06-05T09:15:00+10:00,2023-06-05,09:15,2,1,3
1,2023-06-05T09:15:00+10:00,2023-06-05,09:15,2,3,5
10,2023-06-05T09:15:00+10:00,2023-06-05,09:15,5,1,6
24,2023-06-05T09:15:00+10:00,2023-06-05,09:15,21,3,24
30,2023-06-05T09:15:00+10:00,2023-06-05,09:15,2,0,2
35,2023-06-05T09:15:00+10:00,2023-06-05,09:15,3,7,10
48,2023-06-05T09:15:00+10:00,2023-06-05,09:15,1,5,6
52,2023-06-05T09:15:00+10:00,2023-06-05,09:15,1,3,4
57,2023-06-05T09:15:00+10:00,2023-06-05,09:15,5,15,20
58,2023-06-05T09:15:00+10:00,2023-06-05,09:15,29,6,35
62,2023-06-05T09:15:00+10:00,2023-06-05,09:15,0,1,1
63,2023-06-05T09:15:00+10:00,2023-06-05,09:15,4,6,10
67,2023-06-05T09:15:00+10:00,2023-06-05,09:15,6,3,9
68,2023-06-05T09:15:00+10:00,2023-06-05,09:15,2,1,3
86,2023-06-05T09:15:00+10:00,2023-06-05,09:15,1,1,2
4,2023-06-05T09:14:00+10:00,2023-06-05,09:14,14,8,22
6,2023-06-05T09:14:00+10:00,2023-06-05,09:14,4,8,12
28,2023-06-05T09:14:00+10:00,2023-06-05,09:14,8,2,10
29,2023-06-05T09:14:00+10:00,2023-06-05,09:14,1,0,1
36,2023-06-05T09:14:00+10:00,2023-06-05,09:14,13,7,20
37,2023-06-05T09:14:00+10:00,2023-06-05,09:14,2,0,2
40,2023-06-05T09:14:00+10:00,2023-06-05,09:14,4,1,5
54,2023-06-05T09:14:00+10:00,2023-06-05,09:14,2,0,2
61,2023-06-05T09:14:00+10:00,2023-06-05,09:14,4,7,11
70,2023-06-05T09:14:00+10:00,2023-06-05,09:14,1,0,1
75,2023-06-05T09:14:00+10:00,2023-06-05,09:14,1,0,1
77,2023-06-05T09:14:00+10:00,2023-06-05,09:14,1,1,2
1,2023-06-05T09:14:00+10:00,2023-06-05,09:14,5,5,10
10,2023-06-05T09:14:00+10:00,2023-06-05,09:14,1,3,4
19,2023-06-05T09:14:00+10:00,2023-06-05,09:14,1,1,2
20,2023-06-05T09:14:00+10:00,2023-06-05,09:14,0,2,2
23,2023-06-05T09:14:00+10:00,2023-06-05,09:14,5,0,5
48,2023-06-05T09:14:00+10:00,2023-06-05,09:14,2,0,2
53,2023-06-05T09:14:00+10:00,2023-06-05,09:14,5,1,6
58,2023-06-05T09:14:00+10:00,2023-06-05,09:14,3,3,6
67,2023-06-05T09:14:00+10:00,2023-06-05,09:14,6,2,8
76,2023-06-05T09:14:00+10:00,2023-06-05,09:14,1,2,3
3,2023-06-05T09:14:00+10:00,2023-06-05,09:14,0,5,5
5,2023-06-05T09:14:00+10:00,2023-06-05,09:14,2,7,9
14,2023-06-05T09:14:00+10:00,2023-06-05,09:14,2,6,8
26,2023-06-05T09:14:00+10:00,2023-06-05,09:14,1,3,4
31,2023-06-05T09:14:00+10:00,2023-06-05,09:14,4,0,4
39,2023-06-05T09:14:00+10:00,2023-06-05,09:14,1,0,1
45,2023-06-05T09:14:00+10:00,2023-06-05,09:14,2,7,9
47,2023-06-05T09:14:00+10:00,2023-06-05,09:14,4,19,23
50,2023-06-05T09:14:00+10:00,2023-06-05,09:14,2,4,6
65,2023-06-05T09:14:00+10:00,2023-06-05,09:14,6,5,11
66,2023-06-05T09:14:00+10:00,2023-06-05,09:14,3,10,13
69,2023-06-05T09:14:00+10:00,2023-06-05,09:14,4,2,6
78,2023-06-05T09:14:00+10:00,2023-06-05,09:14,0,1,1
9,2023-06-05T09:14:00+10:00,2023-06-05,09:14,1,7,8
12,2023-06-05T09:14:00+10:00,2023-06-05,09:14,1,1,2
18,2023-06-05T09:14:00+10:00,2023-06-05,09:14,4,7,11
24,2023-06-05T09:14:00+10:00,2023-06-05,09:14,17,7,24
27,2023-06-05T09:14:00+10:00,2023-06-05,09:14,1,4,5
46,2023-06-05T09:14:00+10:00,2023-06-05,09:14,0,2,2
62,2023-06-05T09:14:00+10:00,2023-06-05,09:14,1,2,3
63,2023-06-05T09:14:00+10:00,2023-06-05,09:14,3,6,9
68,2023-06-05T09:14:00+10:00,2023-06-05,09:14,4,0,4
85,2023-06-05T09:14:00+10:00,2023-06-05,09:14,1,1,2
86,2023-06-05T09:14:00+10:00,2023-06-05,09:14,0,1,1
8,2023-06-05T09:14:00+10:00,2023-06-05,09:14,3,0,3
21,2023-06-05T09:14:00+10:00,2023-06-05,09:14,0,4,4
41,2023-06-05T09:14:00+10:00,2023-06-05,09:14,37,8,45
42,2023-06-05T09:14:00+10:00,2023-06-05,09:14,4,0,4
55,2023-06-05T09:14:00+10:00,2023-06-05,09:14,4,7,11
108,2023-06-05T09:14:00+10:00,2023-06-05,09:14,6,7,13
2,2023-06-05T09:14:00+10:00,2023-06-05,09:14,6,2,8
11,2023-06-05T09:14:00+10:00,2023-06-05,09:14,3,0,3
17,2023-06-05T09:14:00+10:00,2023-06-05,09:14,19,6,25
30,2023-06-05T09:14:00+10:00,2023-06-05,09:14,0,2,2
35,2023-06-05T09:14:00+10:00,2023-06-05,09:14,2,15,17
52,2023-06-05T09:14:00+10:00,2023-06-05,09:14,3,8,11
56,2023-06-05T09:14:00+10:00,2023-06-05,09:14,0,1,1
57,2023-06-05T09:14:00+10:00,2023-06-05,09:14,3,6,9
72,2023-06-05T09:14:00+10:00,2023-06-05,09:14,12,1,13
79,2023-06-05T09:14:00+10:00,2023-06-05,09:14,4,5,9
40,2023-06-05T09:13:00+10:00,2023-06-05,09:13,2,1,3
61,2023-06-05T09:13:00+10:00,2023-06-05,09:13,2,8,10
65,2023-06-05T09:13:00+10:00,2023-06-05,09:13,7,1,8
77,2023-06-05T09:13:00+10:00,2023-06-05,09:13,0,5,5
2,2023-06-05T09:13:00+10:00,2023-06-05,09:13,5,2,7
9,2023-06-05T09:13:00+10:00,2023-06-05,09:13,6,35,41
10,2023-06-05T09:13:00+10:00,2023-06-05,09:13,0,4,4
12,2023-06-05T09:13:00+10:00,2023-06-05,09:13,1,0,1
19,2023-06-05T09:13:00+10:00,2023-06-05,09:13,0,2,2
24,2023-06-05T09:13:00+10:00,2023-06-05,09:13,33,1,34
53,2023-06-05T09:13:00+10:00,2023-06-05,09:13,2,3,5
56,2023-06-05T09:13:00+10:00,2023-06-05,09:13,5,2,7
58,2023-06-05T09:13:00+10:00,2023-06-05,09:13,23,7,30
63,2023-06-05T09:13:00+10:00,2023-06-05,09:13,3,1,4
85,2023-06-05T09:13:00+10:00,2023-06-05,09:13,1,2,3
3,2023-06-05T09:13:00+10:00,2023-06-05,09:13,3,4,7
5,2023-06-05T09:13:00+10:00,2023-06-05,09:13,4,3,7
21,2023-06-05T09:13:00+10:00,2023-06-05,09:13,5,0,5
31,2023-06-05T09:13:00+10:00,2023-06-05,09:13,1,0,1
39,2023-06-05T09:13:00+10:00,2023-06-05,09:13,2,4,6
42,2023-06-05T09:13:00+10:00,2023-06-05,09:13,2,2,4
45,2023-06-05T09:13:00+10:00,2023-06-05,09:13,2,5,7
66,2023-06-05T09:13:00+10:00,2023-06-05,09:13,5,5,10
69,2023-06-05T09:13:00+10:00,2023-06-05,09:13,2,1,3
70,2023-06-05T09:13:00+10:00,2023-06-05,09:13,0,1,1
71,2023-06-05T09:13:00+10:00,2023-06-05,09:13,1,1,2
1,2023-06-05T09:13:00+10:00,2023-06-05,09:13,3,0,3
23,2023-06-05T09:13:00+10:00,2023-06-05,09:13,9,2,11
35,2023-06-05T09:13:00+10:00,2023-06-05,09:13,9,9,18
51,2023-06-05T09:13:00+10:00,2023-06-05,09:13,1,3,4
52,2023-06-05T09:13:00+10:00,2023-06-05,09:13,5,5,10
67,2023-06-05T09:13:00+10:00,2023-06-05,09:13,7,2,9
68,2023-06-05T09:13:00+10:00,2023-06-05,09:13,5,0,5
76,2023-06-05T09:13:00+10:00,2023-06-05,09:13,1,2,3
79,2023-06-05T09:13:00+10:00,2023-06-05,09:13,9,6,15
4,2023-06-05T09:13:00+10:00,2023-06-05,09:13,10,3,13
6,2023-06-05T09:13:00+10:00,2023-06-05,09:13,9,7,16
8,2023-06-05T09:13:00+10:00,2023-06-05,09:13,5,1,6
14,2023-06-05T09:13:00+10:00,2023-06-05,09:13,5,4,9
26,2023-06-05T09:13:00+10:00,2023-06-05,09:13,3,4,7
28,2023-06-05T09:13:00+10:00,2023-06-05,09:13,6,7,13
29,2023-06-05T09:13:00+10:00,2023-06-05,09:13,1,0,1
36,2023-06-05T09:13:00+10:00,2023-06-05,09:13,3,3,6
41,2023-06-05T09:13:00+10:00,2023-06-05,09:13,31,2,33
47,2023-06-05T09:13:00+10:00,2023-06-05,09:13,3,1,4
50,2023-06-05T09:13:00+10:00,2023-06-05,09:13,4,0,4
55,2023-06-05T09:13:00+10:00,2023-06-05,09:13,5,4,9
87,2023-06-05T09:13:00+10:00,2023-06-05,09:13,1,0,1
108,2023-06-05T09:13:00+10:00,2023-06-05,09:13,8,8,16
17,2023-06-05T09:13:00+10:00,2023-06-05,09:13,14,2,16
18,2023-06-05T09:13:00+10:00,2023-06-05,09:13,1,19,20
27,2023-06-05T09:13:00+10:00,2023-06-05,09:13,1,0,1
30,2023-06-05T09:13:00+10:00,2023-06-05,09:13,0,1,1
46,2023-06-05T09:13:00+10:00,2023-06-05,09:13,1,3,4
48,2023-06-05T09:13:00+10:00,2023-06-05,09:13,1,1,2
57,2023-06-05T09:13:00+10:00,2023-06-05,09:13,3,10,13
62,2023-06-05T09:13:00+10:00,2023-06-05,09:13,3,0,3
72,2023-06-05T09:13:00+10:00,2023-06-05,09:13,3,2,5
5,2023-06-05T09:12:00+10:00,2023-06-05,09:12,1,9,10
26,2023-06-05T09:12:00+10:00,2023-06-05,09:12,3,0,3
39,2023-06-05T09:12:00+10:00,2023-06-05,09:12,4,3,7
40,2023-06-05T09:12:00+10:00,2023-06-05,09:12,0,3,3
42,2023-06-05T09:12:00+10:00,2023-06-05,09:12,1,1,2
50,2023-06-05T09:12:00+10:00,2023-06-05,09:12,0,2,2
77,2023-06-05T09:12:00+10:00,2023-06-05,09:12,3,0,3
108,2023-06-05T09:12:00+10:00,2023-06-05,09:12,7,1,8
1,2023-06-05T09:12:00+10:00,2023-06-05,09:12,4,2,6
2,2023-06-05T09:12:00+10:00,2023-06-05,09:12,1,2,3
9,2023-06-05T09:12:00+10:00,2023-06-05,09:12,3,27,30
17,2023-06-05T09:12:00+10:00,2023-06-05,09:12,8,4,12
30,2023-06-05T09:12:00+10:00,2023-06-05,09:12,1,2,3
35,2023-06-05T09:12:00+10:00,2023-06-05,09:12,4,23,27
48,2023-06-05T09:12:00+10:00,2023-06-05,09:12,1,1,2
51,2023-06-05T09:12:00+10:00,2023-06-05,09:12,3,0,3
63,2023-06-05T09:12:00+10:00,2023-06-05,09:12,2,2,4
72,2023-06-05T09:12:00+10:00,2023-06-05,09:12,12,1,13
86,2023-06-05T09:12:00+10:00,2023-06-05,09:12,0,1,1
4,2023-06-05T09:12:00+10:00,2023-06-05,09:12,6,4,10
8,2023-06-05T09:12:00+10:00,2023-06-05,09:12,3,4,7
29,2023-06-05T09:12:00+10:00,2023-06-05,09:12,0,2,2
36,2023-06-05T09:12:00+10:00,2023-06-05,09:12,5,6,11
47,2023-06-05T09:12:00+10:00,2023-06-05,09:12,5,6,11
54,2023-06-05T09:12:00+10:00,2023-06-05,09:12,1,0,1
55,2023-06-05T09:12:00+10:00,2023-06-05,09:12,12,6,18
61,2023-06-05T09:12:00+10:00,2023-06-05,09:12,1,3,4
66,2023-06-05T09:12:00+10:00,2023-06-05,09:12,0,5,5
70,2023-06-05T09:12:00+10:00,2023-06-05,09:12,2,1,3
10,2023-06-05T09:12:00+10:00,2023-06-05,09:12,1,3,4
11,2023-06-05T09:12:00+10:00,2023-06-05,09:12,1,1,2
18,2023-06-05T09:12:00+10:00,2023-06-05,09:12,3,11,14
20,2023-06-05T09:12:00+10:00,2023-06-05,09:12,0,1,1
24,2023-06-05T09:12:00+10:00,2023-06-05,09:12,10,14,24
52,2023-06-05T09:12:00+10:00,2023-06-05,09:12,4,6,10
53,2023-06-05T09:12:00+10:00,2023-06-05,09:12,2,1,3
57,2023-06-05T09:12:00+10:00,2023-06-05,09:12,4,7,11
58,2023-06-05T09:12:00+10:00,2023-06-05,09:12,14,0,14
62,2023-06-05T09:12:00+10:00,2023-06-05,09:12,1,2,3
67,2023-06-05T09:12:00+10:00,2023-06-05,09:12,5,3,8
79,2023-06-05T09:12:00+10:00,2023-06-05,09:12,2,8,10
3,2023-06-05T09:12:00+10:00,2023-06-05,09:12,8,4,12
6,2023-06-05T09:12:00+10:00,2023-06-05,09:12,5,5,10
14,2023-06-05T09:12:00+10:00,2023-06-05,09:12,5,2,7
21,2023-06-05T09:12:00+10:00,2023-06-05,09:12,1,0,1
28,2023-06-05T09:12:00+10:00,2023-06-05,09:12,3,1,4
31,2023-06-05T09:12:00+10:00,2023-06-05,09:12,0,2,2
37,2023-06-05T09:12:00+10:00,2023-06-05,09:12,0,3,3
41,2023-06-05T09:12:00+10:00,2023-06-05,09:12,26,2,28
45,2023-06-05T09:12:00+10:00,2023-06-05,09:12,1,4,5
65,2023-06-05T09:12:00+10:00,2023-06-05,09:12,3,1,4
87,2023-06-05T09:12:00+10:00,2023-06-05,09:12,1,0,1
12,2023-06-05T09:12:00+10:00,2023-06-05,09:12,0,4,4
23,2023-06-05T09:12:00+10:00,2023-06-05,09:12,7,11,18
27,2023-06-05T09:12:00+10:00,2023-06-05,09:12,0,1,1
46,2023-06-05T09:12:00+10:00,2023-06-05,09:12,0,3,3
56,2023-06-05T09:12:00+10:00,2023-06-05,09:12,6,1,7
76,2023-06-05T09:12:00+10:00,2023-06-05,09:12,1,1,2
85,2023-06-05T09:12:00+10:00,2023-06-05,09:12,1,0,1
5,2023-06-05T09:11:00+10:00,2023-06-05,09:11,3,5,8
6,2023-06-05T09:11:00+10:00,2023-06-05,09:11,8,18,26
26,2023-06-05T09:11:00+10:00,2023-06-05,09:11,1,5,6
37,2023-06-05T09:11:00+10:00,2023-06-05,09:11,0,1,1
41,2023-06-05T09:11:00+10:00,2023-06-05,09:11,22,6,28
45,2023-06-05T09:11:00+10:00,2023-06-05,09:11,8,0,8
69,2023-06-05T09:11:00+10:00,2023-06-05,09:11,1,1,2
70,2023-06-05T09:11:00+10:00,2023-06-05,09:11,1,2,3
10,2023-06-05T09:11:00+10:00,2023-06-05,09:11,1,7,8
12,2023-06-05T09:11:00+10:00,2023-06-05,09:11,8,1,9
17,2023-06-05T09:11:00+10:00,2023-06-05,09:11,8,4,12
27,2023-06-05T09:11:00+10:00,2023-06-05,09:11,2,0,2
46,2023-06-05T09:11:00+10:00,2023-06-05,09:11,2,5,7
56,2023-06-05T09:11:00+10:00,2023-06-05,09:11,0,1,1
58,2023-06-05T09:11:00+10:00,2023-06-05,09:11,16,2,18
62,2023-06-05T09:11:00+10:00,2023-06-05,09:11,2,0,2
72,2023-06-05T09:11:00+10:00,2023-06-05,09:11,2,2,4
76,2023-06-05T09:11:00+10:00,2023-06-05,09:11,0,2,2
79,2023-06-05T09:11:00+10:00,2023-06-05,09:11,8,6,14
3,2023-06-05T09:11:00+10:00,2023-06-05,09:11,7,3,10
4,2023-06-05T09:11:00+10:00,2023-06-05,09:11,6,8,14
21,2023-06-05T09:11:00+10:00,2023-06-05,09:11,1,1,2
29,2023-06-05T09:11:00+10:00,2023-06-05,09:11,3,3,6
31,2023-06-05T09:11:00+10:00,2023-06-05,09:11,0,1,1
39,2023-06-05T09:11:00+10:00,2023-06-05,09:11,3,3,6
47,2023-06-05T09:11:00+10:00,2023-06-05,09:11,3,14,17
54,2023-06-05T09:11:00+10:00,2023-06-05,09:11,2,2,4
61,2023-06-05T09:11:00+10:00,2023-06-05,09:11,3,4,7
66,2023-06-05T09:11:00+10:00,2023-06-05,09:11,1,2,3
75,2023-06-05T09:11:00+10:00,2023-06-05,09:11,1,0,1
108,2023-06-05T09:11:00+10:00,2023-06-05,09:11,5,3,8
20,2023-06-05T09:11:00+10:00,2023-06-05,09:11,1,0,1
23,2023-06-05T09:11:00+10:00,2023-06-05,09:11,9,0,9
51,2023-06-05T09:11:00+10:00,2023-06-05,09:11,1,3,4
52,2023-06-05T09:11:00+10:00,2023-06-05,09:11,1,12,13
57,2023-06-05T09:11:00+10:00,2023-06-05,09:11,4,8,12
63,2023-06-05T09:11:00+10:00,2023-06-05,09:11,2,3,5
68,2023-06-05T09:11:00+10:00,2023-06-05,09:11,3,1,4
8,2023-06-05T09:11:00+10:00,2023-06-05,09:11,5,0,5
14,2023-06-05T09:11:00+10:00,2023-06-05,09:11,1,4,5
28,2023-06-05T09:11:00+10:00,2023-06-05,09:11,4,2,6
36,2023-06-05T09:11:00+10:00,2023-06-05,09:11,6,0,6
40,2023-06-05T09:11:00+10:00,2023-06-05,09:11,3,1,4
55,2023-06-05T09:11:00+10:00,2023-06-05,09:11,3,10,13
65,2023-06-05T09:11:00+10:00,2023-06-05,09:11,6,4,10
71,2023-06-05T09:11:00+10:00,2023-06-05,09:11,0,1,1
77,2023-06-05T09:11:00+10:00,2023-06-05,09:11,2,0,2
87,2023-06-05T09:11:00+10:00,2023-06-05,09:11,1,2,3
1,2023-06-05T09:11:00+10:00,2023-06-05,09:11,3,3,6
2,2023-06-05T09:11:00+10:00,2023-06-05,09:11,2,5,7
9,2023-06-05T09:11:00+10:00,2023-06-05,09:11,0,31,31
18,2023-06-05T09:11:00+10:00,2023-06-05,09:11,1,11,12
19,2023-06-05T09:11:00+10:00,2023-06-05,09:11,1,0,1
24,2023-06-05T09:11:00+10:00,2023-06-05,09:11,32,6,38
30,2023-06-05T09:11:00+10:00,2023-06-05,09:11,3,0,3
35,2023-06-05T09:11:00+10:00,2023-06-05,09:11,7,18,25
49,2023-06-05T09:11:00+10:00,2023-06-05,09:11,2,1,3
53,2023-06-05T09:11:00+10:00,2023-06-05,09:11,2,3,5
67,2023-06-05T09:11:00+10:00,2023-06-05,09:11,8,6,14
54,2023-06-05T09:10:00+10:00,2023-06-05,09:10,4,0,4
65,2023-06-05T09:10:00+10:00,2023-06-05,09:10,9,3,12
70,2023-06-05T09:10:00+10:00,2023-06-05,09:10,1,3,4
77,2023-06-05T09:10:00+10:00,2023-06-05,09:10,1,4,5
84,2023-06-05T09:10:00+10:00,2023-06-05,09:10,89,28,117
87,2023-06-05T09:10:00+10:00,2023-06-05,09:10,0,1,1
108,2023-06-05T09:10:00+10:00,2023-06-05,09:10,3,15,18
18,2023-06-05T09:10:00+10:00,2023-06-05,09:10,0,4,4
20,2023-06-05T09:10:00+10:00,2023-06-05,09:10,0,1,1
23,2023-06-05T09:10:00+10:00,2023-06-05,09:10,10,0,10
46,2023-06-05T09:10:00+10:00,2023-06-05,09:10,0,1,1
49,2023-06-05T09:10:00+10:00,2023-06-05,09:10,0,1,1
58,2023-06-05T09:10:00+10:00,2023-06-05,09:10,25,1,26
63,2023-06-05T09:10:00+10:00,2023-06-05,09:10,5,2,7
76,2023-06-05T09:10:00+10:00,2023-06-05,09:10,1,0,1
86,2023-06-05T09:10:00+10:00,2023-06-05,09:10,0,1,1
117,2023-06-05T09:10:00+10:00,2023-06-05,09:10,17,8,25
4,2023-06-05T09:10:00+10:00,2023-06-05,09:10,9,11,20
8,2023-06-05T09:10:00+10:00,2023-06-05,09:10,2,1,3
14,2023-06-05T09:10:00+10:00,2023-06-05,09:10,4,4,8
21,2023-06-05T09:10:00+10:00,2023-06-05,09:10,5,2,7
28,2023-06-05T09:10:00+10:00,2023-06-05,09:10,10,13,23
36,2023-06-05T09:10:00+10:00,2023-06-05,09:10,6,2,8
40,2023-06-05T09:10:00+10:00,2023-06-05,09:10,3,5,8
47,2023-06-05T09:10:00+10:00,2023-06-05,09:10,2,9,11
55,2023-06-05T09:10:00+10:00,2023-06-05,09:10,2,11,13
69,2023-06-05T09:10:00+10:00,2023-06-05,09:10,3,0,3
107,2023-06-05T09:10:00+10:00,2023-06-05,09:10,10,7,17
19,2023-06-05T09:10:00+10:00,2023-06-05,09:10,0,2,2
24,2023-06-05T09:10:00+10:00,2023-06-05,09:10,31,2,33
27,2023-06-05T09:10:00+10:00,2023-06-05,09:10,0,1,1
30,2023-06-05T09:10:00+10:00,2023-06-05,09:10,0,1,1
35,2023-06-05T09:10:00+10:00,2023-06-05,09:10,6,7,13
48,2023-06-05T09:10:00+10:00,2023-06-05,09:10,2,1,3
52,2023-06-05T09:10:00+10:00,2023-06-05,09:10,2,2,4
53,2023-06-05T09:10:00+10:00,2023-06-05,09:10,10,12,22
56,2023-06-05T09:10:00+10:00,2023-06-05,09:10,1,3,4
62,2023-06-05T09:10:00+10:00,2023-06-05,09:10,0,3,3
85,2023-06-05T09:10:00+10:00,2023-06-05,09:10,2,0,2
3,2023-06-05T09:10:00+10:00,2023-06-05,09:10,3,4,7
5,2023-06-05T09:10:00+10:00,2023-06-05,09:10,5,4,9
31,2023-06-05T09:10:00+10:00,2023-06-05,09:10,0,2,2
39,2023-06-05T09:10:00+10:00,2023-06-05,09:10,3,0,3
41,2023-06-05T09:10:00+10:00,2023-06-05,09:10,14,11,25
42,2023-06-05T09:10:00+10:00,2023-06-05,09:10,2,0,2
6,2023-06-05T09:10:00+10:00,2023-06-05,09:10,3,42,45
26,2023-06-05T09:10:00+10:00,2023-06-05,09:10,2,2,4
37,2023-06-05T09:10:00+10:00,2023-06-05,09:10,1,0,1
45,2023-06-05T09:10:00+10:00,2023-06-05,09:10,2,6,8
59,2023-06-05T09:10:00+10:00,2023-06-05,09:10,33,16,49
61,2023-06-05T09:10:00+10:00,2023-06-05,09:10,1,5,6
66,2023-06-05T09:10:00+10:00,2023-06-05,09:10,2,4,6
1,2023-06-05T09:10:00+10:00,2023-06-05,09:10,1,4,5
2,2023-06-05T09:10:00+10:00,2023-06-05,09:10,1,2,3
9,2023-06-05T09:10:00+10:00,2023-06-05,09:10,3,16,19
11,2023-06-05T09:10:00+10:00,2023-06-05,09:10,4,2,6
12,2023-06-05T09:10:00+10:00,2023-06-05,09:10,2,0,2
17,2023-06-05T09:10:00+10:00,2023-06-05,09:10,8,4,12
57,2023-06-05T09:10:00+10:00,2023-06-05,09:10,5,9,14
67,2023-06-05T09:10:00+10:00,2023-06-05,09:10,5,5,10
68,2023-06-05T09:10:00+10:00,2023-06-05,09:10,1,5,6
72,2023-06-05T09:10:00+10:00,2023-06-05,09:10,1,0,1
79,2023-06-05T09:10:00+10:00,2023-06-05,09:10,10,6,16
109,2023-06-05T09:10:00+10:00,2023-06-05,09:10,1,36,37
47,2023-06-05T09:09:00+10:00,2023-06-05,09:09,3,14,17
55,2023-06-05T09:09:00+10:00,2023-06-05,09:09,13,9,22
66,2023-06-05T09:09:00+10:00,2023-06-05,09:09,2,4,6
108,2023-06-05T09:09:00+10:00,2023-06-05,09:09,4,11,15
2,2023-06-05T09:09:00+10:00,2023-06-05,09:09,2,3,5
9,2023-06-05T09:09:00+10:00,2023-06-05,09:09,0,12,12
11,2023-06-05T09:09:00+10:00,2023-06-05,09:09,0,2,2
17,2023-06-05T09:09:00+10:00,2023-06-05,09:09,10,2,12
20,2023-06-05T09:09:00+10:00,2023-06-05,09:09,1,0,1
53,2023-06-05T09:09:00+10:00,2023-06-05,09:09,6,4,10
56,2023-06-05T09:09:00+10:00,2023-06-05,09:09,1,1,2
58,2023-06-05T09:09:00+10:00,2023-06-05,09:09,4,2,6
62,2023-06-05T09:09:00+10:00,2023-06-05,09:09,1,0,1
72,2023-06-05T09:09:00+10:00,2023-06-05,09:09,6,1,7
85,2023-06-05T09:09:00+10:00,2023-06-05,09:09,5,0,5
5,2023-06-05T09:09:00+10:00,2023-06-05,09:09,2,7,9
6,2023-06-05T09:09:00+10:00,2023-06-05,09:09,1,17,18
8,2023-06-05T09:09:00+10:00,2023-06-05,09:09,3,2,5
26,2023-06-05T09:09:00+10:00,2023-06-05,09:09,2,1,3
36,2023-06-05T09:09:00+10:00,2023-06-05,09:09,7,1,8
39,2023-06-05T09:09:00+10:00,2023-06-05,09:09,5,0,5
45,2023-06-05T09:09:00+10:00,2023-06-05,09:09,6,2,8
61,2023-06-05T09:09:00+10:00,2023-06-05,09:09,2,7,9
65,2023-06-05T09:09:00+10:00,2023-06-05,09:09,2,1,3
69,2023-06-05T09:09:00+10:00,2023-06-05,09:09,4,1,5
70,2023-06-05T09:09:00+10:00,2023-06-05,09:09,1,0,1
77,2023-06-05T09:09:00+10:00,2023-06-05,09:09,3,5,8
78,2023-06-05T09:09:00+10:00,2023-06-05,09:09,1,0,1
1,2023-06-05T09:09:00+10:00,2023-06-05,09:09,0,2,2
10,2023-06-05T09:09:00+10:00,2023-06-05,09:09,1,3,4
12,2023-06-05T09:09:00+10:00,2023-06-05,09:09,1,0,1
18,2023-06-05T09:09:00+10:00,2023-06-05,09:09,0,16,16
24,2023-06-05T09:09:00+10:00,2023-06-05,09:09,9,12,21
48,2023-06-05T09:09:00+10:00,2023-06-05,09:09,2,0,2
52,2023-06-05T09:09:00+10:00,2023-06-05,09:09,8,4,12
63,2023-06-05T09:09:00+10:00,2023-06-05,09:09,2,1,3
67,2023-06-05T09:09:00+10:00,2023-06-05,09:09,9,6,15
3,2023-06-05T09:09:00+10:00,2023-06-05,09:09,5,7,12
4,2023-06-05T09:09:00+10:00,2023-06-05,09:09,5,0,5
28,2023-06-05T09:09:00+10:00,2023-06-05,09:09,12,4,16
31,2023-06-05T09:09:00+10:00,2023-06-05,09:09,1,5,6
40,2023-06-05T09:09:00+10:00,2023-06-05,09:09,2,4,6
41,2023-06-05T09:09:00+10:00,2023-06-05,09:09,17,11,28
14,2023-06-05T09:09:00+10:00,2023-06-05,09:09,3,4,7
29,2023-06-05T09:09:00+10:00,2023-06-05,09:09,2,1,3
37,2023-06-05T09:09:00+10:00,2023-06-05,09:09,4,2,6
42,2023-06-05T09:09:00+10:00,2023-06-05,09:09,0,2,2
44,2023-06-05T09:09:00+10:00,2023-06-05,09:09,0,2,2
54,2023-06-05T09:09:00+10:00,2023-06-05,09:09,3,0,3
23,2023-06-05T09:09:00+10:00,2023-06-05,09:09,3,6,9
27,2023-06-05T09:09:00+10:00,2023-06-05,09:09,1,1,2
30,2023-06-05T09:09:00+10:00,2023-06-05,09:09,2,5,7
35,2023-06-05T09:09:00+10:00,2023-06-05,09:09,7,8,15
46,2023-06-05T09:09:00+10:00,2023-06-05,09:09,3,2,5
51,2023-06-05T09:09:00+10:00,2023-06-05,09:09,0,6,6
57,2023-06-05T09:09:00+10:00,2023-06-05,09:09,9,11,20
68,2023-06-05T09:09:00+10:00,2023-06-05,09:09,2,0,2
76,2023-06-05T09:09:00+10:00,2023-06-05,09:09,0,2,2
79,2023-06-05T09:09:00+10:00,2023-06-05,09:09,6,6,12
54,2023-06-05T09:08:00+10:00,2023-06-05,09:08,2,1,3
61,2023-06-05T09:08:00+10:00,2023-06-05,09:08,2,3,5
65,2023-06-05T09:08:00+10:00,2023-06-05,09:08,5,6,11
108,2023-06-05T09:08:00+10:00,2023-06-05,09:08,0,13,13
1,2023-06-05T09:08:00+10:00,2023-06-05,09:08,3,0,3
9,2023-06-05T09:08:00+10:00,2023-06-05,09:08,9,22,31
10,2023-06-05T09:08:00+10:00,2023-06-05,09:08,2,4,6
17,2023-06-05T09:08:00+10:00,2023-06-05,09:08,15,3,18
18,2023-06-05T09:08:00+10:00,2023-06-05,09:08,1,15,16
24,2023-06-05T09:08:00+10:00,2023-06-05,09:08,35,3,38
35,2023-06-05T09:08:00+10:00,2023-06-05,09:08,3,11,14
46,2023-06-05T09:08:00+10:00,2023-06-05,09:08,2,5,7
62,2023-06-05T09:08:00+10:00,2023-06-05,09:08,2,1,3
67,2023-06-05T09:08:00+10:00,2023-06-05,09:08,3,4,7
72,2023-06-05T09:08:00+10:00,2023-06-05,09:08,2,1,3
79,2023-06-05T09:08:00+10:00,2023-06-05,09:08,3,4,7
21,2023-06-05T09:08:00+10:00,2023-06-05,09:08,0,3,3
26,2023-06-05T09:08:00+10:00,2023-06-05,09:08,2,0,2
28,2023-06-05T09:08:00+10:00,2023-06-05,09:08,9,0,9
29,2023-06-05T09:08:00+10:00,2023-06-05,09:08,0,3,3
37,2023-06-05T09:08:00+10:00,2023-06-05,09:08,0,1,1
55,2023-06-05T09:08:00+10:00,2023-06-05,09:08,8,9,17
66,2023-06-05T09:08:00+10:00,2023-06-05,09:08,2,8,10
70,2023-06-05T09:08:00+10:00,2023-06-05,09:08,2,1,3
77,2023-06-05T09:08:00+10:00,2023-06-05,09:08,3,8,11
12,2023-06-05T09:08:00+10:00,2023-06-05,09:08,1,1,2
20,2023-06-05T09:08:00+10:00,2023-06-05,09:08,0,3,3
52,2023-06-05T09:08:00+10:00,2023-06-05,09:08,1,7,8
58,2023-06-05T09:08:00+10:00,2023-06-05,09:08,37,1,38
68,2023-06-05T09:08:00+10:00,2023-06-05,09:08,0,1,1
85,2023-06-05T09:08:00+10:00,2023-06-05,09:08,0,2,2
3,2023-06-05T09:08:00+10:00,2023-06-05,09:08,3,5,8
5,2023-06-05T09:08:00+10:00,2023-06-05,09:08,2,4,6
8,2023-06-05T09:08:00+10:00,2023-06-05,09:08,5,1,6
36,2023-06-05T09:08:00+10:00,2023-06-05,09:08,6,1,7
39,2023-06-05T09:08:00+10:00,2023-06-05,09:08,4,1,5
41,2023-06-05T09:08:00+10:00,2023-06-05,09:08,14,2,16
44,2023-06-05T09:08:00+10:00,2023-06-05,09:08,0,2,2
4,2023-06-05T09:08:00+10:00,2023-06-05,09:08,17,5,22
6,2023-06-05T09:08:00+10:00,2023-06-05,09:08,3,12,15
14,2023-06-05T09:08:00+10:00,2023-06-05,09:08,1,7,8
31,2023-06-05T09:08:00+10:00,2023-06-05,09:08,1,0,1
40,2023-06-05T09:08:00+10:00,2023-06-05,09:08,3,6,9
42,2023-06-05T09:08:00+10:00,2023-06-05,09:08,0,3,3
45,2023-06-05T09:08:00+10:00,2023-06-05,09:08,6,0,6
47,2023-06-05T09:08:00+10:00,2023-06-05,09:08,4,19,23
50,2023-06-05T09:08:00+10:00,2023-06-05,09:08,0,2,2
69,2023-06-05T09:08:00+10:00,2023-06-05,09:08,2,1,3
87,2023-06-05T09:08:00+10:00,2023-06-05,09:08,0,2,2
2,2023-06-05T09:08:00+10:00,2023-06-05,09:08,3,5,8
23,2023-06-05T09:08:00+10:00,2023-06-05,09:08,11,4,15
27,2023-06-05T09:08:00+10:00,2023-06-05,09:08,0,1,1
48,2023-06-05T09:08:00+10:00,2023-06-05,09:08,2,2,4
51,2023-06-05T09:08:00+10:00,2023-06-05,09:08,4,4,8
53,2023-06-05T09:08:00+10:00,2023-06-05,09:08,8,4,12
57,2023-06-05T09:08:00+10:00,2023-06-05,09:08,3,9,12
63,2023-06-05T09:08:00+10:00,2023-06-05,09:08,4,4,8
76,2023-06-05T09:08:00+10:00,2023-06-05,09:08,3,0,3
86,2023-06-05T09:08:00+10:00,2023-06-05,09:08,2,0,2
47,2023-06-05T09:07:00+10:00,2023-06-05,09:07,6,6,12
50,2023-06-05T09:07:00+10:00,2023-06-05,09:07,0,4,4
61,2023-06-05T09:07:00+10:00,2023-06-05,09:07,3,5,8
65,2023-06-05T09:07:00+10:00,2023-06-05,09:07,4,7,11
1,2023-06-05T09:07:00+10:00,2023-06-05,09:07,3,5,8
10,2023-06-05T09:07:00+10:00,2023-06-05,09:07,1,1,2
12,2023-06-05T09:07:00+10:00,2023-06-05,09:07,1,3,4
24,2023-06-05T09:07:00+10:00,2023-06-05,09:07,20,2,22
48,2023-06-05T09:07:00+10:00,2023-06-05,09:07,1,1,2
49,2023-06-05T09:07:00+10:00,2023-06-05,09:07,2,1,3
57,2023-06-05T09:07:00+10:00,2023-06-05,09:07,4,7,11
58,2023-06-05T09:07:00+10:00,2023-06-05,09:07,13,4,17
63,2023-06-05T09:07:00+10:00,2023-06-05,09:07,3,6,9
76,2023-06-05T09:07:00+10:00,2023-06-05,09:07,0,1,1
79,2023-06-05T09:07:00+10:00,2023-06-05,09:07,11,2,13
14,2023-06-05T09:07:00+10:00,2023-06-05,09:07,4,4,8
21,2023-06-05T09:07:00+10:00,2023-06-05,09:07,0,4,4
28,2023-06-05T09:07:00+10:00,2023-06-05,09:07,6,4,10
36,2023-06-05T09:07:00+10:00,2023-06-05,09:07,1,5,6
37,2023-06-05T09:07:00+10:00,2023-06-05,09:07,0,3,3
54,2023-06-05T09:07:00+10:00,2023-06-05,09:07,1,0,1
69,2023-06-05T09:07:00+10:00,2023-06-05,09:07,4,1,5
78,2023-06-05T09:07:00+10:00,2023-06-05,09:07,2,3,5
30,2023-06-05T09:07:00+10:00,2023-06-05,09:07,3,2,5
56,2023-06-05T09:07:00+10:00,2023-06-05,09:07,2,2,4
67,2023-06-05T09:07:00+10:00,2023-06-05,09:07,7,4,11
72,2023-06-05T09:07:00+10:00,2023-06-05,09:07,4,1,5
3,2023-06-05T09:07:00+10:00,2023-06-05,09:07,1,4,5
5,2023-06-05T09:07:00+10:00,2023-06-05,09:07,6,9,15
6,2023-06-05T09:07:00+10:00,2023-06-05,09:07,5,13,18
8,2023-06-05T09:07:00+10:00,2023-06-05,09:07,1,2,3
40,2023-06-05T09:07:00+10:00,2023-06-05,09:07,4,5,9
41,2023-06-05T09:07:00+10:00,2023-06-05,09:07,27,5,32
42,2023-06-05T09:07:00+10:00,2023-06-05,09:07,0,3,3
4,2023-06-05T09:07:00+10:00,2023-06-05,09:07,9,6,15
26,2023-06-05T09:07:00+10:00,2023-06-05,09:07,2,3,5
29,2023-06-05T09:07:00+10:00,2023-06-05,09:07,2,3,5
39,2023-06-05T09:07:00+10:00,2023-06-05,09:07,4,0,4
44,2023-06-05T09:07:00+10:00,2023-06-05,09:07,1,0,1
45,2023-06-05T09:07:00+10:00,2023-06-05,09:07,5,2,7
55,2023-06-05T09:07:00+10:00,2023-06-05,09:07,5,9,14
66,2023-06-05T09:07:00+10:00,2023-06-05,09:07,2,2,4
70,2023-06-05T09:07:00+10:00,2023-06-05,09:07,1,2,3
77,2023-06-05T09:07:00+10:00,2023-06-05,09:07,1,1,2
87,2023-06-05T09:07:00+10:00,2023-06-05,09:07,0,1,1
108,2023-06-05T09:07:00+10:00,2023-06-05,09:07,1,14,15
2,2023-06-05T09:07:00+10:00,2023-06-05,09:07,0,3,3
9,2023-06-05T09:07:00+10:00,2023-06-05,09:07,1,53,54
17,2023-06-05T09:07:00+10:00,2023-06-05,09:07,9,2,11
18,2023-06-05T09:07:00+10:00,2023-06-05,09:07,1,12,13
19,2023-06-05T09:07:00+10:00,2023-06-05,09:07,2,1,3
20,2023-06-05T09:07:00+10:00,2023-06-05,09:07,3,3,6
23,2023-06-05T09:07:00+10:00,2023-06-05,09:07,13,1,14
35,2023-06-05T09:07:00+10:00,2023-06-05,09:07,4,34,38
46,2023-06-05T09:07:00+10:00,2023-06-05,09:07,1,1,2
52,2023-06-05T09:07:00+10:00,2023-06-05,09:07,2,8,10
53,2023-06-05T09:07:00+10:00,2023-06-05,09:07,1,2,3
62,2023-06-05T09:07:00+10:00,2023-06-05,09:07,0,1,1
68,2023-06-05T09:07:00+10:00,2023-06-05,09:07,4,1,5
47,2023-06-05T09:06:00+10:00,2023-06-05,09:06,5,16,21
55,2023-06-05T09:06:00+10:00,2023-06-05,09:06,7,10,17
69,2023-06-05T09:06:00+10:00,2023-06-05,09:06,2,1,3
78,2023-06-05T09:06:00+10:00,2023-06-05,09:06,1,0,1
87,2023-06-05T09:06:00+10:00,2023-06-05,09:06,1,1,2
1,2023-06-05T09:06:00+10:00,2023-06-05,09:06,4,5,9
2,2023-06-05T09:06:00+10:00,2023-06-05,09:06,0,3,3
20,2023-06-05T09:06:00+10:00,2023-06-05,09:06,1,1,2
24,2023-06-05T09:06:00+10:00,2023-06-05,09:06,22,1,23
48,2023-06-05T09:06:00+10:00,2023-06-05,09:06,1,1,2
53,2023-06-05T09:06:00+10:00,2023-06-05,09:06,6,2,8
58,2023-06-05T09:06:00+10:00,2023-06-05,09:06,15,3,18
72,2023-06-05T09:06:00+10:00,2023-06-05,09:06,13,2,15
79,2023-06-05T09:06:00+10:00,2023-06-05,09:06,12,6,18
4,2023-06-05T09:06:00+10:00,2023-06-05,09:06,6,3,9
6,2023-06-05T09:06:00+10:00,2023-06-05,09:06,14,13,27
8,2023-06-05T09:06:00+10:00,2023-06-05,09:06,3,1,4
21,2023-06-05T09:06:00+10:00,2023-06-05,09:06,0,4,4
26,2023-06-05T09:06:00+10:00,2023-06-05,09:06,3,1,4
28,2023-06-05T09:06:00+10:00,2023-06-05,09:06,5,3,8
36,2023-06-05T09:06:00+10:00,2023-06-05,09:06,4,1,5
50,2023-06-05T09:06:00+10:00,2023-06-05,09:06,0,1,1
61,2023-06-05T09:06:00+10:00,2023-06-05,09:06,3,0,3
65,2023-06-05T09:06:00+10:00,2023-06-05,09:06,7,2,9
66,2023-06-05T09:06:00+10:00,2023-06-05,09:06,0,7,7
70,2023-06-05T09:06:00+10:00,2023-06-05,09:06,4,0,4
108,2023-06-05T09:06:00+10:00,2023-06-05,09:06,5,0,5
10,2023-06-05T09:06:00+10:00,2023-06-05,09:06,4,8,12
11,2023-06-05T09:06:00+10:00,2023-06-05,09:06,0,1,1
12,2023-06-05T09:06:00+10:00,2023-06-05,09:06,1,1,2
17,2023-06-05T09:06:00+10:00,2023-06-05,09:06,19,4,23
18,2023-06-05T09:06:00+10:00,2023-06-05,09:06,2,19,21
23,2023-06-05T09:06:00+10:00,2023-06-05,09:06,3,3,6
27,2023-06-05T09:06:00+10:00,2023-06-05,09:06,1,0,1
46,2023-06-05T09:06:00+10:00,2023-06-05,09:06,0,3,3
52,2023-06-05T09:06:00+10:00,2023-06-05,09:06,5,9,14
56,2023-06-05T09:06:00+10:00,2023-06-05,09:06,1,2,3
62,2023-06-05T09:06:00+10:00,2023-06-05,09:06,0,1,1
63,2023-06-05T09:06:00+10:00,2023-06-05,09:06,2,3,5
68,2023-06-05T09:06:00+10:00,2023-06-05,09:06,1,0,1
85,2023-06-05T09:06:00+10:00,2023-06-05,09:06,1,0,1
5,2023-06-05T09:06:00+10:00,2023-06-05,09:06,7,16,23
29,2023-06-05T09:06:00+10:00,2023-06-05,09:06,0,2,2
31,2023-06-05T09:06:00+10:00,2023-06-05,09:06,2,0,2
37,2023-06-05T09:06:00+10:00,2023-06-05,09:06,1,0,1
42,2023-06-05T09:06:00+10:00,2023-06-05,09:06,1,2,3
3,2023-06-05T09:06:00+10:00,2023-06-05,09:06,6,6,12
14,2023-06-05T09:06:00+10:00,2023-06-05,09:06,1,3,4
39,2023-06-05T09:06:00+10:00,2023-06-05,09:06,2,1,3
40,2023-06-05T09:06:00+10:00,2023-06-05,09:06,1,5,6
41,2023-06-05T09:06:00+10:00,2023-06-05,09:06,20,2,22
44,2023-06-05T09:06:00+10:00,2023-06-05,09:06,0,3,3
45,2023-06-05T09:06:00+10:00,2023-06-05,09:06,3,2,5
54,2023-06-05T09:06:00+10:00,2023-06-05,09:06,2,0,2
77,2023-06-05T09:06:00+10:00,2023-06-05,09:06,0,3,3
9,2023-06-05T09:06:00+10:00,2023-06-05,09:06,0,44,44
35,2023-06-05T09:06:00+10:00,2023-06-05,09:06,4,20,24
57,2023-06-05T09:06:00+10:00,2023-06-05,09:06,4,9,13
67,2023-06-05T09:06:00+10:00,2023-06-05,09:06,2,7,9
50,2023-06-05T09:05:00+10:00,2023-06-05,09:05,0,1,1
54,2023-06-05T09:05:00+10:00,2023-06-05,09:05,1,1,2
55,2023-06-05T09:05:00+10:00,2023-06-05,09:05,3,9,12
61,2023-06-05T09:05:00+10:00,2023-06-05,09:05,3,6,9
118,2023-06-05T09:05:00+10:00,2023-06-05,09:05,2,0,2
9,2023-06-05T09:05:00+10:00,2023-06-05,09:05,3,16,19
12,2023-06-05T09:05:00+10:00,2023-06-05,09:05,1,1,2
24,2023-06-05T09:05:00+10:00,2023-06-05,09:05,33,5,38
49,2023-06-05T09:05:00+10:00,2023-06-05,09:05,1,0,1
52,2023-06-05T09:05:00+10:00,2023-06-05,09:05,1,4,5
28,2023-06-05T09:05:00+10:00,2023-06-05,09:05,6,7,13
31,2023-06-05T09:05:00+10:00,2023-06-05,09:05,1,0,1
59,2023-06-05T09:05:00+10:00,2023-06-05,09:05,38,8,46
65,2023-06-05T09:05:00+10:00,2023-06-05,09:05,8,0,8
69,2023-06-05T09:05:00+10:00,2023-06-05,09:05,3,2,5
107,2023-06-05T09:05:00+10:00,2023-06-05,09:05,5,21,26
108,2023-06-05T09:05:00+10:00,2023-06-05,09:05,5,6,11
1,2023-06-05T09:05:00+10:00,2023-06-05,09:05,3,4,7
11,2023-06-05T09:05:00+10:00,2023-06-05,09:05,4,0,4
17,2023-06-05T09:05:00+10:00,2023-06-05,09:05,19,3,22
18,2023-06-05T09:05:00+10:00,2023-06-05,09:05,1,11,12
20,2023-06-05T09:05:00+10:00,2023-06-05,09:05,2,2,4
23,2023-06-05T09:05:00+10:00,2023-06-05,09:05,6,6,12
46,2023-06-05T09:05:00+10:00,2023-06-05,09:05,2,2,4
56,2023-06-05T09:05:00+10:00,2023-06-05,09:05,0,1,1
58,2023-06-05T09:05:00+10:00,2023-06-05,09:05,19,2,21
62,2023-06-05T09:05:00+10:00,2023-06-05,09:05,3,2,5
67,2023-06-05T09:05:00+10:00,2023-06-05,09:05,7,2,9
72,2023-06-05T09:05:00+10:00,2023-06-05,09:05,11,1,12
76,2023-06-05T09:05:00+10:00,2023-06-05,09:05,1,3,4
79,2023-06-05T09:05:00+10:00,2023-06-05,09:05,3,3,6
85,2023-06-05T09:05:00+10:00,2023-06-05,09:05,3,1,4
86,2023-06-05T09:05:00+10:00,2023-06-05,09:05,1,0,1
109,2023-06-05T09:05:00+10:00,2023-06-05,09:05,6,43,49
117,2023-06-05T09:05:00+10:00,2023-06-05,09:05,30,6,36
3,2023-06-05T09:05:00+10:00,2023-06-05,09:05,7,9,16
4,2023-06-05T09:05:00+10:00,2023-06-05,09:05,7,12,19
14,2023-06-05T09:05:00+10:00,2023-06-05,09:05,3,4,7
26,2023-06-05T09:05:00+10:00,2023-06-05,09:05,3,7,10
40,2023-06-05T09:05:00+10:00,2023-06-05,09:05,3,4,7
41,2023-06-05T09:05:00+10:00,2023-06-05,09:05,29,2,31
5,2023-06-05T09:05:00+10:00,2023-06-05,09:05,3,9,12
6,2023-06-05T09:05:00+10:00,2023-06-05,09:05,8,14,22
8,2023-06-05T09:05:00+10:00,2023-06-05,09:05,6,1,7
21,2023-06-05T09:05:00+10:00,2023-06-05,09:05,5,3,8
29,2023-06-05T09:05:00+10:00,2023-06-05,09:05,1,0,1
37,2023-06-05T09:05:00+10:00,2023-06-05,09:05,2,1,3
39,2023-06-05T09:05:00+10:00,2023-06-05,09:05,2,4,6
42,2023-06-05T09:05:00+10:00,2023-06-05,09:05,4,2,6
44,2023-06-05T09:05:00+10:00,2023-06-05,09:05,0,2,2
45,2023-06-05T09:05:00+10:00,2023-06-05,09:05,2,5,7
47,2023-06-05T09:05:00+10:00,2023-06-05,09:05,3,20,23
66,2023-06-05T09:05:00+10:00,2023-06-05,09:05,6,12,18
70,2023-06-05T09:05:00+10:00,2023-06-05,09:05,2,2,4
77,2023-06-05T09:05:00+10:00,2023-06-05,09:05,3,7,10
84,2023-06-05T09:05:00+10:00,2023-06-05,09:05,75,24,99
87,2023-06-05T09:05:00+10:00,2023-06-05,09:05,0,1,1
2,2023-06-05T09:05:00+10:00,2023-06-05,09:05,0,1,1
10,2023-06-05T09:05:00+10:00,2023-06-05,09:05,0,3,3
27,2023-06-05T09:05:00+10:00,2023-06-05,09:05,0,2,2
30,2023-06-05T09:05:00+10:00,2023-06-05,09:05,1,2,3
35,2023-06-05T09:05:00+10:00,2023-06-05,09:05,2,10,12
48,2023-06-05T09:05:00+10:00,2023-06-05,09:05,3,0,3
51,2023-06-05T09:05:00+10:00,2023-06-05,09:05,1,0,1
53,2023-06-05T09:05:00+10:00,2023-06-05,09:05,7,3,10
57,2023-06-05T09:05:00+10:00,2023-06-05,09:05,2,10,12
63,2023-06-05T09:05:00+10:00,2023-06-05,09:05,2,1,3
45,2023-06-05T09:04:00+10:00,2023-06-05,09:04,7,14,21
69,2023-06-05T09:04:00+10:00,2023-06-05,09:04,4,2,6
77,2023-06-05T09:04:00+10:00,2023-06-05,09:04,0,4,4
108,2023-06-05T09:04:00+10:00,2023-06-05,09:04,4,17,21
2,2023-06-05T09:04:00+10:00,2023-06-05,09:04,1,5,6
9,2023-06-05T09:04:00+10:00,2023-06-05,09:04,2,24,26
11,2023-06-05T09:04:00+10:00,2023-06-05,09:04,1,2,3
17,2023-06-05T09:04:00+10:00,2023-06-05,09:04,14,4,18
18,2023-06-05T09:04:00+10:00,2023-06-05,09:04,1,5,6
20,2023-06-05T09:04:00+10:00,2023-06-05,09:04,0,1,1
24,2023-06-05T09:04:00+10:00,2023-06-05,09:04,5,4,9
30,2023-06-05T09:04:00+10:00,2023-06-05,09:04,1,1,2
48,2023-06-05T09:04:00+10:00,2023-06-05,09:04,2,0,2
51,2023-06-05T09:04:00+10:00,2023-06-05,09:04,0,1,1
53,2023-06-05T09:04:00+10:00,2023-06-05,09:04,9,4,13
56,2023-06-05T09:04:00+10:00,2023-06-05,09:04,2,4,6
57,2023-06-05T09:04:00+10:00,2023-06-05,09:04,2,7,9
58,2023-06-05T09:04:00+10:00,2023-06-05,09:04,3,1,4
68,2023-06-05T09:04:00+10:00,2023-06-05,09:04,2,0,2
72,2023-06-05T09:04:00+10:00,2023-06-05,09:04,6,0,6
4,2023-06-05T09:04:00+10:00,2023-06-05,09:04,9,6,15
5,2023-06-05T09:04:00+10:00,2023-06-05,09:04,2,10,12
8,2023-06-05T09:04:00+10:00,2023-06-05,09:04,3,3,6
21,2023-06-05T09:04:00+10:00,2023-06-05,09:04,2,5,7
28,2023-06-05T09:04:00+10:00,2023-06-05,09:04,6,2,8
55,2023-06-05T09:04:00+10:00,2023-06-05,09:04,6,11,17
61,2023-06-05T09:04:00+10:00,2023-06-05,09:04,3,4,7
66,2023-06-05T09:04:00+10:00,2023-06-05,09:04,2,10,12
70,2023-06-05T09:04:00+10:00,2023-06-05,09:04,2,0,2
87,2023-06-05T09:04:00+10:00,2023-06-05,09:04,0,2,2
1,2023-06-05T09:04:00+10:00,2023-06-05,09:04,5,5,10
12,2023-06-05T09:04:00+10:00,2023-06-05,09:04,1,1,2
35,2023-06-05T09:04:00+10:00,2023-06-05,09:04,3,10,13
62,2023-06-05T09:04:00+10:00,2023-06-05,09:04,2,2,4
63,2023-06-05T09:04:00+10:00,2023-06-05,09:04,3,2,5
67,2023-06-05T09:04:00+10:00,2023-06-05,09:04,8,9,17
79,2023-06-05T09:04:00+10:00,2023-06-05,09:04,12,2,14
86,2023-06-05T09:04:00+10:00,2023-06-05,09:04,1,1,2
3,2023-06-05T09:04:00+10:00,2023-06-05,09:04,1,10,11
26,2023-06-05T09:04:00+10:00,2023-06-05,09:04,2,3,5
29,2023-06-05T09:04:00+10:00,2023-06-05,09:04,2,1,3
31,2023-06-05T09:04:00+10:00,2023-06-05,09:04,0,1,1
36,2023-06-05T09:04:00+10:00,2023-06-05,09:04,5,4,9
40,2023-06-05T09:04:00+10:00,2023-06-05,09:04,6,3,9
6,2023-06-05T09:04:00+10:00,2023-06-05,09:04,5,10,15
14,2023-06-05T09:04:00+10:00,2023-06-05,09:04,2,9,11
37,2023-06-05T09:04:00+10:00,2023-06-05,09:04,1,0,1
39,2023-06-05T09:04:00+10:00,2023-06-05,09:04,4,2,6
41,2023-06-05T09:04:00+10:00,2023-06-05,09:04,34,9,43
42,2023-06-05T09:04:00+10:00,2023-06-05,09:04,1,0,1
47,2023-06-05T09:04:00+10:00,2023-06-05,09:04,3,4,7
50,2023-06-05T09:04:00+10:00,2023-06-05,09:04,0,2,2
54,2023-06-05T09:04:00+10:00,2023-06-05,09:04,2,0,2
65,2023-06-05T09:04:00+10:00,2023-06-05,09:04,8,1,9
71,2023-06-05T09:04:00+10:00,2023-06-05,09:04,0,1,1
10,2023-06-05T09:04:00+10:00,2023-06-05,09:04,2,1,3
23,2023-06-05T09:04:00+10:00,2023-06-05,09:04,1,6,7
52,2023-06-05T09:04:00+10:00,2023-06-05,09:04,0,12,12
76,2023-06-05T09:04:00+10:00,2023-06-05,09:04,0,1,1
85,2023-06-05T09:04:00+10:00,2023-06-05,09:04,5,0,5
61,2023-06-05T09:03:00+10:00,2023-06-05,09:03,1,5,6
66,2023-06-05T09:03:00+10:00,2023-06-05,09:03,4,7,11
70,2023-06-05T09:03:00+10:00,2023-06-05,09:03,2,5,7
75,2023-06-05T09:03:00+10:00,2023-06-05,09:03,3,0,3
78,2023-06-05T09:03:00+10:00,2023-06-05,09:03,0,4,4
1,2023-06-05T09:03:00+10:00,2023-06-05,09:03,1,1,2
2,2023-06-05T09:03:00+10:00,2023-06-05,09:03,0,5,5
9,2023-06-05T09:03:00+10:00,2023-06-05,09:03,2,26,28
10,2023-06-05T09:03:00+10:00,2023-06-05,09:03,1,2,3
19,2023-06-05T09:03:00+10:00,2023-06-05,09:03,1,1,2
23,2023-06-05T09:03:00+10:00,2023-06-05,09:03,12,5,17
35,2023-06-05T09:03:00+10:00,2023-06-05,09:03,4,8,12
49,2023-06-05T09:03:00+10:00,2023-06-05,09:03,0,1,1
56,2023-06-05T09:03:00+10:00,2023-06-05,09:03,2,0,2
57,2023-06-05T09:03:00+10:00,2023-06-05,09:03,8,7,15
63,2023-06-05T09:03:00+10:00,2023-06-05,09:03,4,3,7
67,2023-06-05T09:03:00+10:00,2023-06-05,09:03,3,3,6
68,2023-06-05T09:03:00+10:00,2023-06-05,09:03,0,2,2
76,2023-06-05T09:03:00+10:00,2023-06-05,09:03,0,3,3
8,2023-06-05T09:03:00+10:00,2023-06-05,09:03,3,2,5
14,2023-06-05T09:03:00+10:00,2023-06-05,09:03,6,2,8
26,2023-06-05T09:03:00+10:00,2023-06-05,09:03,3,1,4
36,2023-06-05T09:03:00+10:00,2023-06-05,09:03,4,2,6
45,2023-06-05T09:03:00+10:00,2023-06-05,09:03,1,4,5
50,2023-06-05T09:03:00+10:00,2023-06-05,09:03,4,6,10
54,2023-06-05T09:03:00+10:00,2023-06-05,09:03,6,0,6
65,2023-06-05T09:03:00+10:00,2023-06-05,09:03,10,2,12
69,2023-06-05T09:03:00+10:00,2023-06-05,09:03,1,2,3
77,2023-06-05T09:03:00+10:00,2023-06-05,09:03,1,1,2
12,2023-06-05T09:03:00+10:00,2023-06-05,09:03,1,0,1
46,2023-06-05T09:03:00+10:00,2023-06-05,09:03,0,3,3
48,2023-06-05T09:03:00+10:00,2023-06-05,09:03,0,1,1
58,2023-06-05T09:03:00+10:00,2023-06-05,09:03,23,3,26
62,2023-06-05T09:03:00+10:00,2023-06-05,09:03,1,2,3
72,2023-06-05T09:03:00+10:00,2023-06-05,09:03,1,0,1
85,2023-06-05T09:03:00+10:00,2023-06-05,09:03,0,2,2
4,2023-06-05T09:03:00+10:00,2023-06-05,09:03,9,4,13
28,2023-06-05T09:03:00+10:00,2023-06-05,09:03,9,7,16
29,2023-06-05T09:03:00+10:00,2023-06-05,09:03,1,1,2
39,2023-06-05T09:03:00+10:00,2023-06-05,09:03,5,3,8
40,2023-06-05T09:03:00+10:00,2023-06-05,09:03,2,2,4
41,2023-06-05T09:03:00+10:00,2023-06-05,09:03,43,4,47
3,2023-06-05T09:03:00+10:00,2023-06-05,09:03,7,4,11
5,2023-06-05T09:03:00+10:00,2023-06-05,09:03,5,1,6
6,2023-06-05T09:03:00+10:00,2023-06-05,09:03,8,8,16
21,2023-06-05T09:03:00+10:00,2023-06-05,09:03,3,1,4
37,2023-06-05T09:03:00+10:00,2023-06-05,09:03,1,0,1
44,2023-06-05T09:03:00+10:00,2023-06-05,09:03,1,3,4
47,2023-06-05T09:03:00+10:00,2023-06-05,09:03,5,13,18
55,2023-06-05T09:03:00+10:00,2023-06-05,09:03,11,7,18
71,2023-06-05T09:03:00+10:00,2023-06-05,09:03,3,0,3
87,2023-06-05T09:03:00+10:00,2023-06-05,09:03,2,0,2
108,2023-06-05T09:03:00+10:00,2023-06-05,09:03,3,18,21
17,2023-06-05T09:03:00+10:00,2023-06-05,09:03,11,4,15
18,2023-06-05T09:03:00+10:00,2023-06-05,09:03,2,8,10
20,2023-06-05T09:03:00+10:00,2023-06-05,09:03,1,1,2
24,2023-06-05T09:03:00+10:00,2023-06-05,09:03,50,3,53
27,2023-06-05T09:03:00+10:00,2023-06-05,09:03,0,1,1
51,2023-06-05T09:03:00+10:00,2023-06-05,09:03,0,1,1
52,2023-06-05T09:03:00+10:00,2023-06-05,09:03,1,6,7
53,2023-06-05T09:03:00+10:00,2023-06-05,09:03,7,3,10
79,2023-06-05T09:03:00+10:00,2023-06-05,09:03,6,6,12
86,2023-06-05T09:03:00+10:00,2023-06-05,09:03,2,0,2
54,2023-06-05T09:02:00+10:00,2023-06-05,09:02,4,0,4
55,2023-06-05T09:02:00+10:00,2023-06-05,09:02,7,6,13
61,2023-06-05T09:02:00+10:00,2023-06-05,09:02,3,2,5
70,2023-06-05T09:02:00+10:00,2023-06-05,09:02,1,2,3
77,2023-06-05T09:02:00+10:00,2023-06-05,09:02,0,6,6
78,2023-06-05T09:02:00+10:00,2023-06-05,09:02,1,0,1
87,2023-06-05T09:02:00+10:00,2023-06-05,09:02,0,3,3
1,2023-06-05T09:02:00+10:00,2023-06-05,09:02,5,4,9
2,2023-06-05T09:02:00+10:00,2023-06-05,09:02,3,2,5
12,2023-06-05T09:02:00+10:00,2023-06-05,09:02,4,0,4
19,2023-06-05T09:02:00+10:00,2023-06-05,09:02,1,2,3
23,2023-06-05T09:02:00+10:00,2023-06-05,09:02,7,1,8
27,2023-06-05T09:02:00+10:00,2023-06-05,09:02,1,0,1
35,2023-06-05T09:02:00+10:00,2023-06-05,09:02,4,14,18
46,2023-06-05T09:02:00+10:00,2023-06-05,09:02,2,2,4
53,2023-06-05T09:02:00+10:00,2023-06-05,09:02,6,7,13
56,2023-06-05T09:02:00+10:00,2023-06-05,09:02,1,1,2
57,2023-06-05T09:02:00+10:00,2023-06-05,09:02,2,18,20
68,2023-06-05T09:02:00+10:00,2023-06-05,09:02,0,2,2
86,2023-06-05T09:02:00+10:00,2023-06-05,09:02,1,0,1
4,2023-06-05T09:02:00+10:00,2023-06-05,09:02,14,7,21
14,2023-06-05T09:02:00+10:00,2023-06-05,09:02,4,6,10
21,2023-06-05T09:02:00+10:00,2023-06-05,09:02,4,2,6
26,2023-06-05T09:02:00+10:00,2023-06-05,09:02,4,1,5
47,2023-06-05T09:02:00+10:00,2023-06-05,09:02,5,18,23
66,2023-06-05T09:02:00+10:00,2023-06-05,09:02,1,8,9
24,2023-06-05T09:02:00+10:00,2023-06-05,09:02,14,3,17
30,2023-06-05T09:02:00+10:00,2023-06-05,09:02,3,4,7
58,2023-06-05T09:02:00+10:00,2023-06-05,09:02,31,6,37
67,2023-06-05T09:02:00+10:00,2023-06-05,09:02,8,1,9
72,2023-06-05T09:02:00+10:00,2023-06-05,09:02,15,0,15
76,2023-06-05T09:02:00+10:00,2023-06-05,09:02,2,0,2
79,2023-06-05T09:02:00+10:00,2023-06-05,09:02,7,3,10
85,2023-06-05T09:02:00+10:00,2023-06-05,09:02,3,1,4
3,2023-06-05T09:02:00+10:00,2023-06-05,09:02,2,4,6
6,2023-06-05T09:02:00+10:00,2023-06-05,09:02,5,17,22
8,2023-06-05T09:02:00+10:00,2023-06-05,09:02,2,0,2
36,2023-06-05T09:02:00+10:00,2023-06-05,09:02,5,3,8
37,2023-06-05T09:02:00+10:00,2023-06-05,09:02,0,4,4
42,2023-06-05T09:02:00+10:00,2023-06-05,09:02,1,1,2
5,2023-06-05T09:02:00+10:00,2023-06-05,09:02,6,12,18
28,2023-06-05T09:02:00+10:00,2023-06-05,09:02,12,1,13
29,2023-06-05T09:02:00+10:00,2023-06-05,09:02,1,0,1
39,2023-06-05T09:02:00+10:00,2023-06-05,09:02,5,2,7
40,2023-06-05T09:02:00+10:00,2023-06-05,09:02,4,2,6
41,2023-06-05T09:02:00+10:00,2023-06-05,09:02,15,1,16
45,2023-06-05T09:02:00+10:00,2023-06-05,09:02,1,2,3
65,2023-06-05T09:02:00+10:00,2023-06-05,09:02,18,2,20
69,2023-06-05T09:02:00+10:00,2023-06-05,09:02,3,3,6
71,2023-06-05T09:02:00+10:00,2023-06-05,09:02,1,1,2
75,2023-06-05T09:02:00+10:00,2023-06-05,09:02,1,0,1
108,2023-06-05T09:02:00+10:00,2023-06-05,09:02,4,10,14
9,2023-06-05T09:02:00+10:00,2023-06-05,09:02,1,26,27
10,2023-06-05T09:02:00+10:00,2023-06-05,09:02,0,3,3
11,2023-06-05T09:02:00+10:00,2023-06-05,09:02,1,1,2
17,2023-06-05T09:02:00+10:00,2023-06-05,09:02,30,2,32
18,2023-06-05T09:02:00+10:00,2023-06-05,09:02,4,24,28
51,2023-06-05T09:02:00+10:00,2023-06-05,09:02,1,0,1
52,2023-06-05T09:02:00+10:00,2023-06-05,09:02,0,4,4
63,2023-06-05T09:02:00+10:00,2023-06-05,09:02,1,1,2
45,2023-06-05T09:01:00+10:00,2023-06-05,09:01,4,5,9
50,2023-06-05T09:01:00+10:00,2023-06-05,09:01,0,2,2
69,2023-06-05T09:01:00+10:00,2023-06-05,09:01,2,0,2
71,2023-06-05T09:01:00+10:00,2023-06-05,09:01,1,0,1
1,2023-06-05T09:01:00+10:00,2023-06-05,09:01,0,2,2
2,2023-06-05T09:01:00+10:00,2023-06-05,09:01,3,3,6
18,2023-06-05T09:01:00+10:00,2023-06-05,09:01,3,20,23
20,2023-06-05T09:01:00+10:00,2023-06-05,09:01,1,0,1
23,2023-06-05T09:01:00+10:00,2023-06-05,09:01,9,2,11
30,2023-06-05T09:01:00+10:00,2023-06-05,09:01,0,2,2
46,2023-06-05T09:01:00+10:00,2023-06-05,09:01,2,3,5
48,2023-06-05T09:01:00+10:00,2023-06-05,09:01,8,1,9
57,2023-06-05T09:01:00+10:00,2023-06-05,09:01,4,8,12
68,2023-06-05T09:01:00+10:00,2023-06-05,09:01,2,3,5
86,2023-06-05T09:01:00+10:00,2023-06-05,09:01,2,1,3
8,2023-06-05T09:01:00+10:00,2023-06-05,09:01,1,1,2
14,2023-06-05T09:01:00+10:00,2023-06-05,09:01,3,13,16
21,2023-06-05T09:01:00+10:00,2023-06-05,09:01,3,2,5
28,2023-06-05T09:01:00+10:00,2023-06-05,09:01,13,1,14
42,2023-06-05T09:01:00+10:00,2023-06-05,09:01,3,1,4
54,2023-06-05T09:01:00+10:00,2023-06-05,09:01,2,1,3
55,2023-06-05T09:01:00+10:00,2023-06-05,09:01,5,2,7
61,2023-06-05T09:01:00+10:00,2023-06-05,09:01,3,6,9
66,2023-06-05T09:01:00+10:00,2023-06-05,09:01,0,5,5
70,2023-06-05T09:01:00+10:00,2023-06-05,09:01,1,3,4
75,2023-06-05T09:01:00+10:00,2023-06-05,09:01,1,0,1
87,2023-06-05T09:01:00+10:00,2023-06-05,09:01,1,1,2
10,2023-06-05T09:01:00+10:00,2023-06-05,09:01,0,1,1
12,2023-06-05T09:01:00+10:00,2023-06-05,09:01,2,3,5
27,2023-06-05T09:01:00+10:00,2023-06-05,09:01,0,2,2
35,2023-06-05T09:01:00+10:00,2023-06-05,09:01,7,13,20
52,2023-06-05T09:01:00+10:00,2023-06-05,09:01,3,9,12
56,2023-06-05T09:01:00+10:00,2023-06-05,09:01,0,3,3
58,2023-06-05T09:01:00+10:00,2023-06-05,09:01,6,2,8
63,2023-06-05T09:01:00+10:00,2023-06-05,09:01,2,3,5
67,2023-06-05T09:01:00+10:00,2023-06-05,09:01,8,8,16
85,2023-06-05T09:01:00+10:00,2023-06-05,09:01,3,4,7
3,2023-06-05T09:01:00+10:00,2023-06-05,09:01,1,5,6
4,2023-06-05T09:01:00+10:00,2023-06-05,09:01,6,5,11
5,2023-06-05T09:01:00+10:00,2023-06-05,09:01,1,7,8
6,2023-06-05T09:01:00+10:00,2023-06-05,09:01,4,14,18
26,2023-06-05T09:01:00+10:00,2023-06-05,09:01,3,4,7
31,2023-06-05T09:01:00+10:00,2023-06-05,09:01,1,1,2
29,2023-06-05T09:01:00+10:00,2023-06-05,09:01,3,1,4
36,2023-06-05T09:01:00+10:00,2023-06-05,09:01,2,1,3
37,2023-06-05T09:01:00+10:00,2023-06-05,09:01,5,2,7
39,2023-06-05T09:01:00+10:00,2023-06-05,09:01,9,6,15
40,2023-06-05T09:01:00+10:00,2023-06-05,09:01,6,8,14
41,2023-06-05T09:01:00+10:00,2023-06-05,09:01,71,5,76
47,2023-06-05T09:01:00+10:00,2023-06-05,09:01,6,5,11
65,2023-06-05T09:01:00+10:00,2023-06-05,09:01,7,1,8
77,2023-06-05T09:01:00+10:00,2023-06-05,09:01,2,2,4
78,2023-06-05T09:01:00+10:00,2023-06-05,09:01,0,2,2
108,2023-06-05T09:01:00+10:00,2023-06-05,09:01,8,22,30
9,2023-06-05T09:01:00+10:00,2023-06-05,09:01,2,33,35
17,2023-06-05T09:01:00+10:00,2023-06-05,09:01,20,3,23
19,2023-06-05T09:01:00+10:00,2023-06-05,09:01,4,1,5
24,2023-06-05T09:01:00+10:00,2023-06-05,09:01,26,3,29
53,2023-06-05T09:01:00+10:00,2023-06-05,09:01,6,1,7
72,2023-06-05T09:01:00+10:00,2023-06-05,09:01,5,2,7
76,2023-06-05T09:01:00+10:00,2023-06-05,09:01,2,0,2
79,2023-06-05T09:01:00+10:00,2023-06-05,09:01,14,7,21
45,2023-06-05T09:00:00+10:00,2023-06-05,09:00,6,2,8
54,2023-06-05T09:00:00+10:00,2023-06-05,09:00,0,2,2
107,2023-06-05T09:00:00+10:00,2023-06-05,09:00,8,16,24
118,2023-06-05T09:00:00+10:00,2023-06-05,09:00,4,0,4
18,2023-06-05T09:00:00+10:00,2023-06-05,09:00,2,11,13
19,2023-06-05T09:00:00+10:00,2023-06-05,09:00,0,1,1
23,2023-06-05T09:00:00+10:00,2023-06-05,09:00,11,1,12
48,2023-06-05T09:00:00+10:00,2023-06-05,09:00,4,0,4
53,2023-06-05T09:00:00+10:00,2023-06-05,09:00,9,14,23
68,2023-06-05T09:00:00+10:00,2023-06-05,09:00,5,0,5
79,2023-06-05T09:00:00+10:00,2023-06-05,09:00,1,7,8
5,2023-06-05T09:00:00+10:00,2023-06-05,09:00,4,11,15
21,2023-06-05T09:00:00+10:00,2023-06-05,09:00,0,5,5
26,2023-06-05T09:00:00+10:00,2023-06-05,09:00,4,4,8
42,2023-06-05T09:00:00+10:00,2023-06-05,09:00,7,1,8
47,2023-06-05T09:00:00+10:00,2023-06-05,09:00,5,16,21
59,2023-06-05T09:00:00+10:00,2023-06-05,09:00,40,24,64
65,2023-06-05T09:00:00+10:00,2023-06-05,09:00,6,1,7
69,2023-06-05T09:00:00+10:00,2023-06-05,09:00,5,0,5
75,2023-06-05T09:00:00+10:00,2023-06-05,09:00,1,0,1
78,2023-06-05T09:00:00+10:00,2023-06-05,09:00,0,1,1
1,2023-06-05T09:00:00+10:00,2023-06-05,09:00,1,1,2
9,2023-06-05T09:00:00+10:00,2023-06-05,09:00,0,40,40
11,2023-06-05T09:00:00+10:00,2023-06-05,09:00,7,2,9
12,2023-06-05T09:00:00+10:00,2023-06-05,09:00,1,4,5
30,2023-06-05T09:00:00+10:00,2023-06-05,09:00,1,1,2
35,2023-06-05T09:00:00+10:00,2023-06-05,09:00,10,24,34
46,2023-06-05T09:00:00+10:00,2023-06-05,09:00,3,3,6
49,2023-06-05T09:00:00+10:00,2023-06-05,09:00,1,0,1
51,2023-06-05T09:00:00+10:00,2023-06-05,09:00,0,1,1
56,2023-06-05T09:00:00+10:00,2023-06-05,09:00,1,1,2
58,2023-06-05T09:00:00+10:00,2023-06-05,09:00,24,8,32
63,2023-06-05T09:00:00+10:00,2023-06-05,09:00,4,1,5
109,2023-06-05T09:00:00+10:00,2023-06-05,09:00,8,46,54
3,2023-06-05T09:00:00+10:00,2023-06-05,09:00,1,4,5
8,2023-06-05T09:00:00+10:00,2023-06-05,09:00,3,1,4
29,2023-06-05T09:00:00+10:00,2023-06-05,09:00,1,1,2
40,2023-06-05T09:00:00+10:00,2023-06-05,09:00,4,8,12
4,2023-06-05T09:00:00+10:00,2023-06-05,09:00,15,1,16
6,2023-06-05T09:00:00+10:00,2023-06-05,09:00,8,15,23
14,2023-06-05T09:00:00+10:00,2023-06-05,09:00,2,3,5
28,2023-06-05T09:00:00+10:00,2023-06-05,09:00,6,4,10
31,2023-06-05T09:00:00+10:00,2023-06-05,09:00,0,5,5
36,2023-06-05T09:00:00+10:00,2023-06-05,09:00,6,2,8
37,2023-06-05T09:00:00+10:00,2023-06-05,09:00,0,2,2
39,2023-06-05T09:00:00+10:00,2023-06-05,09:00,3,2,5
41,2023-06-05T09:00:00+10:00,2023-06-05,09:00,37,2,39
55,2023-06-05T09:00:00+10:00,2023-06-05,09:00,9,6,15
61,2023-06-05T09:00:00+10:00,2023-06-05,09:00,1,3,4
66,2023-06-05T09:00:00+10:00,2023-06-05,09:00,2,11,13
70,2023-06-05T09:00:00+10:00,2023-06-05,09:00,2,0,2
71,2023-06-05T09:00:00+10:00,2023-06-05,09:00,2,0,2
84,2023-06-05T09:00:00+10:00,2023-06-05,09:00,92,31,123
87,2023-06-05T09:00:00+10:00,2023-06-05,09:00,2,2,4
108,2023-06-05T09:00:00+10:00,2023-06-05,09:00,6,13,19
2,2023-06-05T09:00:00+10:00,2023-06-05,09:00,2,4,6
10,2023-06-05T09:00:00+10:00,2023-06-05,09:00,1,8,9
17,2023-06-05T09:00:00+10:00,2023-06-05,09:00,12,6,18
24,2023-06-05T09:00:00+10:00,2023-06-05,09:00,38,9,47
52,2023-06-05T09:00:00+10:00,2023-06-05,09:00,3,13,16
57,2023-06-05T09:00:00+10:00,2023-06-05,09:00,3,6,9
62,2023-06-05T09:00:00+10:00,2023-06-05,09:00,3,2,5
67,2023-06-05T09:00:00+10:00,2023-06-05,09:00,7,5,12
72,2023-06-05T09:00:00+10:00,2023-06-05,09:00,29,0,29
76,2023-06-05T09:00:00+10:00,2023-06-05,09:00,2,2,4
85,2023-06-05T09:00:00+10:00,2023-06-05,09:00,2,2,4
117,2023-06-05T09:00:00+10:00,2023-06-05,09:00,19,1,20
45,2023-06-05T08:59:00+10:00,2023-06-05,08:59,5,2,7
50,2023-06-05T08:59:00+10:00,2023-06-05,08:59,0,1,1
55,2023-06-05T08:59:00+10:00,2023-06-05,08:59,6,8,14
69,2023-06-05T08:59:00+10:00,2023-06-05,08:59,4,1,5
77,2023-06-05T08:59:00+10:00,2023-06-05,08:59,3,2,5
108,2023-06-05T08:59:00+10:00,2023-06-05,08:59,3,11,14
9,2023-06-05T08:59:00+10:00,2023-06-05,08:59,1,21,22
10,2023-06-05T08:59:00+10:00,2023-06-05,08:59,1,2,3
19,2023-06-05T08:59:00+10:00,2023-06-05,08:59,3,1,4
30,2023-06-05T08:59:00+10:00,2023-06-05,08:59,2,0,2
48,2023-06-05T08:59:00+10:00,2023-06-05,08:59,3,1,4
63,2023-06-05T08:59:00+10:00,2023-06-05,08:59,0,2,2
67,2023-06-05T08:59:00+10:00,2023-06-05,08:59,9,1,10
68,2023-06-05T08:59:00+10:00,2023-06-05,08:59,5,0,5
72,2023-06-05T08:59:00+10:00,2023-06-05,08:59,2,2,4
3,2023-06-05T08:59:00+10:00,2023-06-05,08:59,1,6,7
6,2023-06-05T08:59:00+10:00,2023-06-05,08:59,14,25,39
28,2023-06-05T08:59:00+10:00,2023-06-05,08:59,8,5,13
31,2023-06-05T08:59:00+10:00,2023-06-05,08:59,0,2,2
36,2023-06-05T08:59:00+10:00,2023-06-05,08:59,5,1,6
42,2023-06-05T08:59:00+10:00,2023-06-05,08:59,3,1,4
47,2023-06-05T08:59:00+10:00,2023-06-05,08:59,11,14,25
54,2023-06-05T08:59:00+10:00,2023-06-05,08:59,0,2,2
61,2023-06-05T08:59:00+10:00,2023-06-05,08:59,1,2,3
65,2023-06-05T08:59:00+10:00,2023-06-05,08:59,12,7,19
66,2023-06-05T08:59:00+10:00,2023-06-05,08:59,1,11,12
75,2023-06-05T08:59:00+10:00,2023-06-05,08:59,1,0,1
78,2023-06-05T08:59:00+10:00,2023-06-05,08:59,2,1,3
2,2023-06-05T08:59:00+10:00,2023-06-05,08:59,3,0,3
11,2023-06-05T08:59:00+10:00,2023-06-05,08:59,0,1,1
17,2023-06-05T08:59:00+10:00,2023-06-05,08:59,27,3,30
18,2023-06-05T08:59:00+10:00,2023-06-05,08:59,1,17,18
23,2023-06-05T08:59:00+10:00,2023-06-05,08:59,2,7,9
35,2023-06-05T08:59:00+10:00,2023-06-05,08:59,5,17,22
57,2023-06-05T08:59:00+10:00,2023-06-05,08:59,9,17,26
79,2023-06-05T08:59:00+10:00,2023-06-05,08:59,3,5,8
5,2023-06-05T08:59:00+10:00,2023-06-05,08:59,8,17,25
8,2023-06-05T08:59:00+10:00,2023-06-05,08:59,1,2,3
26,2023-06-05T08:59:00+10:00,2023-06-05,08:59,2,3,5
29,2023-06-05T08:59:00+10:00,2023-06-05,08:59,2,3,5
41,2023-06-05T08:59:00+10:00,2023-06-05,08:59,39,4,43
44,2023-06-05T08:59:00+10:00,2023-06-05,08:59,1,1,2
4,2023-06-05T08:59:00+10:00,2023-06-05,08:59,16,2,18
14,2023-06-05T08:59:00+10:00,2023-06-05,08:59,2,4,6
21,2023-06-05T08:59:00+10:00,2023-06-05,08:59,1,4,5
37,2023-06-05T08:59:00+10:00,2023-06-05,08:59,0,4,4
39,2023-06-05T08:59:00+10:00,2023-06-05,08:59,1,0,1
40,2023-06-05T08:59:00+10:00,2023-06-05,08:59,1,4,5
70,2023-06-05T08:59:00+10:00,2023-06-05,08:59,2,0,2
87,2023-06-05T08:59:00+10:00,2023-06-05,08:59,1,2,3
1,2023-06-05T08:59:00+10:00,2023-06-05,08:59,8,1,9
12,2023-06-05T08:59:00+10:00,2023-06-05,08:59,6,1,7
20,2023-06-05T08:59:00+10:00,2023-06-05,08:59,1,0,1
24,2023-06-05T08:59:00+10:00,2023-06-05,08:59,12,2,14
27,2023-06-05T08:59:00+10:00,2023-06-05,08:59,0,3,3
46,2023-06-05T08:59:00+10:00,2023-06-05,08:59,0,1,1
52,2023-06-05T08:59:00+10:00,2023-06-05,08:59,2,11,13
53,2023-06-05T08:59:00+10:00,2023-06-05,08:59,4,4,8
56,2023-06-05T08:59:00+10:00,2023-06-05,08:59,0,3,3
58,2023-06-05T08:59:00+10:00,2023-06-05,08:59,2,1,3
62,2023-06-05T08:59:00+10:00,2023-06-05,08:59,1,3,4
76,2023-06-05T08:59:00+10:00,2023-06-05,08:59,5,1,6
85,2023-06-05T08:59:00+10:00,2023-06-05,08:59,2,1,3
86,2023-06-05T08:59:00+10:00,2023-06-05,08:59,1,1,2
50,2023-06-05T08:58:00+10:00,2023-06-05,08:58,2,1,3
54,2023-06-05T08:58:00+10:00,2023-06-05,08:58,1,2,3
65,2023-06-05T08:58:00+10:00,2023-06-05,08:58,6,3,9
77,2023-06-05T08:58:00+10:00,2023-06-05,08:58,3,1,4
108,2023-06-05T08:58:00+10:00,2023-06-05,08:58,3,19,22
1,2023-06-05T08:58:00+10:00,2023-06-05,08:58,9,6,15
10,2023-06-05T08:58:00+10:00,2023-06-05,08:58,1,2,3
18,2023-06-05T08:58:00+10:00,2023-06-05,08:58,3,13,16
19,2023-06-05T08:58:00+10:00,2023-06-05,08:58,0,1,1
53,2023-06-05T08:58:00+10:00,2023-06-05,08:58,9,6,15
76,2023-06-05T08:58:00+10:00,2023-06-05,08:58,0,1,1
79,2023-06-05T08:58:00+10:00,2023-06-05,08:58,2,5,7
86,2023-06-05T08:58:00+10:00,2023-06-05,08:58,1,0,1
26,2023-06-05T08:58:00+10:00,2023-06-05,08:58,4,2,6
28,2023-06-05T08:58:00+10:00,2023-06-05,08:58,9,1,10
36,2023-06-05T08:58:00+10:00,2023-06-05,08:58,8,5,13
37,2023-06-05T08:58:00+10:00,2023-06-05,08:58,0,1,1
40,2023-06-05T08:58:00+10:00,2023-06-05,08:58,0,4,4
41,2023-06-05T08:58:00+10:00,2023-06-05,08:58,18,8,26
45,2023-06-05T08:58:00+10:00,2023-06-05,08:58,2,3,5
47,2023-06-05T08:58:00+10:00,2023-06-05,08:58,4,3,7
75,2023-06-05T08:58:00+10:00,2023-06-05,08:58,1,0,1
78,2023-06-05T08:58:00+10:00,2023-06-05,08:58,0,4,4
2,2023-06-05T08:58:00+10:00,2023-06-05,08:58,1,5,6
20,2023-06-05T08:58:00+10:00,2023-06-05,08:58,0,1,1
23,2023-06-05T08:58:00+10:00,2023-06-05,08:58,8,10,18
35,2023-06-05T08:58:00+10:00,2023-06-05,08:58,3,13,16
48,2023-06-05T08:58:00+10:00,2023-06-05,08:58,2,4,6
51,2023-06-05T08:58:00+10:00,2023-06-05,08:58,3,3,6
62,2023-06-05T08:58:00+10:00,2023-06-05,08:58,0,2,2
67,2023-06-05T08:58:00+10:00,2023-06-05,08:58,5,3,8
85,2023-06-05T08:58:00+10:00,2023-06-05,08:58,2,0,2
3,2023-06-05T08:58:00+10:00,2023-06-05,08:58,4,8,12
4,2023-06-05T08:58:00+10:00,2023-06-05,08:58,3,8,11
5,2023-06-05T08:58:00+10:00,2023-06-05,08:58,2,9,11
6,2023-06-05T08:58:00+10:00,2023-06-05,08:58,6,41,47
21,2023-06-05T08:58:00+10:00,2023-06-05,08:58,1,1,2
31,2023-06-05T08:58:00+10:00,2023-06-05,08:58,1,3,4
8,2023-06-05T08:58:00+10:00,2023-06-05,08:58,6,2,8
14,2023-06-05T08:58:00+10:00,2023-06-05,08:58,7,4,11
29,2023-06-05T08:58:00+10:00,2023-06-05,08:58,0,1,1
39,2023-06-05T08:58:00+10:00,2023-06-05,08:58,1,1,2
55,2023-06-05T08:58:00+10:00,2023-06-05,08:58,3,8,11
61,2023-06-05T08:58:00+10:00,2023-06-05,08:58,3,8,11
66,2023-06-05T08:58:00+10:00,2023-06-05,08:58,0,7,7
70,2023-06-05T08:58:00+10:00,2023-06-05,08:58,1,1,2
71,2023-06-05T08:58:00+10:00,2023-06-05,08:58,1,1,2
87,2023-06-05T08:58:00+10:00,2023-06-05,08:58,1,0,1
9,2023-06-05T08:58:00+10:00,2023-06-05,08:58,1,23,24
12,2023-06-05T08:58:00+10:00,2023-06-05,08:58,4,1,5
17,2023-06-05T08:58:00+10:00,2023-06-05,08:58,8,3,11
24,2023-06-05T08:58:00+10:00,2023-06-05,08:58,40,1,41
27,2023-06-05T08:58:00+10:00,2023-06-05,08:58,0,1,1
30,2023-06-05T08:58:00+10:00,2023-06-05,08:58,2,4,6
46,2023-06-05T08:58:00+10:00,2023-06-05,08:58,2,1,3
52,2023-06-05T08:58:00+10:00,2023-06-05,08:58,11,6,17
56,2023-06-05T08:58:00+10:00,2023-06-05,08:58,0,1,1
57,2023-06-05T08:58:00+10:00,2023-06-05,08:58,4,2,6
58,2023-06-05T08:58:00+10:00,2023-06-05,08:58,34,2,36
63,2023-06-05T08:58:00+10:00,2023-06-05,08:58,0,2,2
68,2023-06-05T08:58:00+10:00,2023-06-05,08:58,2,1,3
72,2023-06-05T08:58:00+10:00,2023-06-05,08:58,5,2,7
45,2023-06-05T08:57:00+10:00,2023-06-05,08:57,3,7,10
61,2023-06-05T08:57:00+10:00,2023-06-05,08:57,1,3,4
66,2023-06-05T08:57:00+10:00,2023-06-05,08:57,0,8,8
70,2023-06-05T08:57:00+10:00,2023-06-05,08:57,3,3,6
108,2023-06-05T08:57:00+10:00,2023-06-05,08:57,2,9,11
2,2023-06-05T08:57:00+10:00,2023-06-05,08:57,1,6,7
19,2023-06-05T08:57:00+10:00,2023-06-05,08:57,2,3,5
24,2023-06-05T08:57:00+10:00,2023-06-05,08:57,23,6,29
46,2023-06-05T08:57:00+10:00,2023-06-05,08:57,1,3,4
57,2023-06-05T08:57:00+10:00,2023-06-05,08:57,2,13,15
63,2023-06-05T08:57:00+10:00,2023-06-05,08:57,3,4,7
68,2023-06-05T08:57:00+10:00,2023-06-05,08:57,1,1,2
85,2023-06-05T08:57:00+10:00,2023-06-05,08:57,3,2,5
4,2023-06-05T08:57:00+10:00,2023-06-05,08:57,12,9,21
6,2023-06-05T08:57:00+10:00,2023-06-05,08:57,4,26,30
21,2023-06-05T08:57:00+10:00,2023-06-05,08:57,0,5,5
26,2023-06-05T08:57:00+10:00,2023-06-05,08:57,1,3,4
40,2023-06-05T08:57:00+10:00,2023-06-05,08:57,8,5,13
55,2023-06-05T08:57:00+10:00,2023-06-05,08:57,4,3,7
65,2023-06-05T08:57:00+10:00,2023-06-05,08:57,2,5,7
75,2023-06-05T08:57:00+10:00,2023-06-05,08:57,0,1,1
77,2023-06-05T08:57:00+10:00,2023-06-05,08:57,3,2,5
78,2023-06-05T08:57:00+10:00,2023-06-05,08:57,1,1,2
9,2023-06-05T08:57:00+10:00,2023-06-05,08:57,4,48,52
30,2023-06-05T08:57:00+10:00,2023-06-05,08:57,0,3,3
48,2023-06-05T08:57:00+10:00,2023-06-05,08:57,5,0,5
51,2023-06-05T08:57:00+10:00,2023-06-05,08:57,0,1,1
58,2023-06-05T08:57:00+10:00,2023-06-05,08:57,15,3,18
62,2023-06-05T08:57:00+10:00,2023-06-05,08:57,3,0,3
67,2023-06-05T08:57:00+10:00,2023-06-05,08:57,2,1,3
72,2023-06-05T08:57:00+10:00,2023-06-05,08:57,7,1,8
79,2023-06-05T08:57:00+10:00,2023-06-05,08:57,19,2,21
5,2023-06-05T08:57:00+10:00,2023-06-05,08:57,5,7,12
31,2023-06-05T08:57:00+10:00,2023-06-05,08:57,1,2,3
36,2023-06-05T08:57:00+10:00,2023-06-05,08:57,6,2,8
39,2023-06-05T08:57:00+10:00,2023-06-05,08:57,4,3,7
41,2023-06-05T08:57:00+10:00,2023-06-05,08:57,18,4,22
3,2023-06-05T08:57:00+10:00,2023-06-05,08:57,4,9,13
8,2023-06-05T08:57:00+10:00,2023-06-05,08:57,0,3,3
14,2023-06-05T08:57:00+10:00,2023-06-05,08:57,3,3,6
28,2023-06-05T08:57:00+10:00,2023-06-05,08:57,8,5,13
42,2023-06-05T08:57:00+10:00,2023-06-05,08:57,2,0,2
47,2023-06-05T08:57:00+10:00,2023-06-05,08:57,4,16,20
54,2023-06-05T08:57:00+10:00,2023-06-05,08:57,0,2,2
69,2023-06-05T08:57:00+10:00,2023-06-05,08:57,4,2,6
71,2023-06-05T08:57:00+10:00,2023-06-05,08:57,1,0,1
87,2023-06-05T08:57:00+10:00,2023-06-05,08:57,1,1,2
1,2023-06-05T08:57:00+10:00,2023-06-05,08:57,3,4,7
10,2023-06-05T08:57:00+10:00,2023-06-05,08:57,0,3,3
11,2023-06-05T08:57:00+10:00,2023-06-05,08:57,1,0,1
17,2023-06-05T08:57:00+10:00,2023-06-05,08:57,27,3,30
18,2023-06-05T08:57:00+10:00,2023-06-05,08:57,4,22,26
23,2023-06-05T08:57:00+10:00,2023-06-05,08:57,6,4,10
27,2023-06-05T08:57:00+10:00,2023-06-05,08:57,4,0,4
35,2023-06-05T08:57:00+10:00,2023-06-05,08:57,8,13,21
52,2023-06-05T08:57:00+10:00,2023-06-05,08:57,3,2,5
53,2023-06-05T08:57:00+10:00,2023-06-05,08:57,9,3,12
50,2023-06-05T08:56:00+10:00,2023-06-05,08:56,0,1,1
54,2023-06-05T08:56:00+10:00,2023-06-05,08:56,3,2,5
65,2023-06-05T08:56:00+10:00,2023-06-05,08:56,3,0,3
66,2023-06-05T08:56:00+10:00,2023-06-05,08:56,3,11,14
69,2023-06-05T08:56:00+10:00,2023-06-05,08:56,7,0,7
70,2023-06-05T08:56:00+10:00,2023-06-05,08:56,0,1,1
9,2023-06-05T08:56:00+10:00,2023-06-05,08:56,2,27,29
49,2023-06-05T08:56:00+10:00,2023-06-05,08:56,0,1,1
52,2023-06-05T08:56:00+10:00,2023-06-05,08:56,3,11,14
58,2023-06-05T08:56:00+10:00,2023-06-05,08:56,14,2,16
67,2023-06-05T08:56:00+10:00,2023-06-05,08:56,2,4,6
79,2023-06-05T08:56:00+10:00,2023-06-05,08:56,5,3,8
5,2023-06-05T08:56:00+10:00,2023-06-05,08:56,7,5,12
21,2023-06-05T08:56:00+10:00,2023-06-05,08:56,3,4,7
28,2023-06-05T08:56:00+10:00,2023-06-05,08:56,14,4,18
45,2023-06-05T08:56:00+10:00,2023-06-05,08:56,0,6,6
47,2023-06-05T08:56:00+10:00,2023-06-05,08:56,3,18,21
55,2023-06-05T08:56:00+10:00,2023-06-05,08:56,6,9,15
71,2023-06-05T08:56:00+10:00,2023-06-05,08:56,1,1,2
77,2023-06-05T08:56:00+10:00,2023-06-05,08:56,2,7,9
2,2023-06-05T08:56:00+10:00,2023-06-05,08:56,1,2,3
10,2023-06-05T08:56:00+10:00,2023-06-05,08:56,4,6,10
11,2023-06-05T08:56:00+10:00,2023-06-05,08:56,0,1,1
12,2023-06-05T08:56:00+10:00,2023-06-05,08:56,1,2,3
17,2023-06-05T08:56:00+10:00,2023-06-05,08:56,16,3,19
18,2023-06-05T08:56:00+10:00,2023-06-05,08:56,2,20,22
19,2023-06-05T08:56:00+10:00,2023-06-05,08:56,0,1,1
20,2023-06-05T08:56:00+10:00,2023-06-05,08:56,1,1,2
23,2023-06-05T08:56:00+10:00,2023-06-05,08:56,15,5,20
24,2023-06-05T08:56:00+10:00,2023-06-05,08:56,35,1,36
27,2023-06-05T08:56:00+10:00,2023-06-05,08:56,0,4,4
46,2023-06-05T08:56:00+10:00,2023-06-05,08:56,1,3,4
62,2023-06-05T08:56:00+10:00,2023-06-05,08:56,2,3,5
63,2023-06-05T08:56:00+10:00,2023-06-05,08:56,3,7,10
68,2023-06-05T08:56:00+10:00,2023-06-05,08:56,2,1,3
76,2023-06-05T08:56:00+10:00,2023-06-05,08:56,0,2,2
85,2023-06-05T08:56:00+10:00,2023-06-05,08:56,0,1,1
8,2023-06-05T08:56:00+10:00,2023-06-05,08:56,5,3,8
14,2023-06-05T08:56:00+10:00,2023-06-05,08:56,5,4,9
26,2023-06-05T08:56:00+10:00,2023-06-05,08:56,3,0,3
31,2023-06-05T08:56:00+10:00,2023-06-05,08:56,2,2,4
36,2023-06-05T08:56:00+10:00,2023-06-05,08:56,9,2,11
39,2023-06-05T08:56:00+10:00,2023-06-05,08:56,5,4,9
41,2023-06-05T08:56:00+10:00,2023-06-05,08:56,16,3,19
3,2023-06-05T08:56:00+10:00,2023-06-05,08:56,4,3,7
4,2023-06-05T08:56:00+10:00,2023-06-05,08:56,7,7,14
6,2023-06-05T08:56:00+10:00,2023-06-05,08:56,1,15,16
40,2023-06-05T08:56:00+10:00,2023-06-05,08:56,2,5,7
42,2023-06-05T08:56:00+10:00,2023-06-05,08:56,5,1,6
61,2023-06-05T08:56:00+10:00,2023-06-05,08:56,3,15,18
75,2023-06-05T08:56:00+10:00,2023-06-05,08:56,0,2,2
87,2023-06-05T08:56:00+10:00,2023-06-05,08:56,4,0,4
108,2023-06-05T08:56:00+10:00,2023-06-05,08:56,6,11,17
1,2023-06-05T08:56:00+10:00,2023-06-05,08:56,2,3,5
30,2023-06-05T08:56:00+10:00,2023-06-05,08:56,2,4,6
35,2023-06-05T08:56:00+10:00,2023-06-05,08:56,4,12,16
48,2023-06-05T08:56:00+10:00,2023-06-05,08:56,3,1,4
53,2023-06-05T08:56:00+10:00,2023-06-05,08:56,5,5,10
56,2023-06-05T08:56:00+10:00,2023-06-05,08:56,6,4,10
57,2023-06-05T08:56:00+10:00,2023-06-05,08:56,4,11,15
72,2023-06-05T08:56:00+10:00,2023-06-05,08:56,3,3,6
26,2023-06-05T08:55:00+10:00,2023-06-05,08:55,0,3,3
29,2023-06-05T08:55:00+10:00,2023-06-05,08:55,2,0,2
36,2023-06-05T08:55:00+10:00,2023-06-05,08:55,7,4,11
37,2023-06-05T08:55:00+10:00,2023-06-05,08:55,0,2,2
44,2023-06-05T08:55:00+10:00,2023-06-05,08:55,0,1,1
59,2023-06-05T08:55:00+10:00,2023-06-05,08:55,48,12,60
65,2023-06-05T08:55:00+10:00,2023-06-05,08:55,4,0,4
71,2023-06-05T08:55:00+10:00,2023-06-05,08:55,4,0,4
118,2023-06-05T08:55:00+10:00,2023-06-05,08:55,4,1,5
2,2023-06-05T08:55:00+10:00,2023-06-05,08:55,1,2,3
12,2023-06-05T08:55:00+10:00,2023-06-05,08:55,1,2,3
46,2023-06-05T08:55:00+10:00,2023-06-05,08:55,1,6,7
67,2023-06-05T08:55:00+10:00,2023-06-05,08:55,8,6,14
68,2023-06-05T08:55:00+10:00,2023-06-05,08:55,3,1,4
4,2023-06-05T08:55:00+10:00,2023-06-05,08:55,4,3,7
8,2023-06-05T08:55:00+10:00,2023-06-05,08:55,1,1,2
14,2023-06-05T08:55:00+10:00,2023-06-05,08:55,4,9,13
21,2023-06-05T08:55:00+10:00,2023-06-05,08:55,0,1,1
28,2023-06-05T08:55:00+10:00,2023-06-05,08:55,8,0,8
31,2023-06-05T08:55:00+10:00,2023-06-05,08:55,0,1,1
41,2023-06-05T08:55:00+10:00,2023-06-05,08:55,27,5,32
45,2023-06-05T08:55:00+10:00,2023-06-05,08:55,6,6,12
54,2023-06-05T08:55:00+10:00,2023-06-05,08:55,2,0,2
61,2023-06-05T08:55:00+10:00,2023-06-05,08:55,3,1,4
66,2023-06-05T08:55:00+10:00,2023-06-05,08:55,3,8,11
84,2023-06-05T08:55:00+10:00,2023-06-05,08:55,78,17,95
107,2023-06-05T08:55:00+10:00,2023-06-05,08:55,4,20,24
9,2023-06-05T08:55:00+10:00,2023-06-05,08:55,1,30,31
11,2023-06-05T08:55:00+10:00,2023-06-05,08:55,8,1,9
17,2023-06-05T08:55:00+10:00,2023-06-05,08:55,28,6,34
24,2023-06-05T08:55:00+10:00,2023-06-05,08:55,47,19,66
30,2023-06-05T08:55:00+10:00,2023-06-05,08:55,0,3,3
35,2023-06-05T08:55:00+10:00,2023-06-05,08:55,3,17,20
56,2023-06-05T08:55:00+10:00,2023-06-05,08:55,1,2,3
58,2023-06-05T08:55:00+10:00,2023-06-05,08:55,35,0,35
63,2023-06-05T08:55:00+10:00,2023-06-05,08:55,3,2,5
85,2023-06-05T08:55:00+10:00,2023-06-05,08:55,2,0,2
3,2023-06-05T08:55:00+10:00,2023-06-05,08:55,2,5,7
5,2023-06-05T08:55:00+10:00,2023-06-05,08:55,2,9,11
6,2023-06-05T08:55:00+10:00,2023-06-05,08:55,7,23,30
39,2023-06-05T08:55:00+10:00,2023-06-05,08:55,4,1,5
40,2023-06-05T08:55:00+10:00,2023-06-05,08:55,2,5,7
42,2023-06-05T08:55:00+10:00,2023-06-05,08:55,3,0,3
47,2023-06-05T08:55:00+10:00,2023-06-05,08:55,5,7,12
55,2023-06-05T08:55:00+10:00,2023-06-05,08:55,10,7,17
69,2023-06-05T08:55:00+10:00,2023-06-05,08:55,7,3,10
70,2023-06-05T08:55:00+10:00,2023-06-05,08:55,4,1,5
75,2023-06-05T08:55:00+10:00,2023-06-05,08:55,2,0,2
77,2023-06-05T08:55:00+10:00,2023-06-05,08:55,1,1,2
78,2023-06-05T08:55:00+10:00,2023-06-05,08:55,1,0,1
87,2023-06-05T08:55:00+10:00,2023-06-05,08:55,0,3,3
108,2023-06-05T08:55:00+10:00,2023-06-05,08:55,0,19,19
1,2023-06-05T08:55:00+10:00,2023-06-05,08:55,5,7,12
10,2023-06-05T08:55:00+10:00,2023-06-05,08:55,0,10,10
18,2023-06-05T08:55:00+10:00,2023-06-05,08:55,2,11,13
19,2023-06-05T08:55:00+10:00,2023-06-05,08:55,1,1,2
20,2023-06-05T08:55:00+10:00,2023-06-05,08:55,1,0,1
23,2023-06-05T08:55:00+10:00,2023-06-05,08:55,15,3,18
48,2023-06-05T08:55:00+10:00,2023-06-05,08:55,2,0,2
49,2023-06-05T08:55:00+10:00,2023-06-05,08:55,1,0,1
52,2023-06-05T08:55:00+10:00,2023-06-05,08:55,2,10,12
53,2023-06-05T08:55:00+10:00,2023-06-05,08:55,6,4,10
57,2023-06-05T08:55:00+10:00,2023-06-05,08:55,6,5,11
62,2023-06-05T08:55:00+10:00,2023-06-05,08:55,2,0,2
72,2023-06-05T08:55:00+10:00,2023-06-05,08:55,3,3,6
79,2023-06-05T08:55:00+10:00,2023-06-05,08:55,1,3,4
109,2023-06-05T08:55:00+10:00,2023-06-05,08:55,12,44,56
117,2023-06-05T08:55:00+10:00,2023-06-05,08:55,17,10,27
8,2023-06-05T08:54:00+10:00,2023-06-05,08:54,4,2,6
14,2023-06-05T08:54:00+10:00,2023-06-05,08:54,2,2,4
31,2023-06-05T08:54:00+10:00,2023-06-05,08:54,2,0,2
37,2023-06-05T08:54:00+10:00,2023-06-05,08:54,0,1,1
39,2023-06-05T08:54:00+10:00,2023-06-05,08:54,0,3,3
42,2023-06-05T08:54:00+10:00,2023-06-05,08:54,2,2,4
54,2023-06-05T08:54:00+10:00,2023-06-05,08:54,1,2,3
55,2023-06-05T08:54:00+10:00,2023-06-05,08:54,10,11,21
66,2023-06-05T08:54:00+10:00,2023-06-05,08:54,1,14,15
69,2023-06-05T08:54:00+10:00,2023-06-05,08:54,7,2,9
70,2023-06-05T08:54:00+10:00,2023-06-05,08:54,1,2,3
75,2023-06-05T08:54:00+10:00,2023-06-05,08:54,1,1,2
77,2023-06-05T08:54:00+10:00,2023-06-05,08:54,1,5,6
78,2023-06-05T08:54:00+10:00,2023-06-05,08:54,1,0,1
18,2023-06-05T08:54:00+10:00,2023-06-05,08:54,4,25,29
23,2023-06-05T08:54:00+10:00,2023-06-05,08:54,5,5,10
35,2023-06-05T08:54:00+10:00,2023-06-05,08:54,3,15,18
46,2023-06-05T08:54:00+10:00,2023-06-05,08:54,1,0,1
53,2023-06-05T08:54:00+10:00,2023-06-05,08:54,3,5,8
57,2023-06-05T08:54:00+10:00,2023-06-05,08:54,3,9,12
63,2023-06-05T08:54:00+10:00,2023-06-05,08:54,2,1,3
68,2023-06-05T08:54:00+10:00,2023-06-05,08:54,1,2,3
72,2023-06-05T08:54:00+10:00,2023-06-05,08:54,7,2,9
76,2023-06-05T08:54:00+10:00,2023-06-05,08:54,3,1,4
79,2023-06-05T08:54:00+10:00,2023-06-05,08:54,17,4,21
85,2023-06-05T08:54:00+10:00,2023-06-05,08:54,2,0,2
4,2023-06-05T08:54:00+10:00,2023-06-05,08:54,7,5,12
5,2023-06-05T08:54:00+10:00,2023-06-05,08:54,3,8,11
6,2023-06-05T08:54:00+10:00,2023-06-05,08:54,4,8,12
26,2023-06-05T08:54:00+10:00,2023-06-05,08:54,2,1,3
36,2023-06-05T08:54:00+10:00,2023-06-05,08:54,13,1,14
41,2023-06-05T08:54:00+10:00,2023-06-05,08:54,20,5,25
45,2023-06-05T08:54:00+10:00,2023-06-05,08:54,4,4,8
71,2023-06-05T08:54:00+10:00,2023-06-05,08:54,1,1,2
87,2023-06-05T08:54:00+10:00,2023-06-05,08:54,1,0,1
2,2023-06-05T08:54:00+10:00,2023-06-05,08:54,3,7,10
11,2023-06-05T08:54:00+10:00,2023-06-05,08:54,1,0,1
17,2023-06-05T08:54:00+10:00,2023-06-05,08:54,15,5,20
24,2023-06-05T08:54:00+10:00,2023-06-05,08:54,13,3,16
27,2023-06-05T08:54:00+10:00,2023-06-05,08:54,0,4,4
30,2023-06-05T08:54:00+10:00,2023-06-05,08:54,0,3,3
67,2023-06-05T08:54:00+10:00,2023-06-05,08:54,4,2,6
3,2023-06-05T08:54:00+10:00,2023-06-05,08:54,2,5,7
21,2023-06-05T08:54:00+10:00,2023-06-05,08:54,2,1,3
28,2023-06-05T08:54:00+10:00,2023-06-05,08:54,5,2,7
40,2023-06-05T08:54:00+10:00,2023-06-05,08:54,6,8,14
44,2023-06-05T08:54:00+10:00,2023-06-05,08:54,0,2,2
47,2023-06-05T08:54:00+10:00,2023-06-05,08:54,7,19,26
50,2023-06-05T08:54:00+10:00,2023-06-05,08:54,1,2,3
61,2023-06-05T08:54:00+10:00,2023-06-05,08:54,3,9,12
65,2023-06-05T08:54:00+10:00,2023-06-05,08:54,3,3,6
108,2023-06-05T08:54:00+10:00,2023-06-05,08:54,0,15,15
1,2023-06-05T08:54:00+10:00,2023-06-05,08:54,9,3,12
9,2023-06-05T08:54:00+10:00,2023-06-05,08:54,0,36,36
10,2023-06-05T08:54:00+10:00,2023-06-05,08:54,1,3,4
12,2023-06-05T08:54:00+10:00,2023-06-05,08:54,4,1,5
48,2023-06-05T08:54:00+10:00,2023-06-05,08:54,2,1,3
52,2023-06-05T08:54:00+10:00,2023-06-05,08:54,1,11,12
58,2023-06-05T08:54:00+10:00,2023-06-05,08:54,18,3,21
14,2023-06-05T08:53:00+10:00,2023-06-05,08:53,1,4,5
26,2023-06-05T08:53:00+10:00,2023-06-05,08:53,4,3,7
36,2023-06-05T08:53:00+10:00,2023-06-05,08:53,7,2,9
37,2023-06-05T08:53:00+10:00,2023-06-05,08:53,0,1,1
39,2023-06-05T08:53:00+10:00,2023-06-05,08:53,4,4,8
40,2023-06-05T08:53:00+10:00,2023-06-05,08:53,3,7,10
42,2023-06-05T08:53:00+10:00,2023-06-05,08:53,3,0,3
47,2023-06-05T08:53:00+10:00,2023-06-05,08:53,6,33,39
69,2023-06-05T08:53:00+10:00,2023-06-05,08:53,4,1,5
71,2023-06-05T08:53:00+10:00,2023-06-05,08:53,1,0,1
12,2023-06-05T08:53:00+10:00,2023-06-05,08:53,2,0,2
17,2023-06-05T08:53:00+10:00,2023-06-05,08:53,21,13,34
19,2023-06-05T08:53:00+10:00,2023-06-05,08:53,4,2,6
23,2023-06-05T08:53:00+10:00,2023-06-05,08:53,18,3,21
24,2023-06-05T08:53:00+10:00,2023-06-05,08:53,69,0,69
35,2023-06-05T08:53:00+10:00,2023-06-05,08:53,7,19,26
56,2023-06-05T08:53:00+10:00,2023-06-05,08:53,2,0,2
57,2023-06-05T08:53:00+10:00,2023-06-05,08:53,3,8,11
58,2023-06-05T08:53:00+10:00,2023-06-05,08:53,31,3,34
62,2023-06-05T08:53:00+10:00,2023-06-05,08:53,0,1,1
72,2023-06-05T08:53:00+10:00,2023-06-05,08:53,9,0,9
76,2023-06-05T08:53:00+10:00,2023-06-05,08:53,0,1,1
4,2023-06-05T08:53:00+10:00,2023-06-05,08:53,7,10,17
5,2023-06-05T08:53:00+10:00,2023-06-05,08:53,1,15,16
8,2023-06-05T08:53:00+10:00,2023-06-05,08:53,1,3,4
21,2023-06-05T08:53:00+10:00,2023-06-05,08:53,1,4,5
28,2023-06-05T08:53:00+10:00,2023-06-05,08:53,5,6,11
41,2023-06-05T08:53:00+10:00,2023-06-05,08:53,33,4,37
45,2023-06-05T08:53:00+10:00,2023-06-05,08:53,2,3,5
50,2023-06-05T08:53:00+10:00,2023-06-05,08:53,0,4,4
61,2023-06-05T08:53:00+10:00,2023-06-05,08:53,1,2,3
65,2023-06-05T08:53:00+10:00,2023-06-05,08:53,16,1,17
66,2023-06-05T08:53:00+10:00,2023-06-05,08:53,2,19,21
70,2023-06-05T08:53:00+10:00,2023-06-05,08:53,3,2,5
78,2023-06-05T08:53:00+10:00,2023-06-05,08:53,1,1,2
108,2023-06-05T08:53:00+10:00,2023-06-05,08:53,6,30,36
2,2023-06-05T08:53:00+10:00,2023-06-05,08:53,3,2,5
9,2023-06-05T08:53:00+10:00,2023-06-05,08:53,11,49,60
20,2023-06-05T08:53:00+10:00,2023-06-05,08:53,1,0,1
52,2023-06-05T08:53:00+10:00,2023-06-05,08:53,8,3,11
53,2023-06-05T08:53:00+10:00,2023-06-05,08:53,2,9,11
63,2023-06-05T08:53:00+10:00,2023-06-05,08:53,6,3,9
67,2023-06-05T08:53:00+10:00,2023-06-05,08:53,10,6,16
68,2023-06-05T08:53:00+10:00,2023-06-05,08:53,1,1,2
3,2023-06-05T08:53:00+10:00,2023-06-05,08:53,1,8,9
6,2023-06-05T08:53:00+10:00,2023-06-05,08:53,4,22,26
31,2023-06-05T08:53:00+10:00,2023-06-05,08:53,2,1,3
54,2023-06-05T08:53:00+10:00,2023-06-05,08:53,3,1,4
55,2023-06-05T08:53:00+10:00,2023-06-05,08:53,2,10,12
75,2023-06-05T08:53:00+10:00,2023-06-05,08:53,1,0,1
77,2023-06-05T08:53:00+10:00,2023-06-05,08:53,3,4,7
87,2023-06-05T08:53:00+10:00,2023-06-05,08:53,1,0,1
1,2023-06-05T08:53:00+10:00,2023-06-05,08:53,4,3,7
10,2023-06-05T08:53:00+10:00,2023-06-05,08:53,3,3,6
18,2023-06-05T08:53:00+10:00,2023-06-05,08:53,2,25,27
27,2023-06-05T08:53:00+10:00,2023-06-05,08:53,1,0,1
30,2023-06-05T08:53:00+10:00,2023-06-05,08:53,6,3,9
46,2023-06-05T08:53:00+10:00,2023-06-05,08:53,1,3,4
48,2023-06-05T08:53:00+10:00,2023-06-05,08:53,1,1,2
49,2023-06-05T08:53:00+10:00,2023-06-05,08:53,0,2,2
51,2023-06-05T08:53:00+10:00,2023-06-05,08:53,2,0,2
79,2023-06-05T08:53:00+10:00,2023-06-05,08:53,6,6,12
85,2023-06-05T08:53:00+10:00,2023-06-05,08:53,3,0,3
86,2023-06-05T08:53:00+10:00,2023-06-05,08:53,2,1,3
3,2023-06-05T08:52:00+10:00,2023-06-05,08:52,3,7,10
5,2023-06-05T08:52:00+10:00,2023-06-05,08:52,3,11,14
6,2023-06-05T08:52:00+10:00,2023-06-05,08:52,6,34,40
8,2023-06-05T08:52:00+10:00,2023-06-05,08:52,3,3,6
14,2023-06-05T08:52:00+10:00,2023-06-05,08:52,4,6,10
26,2023-06-05T08:52:00+10:00,2023-06-05,08:52,3,2,5
31,2023-06-05T08:52:00+10:00,2023-06-05,08:52,1,1,2
44,2023-06-05T08:52:00+10:00,2023-06-05,08:52,0,2,2
55,2023-06-05T08:52:00+10:00,2023-06-05,08:52,9,9,18
70,2023-06-05T08:52:00+10:00,2023-06-05,08:52,3,1,4
75,2023-06-05T08:52:00+10:00,2023-06-05,08:52,0,3,3
87,2023-06-05T08:52:00+10:00,2023-06-05,08:52,1,4,5
1,2023-06-05T08:52:00+10:00,2023-06-05,08:52,3,0,3
9,2023-06-05T08:52:00+10:00,2023-06-05,08:52,4,51,55
18,2023-06-05T08:52:00+10:00,2023-06-05,08:52,4,13,17
24,2023-06-05T08:52:00+10:00,2023-06-05,08:52,26,2,28
30,2023-06-05T08:52:00+10:00,2023-06-05,08:52,1,1,2
48,2023-06-05T08:52:00+10:00,2023-06-05,08:52,1,0,1
52,2023-06-05T08:52:00+10:00,2023-06-05,08:52,1,5,6
53,2023-06-05T08:52:00+10:00,2023-06-05,08:52,7,5,12
56,2023-06-05T08:52:00+10:00,2023-06-05,08:52,4,2,6
57,2023-06-05T08:52:00+10:00,2023-06-05,08:52,11,20,31
68,2023-06-05T08:52:00+10:00,2023-06-05,08:52,1,1,2
76,2023-06-05T08:52:00+10:00,2023-06-05,08:52,3,0,3
85,2023-06-05T08:52:00+10:00,2023-06-05,08:52,0,1,1
28,2023-06-05T08:52:00+10:00,2023-06-05,08:52,12,2,14
29,2023-06-05T08:52:00+10:00,2023-06-05,08:52,2,1,3
36,2023-06-05T08:52:00+10:00,2023-06-05,08:52,3,0,3
37,2023-06-05T08:52:00+10:00,2023-06-05,08:52,0,1,1
40,2023-06-05T08:52:00+10:00,2023-06-05,08:52,2,7,9
41,2023-06-05T08:52:00+10:00,2023-06-05,08:52,32,4,36
45,2023-06-05T08:52:00+10:00,2023-06-05,08:52,1,2,3
47,2023-06-05T08:52:00+10:00,2023-06-05,08:52,2,5,7
50,2023-06-05T08:52:00+10:00,2023-06-05,08:52,0,3,3
54,2023-06-05T08:52:00+10:00,2023-06-05,08:52,3,0,3
66,2023-06-05T08:52:00+10:00,2023-06-05,08:52,5,5,10
77,2023-06-05T08:52:00+10:00,2023-06-05,08:52,1,8,9
2,2023-06-05T08:52:00+10:00,2023-06-05,08:52,1,3,4
12,2023-06-05T08:52:00+10:00,2023-06-05,08:52,2,1,3
17,2023-06-05T08:52:00+10:00,2023-06-05,08:52,28,3,31
19,2023-06-05T08:52:00+10:00,2023-06-05,08:52,1,1,2
20,2023-06-05T08:52:00+10:00,2023-06-05,08:52,0,3,3
23,2023-06-05T08:52:00+10:00,2023-06-05,08:52,9,7,16
27,2023-06-05T08:52:00+10:00,2023-06-05,08:52,0,2,2
62,2023-06-05T08:52:00+10:00,2023-06-05,08:52,3,0,3
67,2023-06-05T08:52:00+10:00,2023-06-05,08:52,6,5,11
72,2023-06-05T08:52:00+10:00,2023-06-05,08:52,8,1,9
79,2023-06-05T08:52:00+10:00,2023-06-05,08:52,10,7,17
4,2023-06-05T08:52:00+10:00,2023-06-05,08:52,6,5,11
21,2023-06-05T08:52:00+10:00,2023-06-05,08:52,0,1,1
39,2023-06-05T08:52:00+10:00,2023-06-05,08:52,4,1,5
42,2023-06-05T08:52:00+10:00,2023-06-05,08:52,5,1,6
61,2023-06-05T08:52:00+10:00,2023-06-05,08:52,0,5,5
65,2023-06-05T08:52:00+10:00,2023-06-05,08:52,4,3,7
69,2023-06-05T08:52:00+10:00,2023-06-05,08:52,2,0,2
71,2023-06-05T08:52:00+10:00,2023-06-05,08:52,1,0,1
78,2023-06-05T08:52:00+10:00,2023-06-05,08:52,1,1,2
108,2023-06-05T08:52:00+10:00,2023-06-05,08:52,1,28,29
10,2023-06-05T08:52:00+10:00,2023-06-05,08:52,2,4,6
35,2023-06-05T08:52:00+10:00,2023-06-05,08:52,7,25,32
46,2023-06-05T08:52:00+10:00,2023-06-05,08:52,1,3,4
51,2023-06-05T08:52:00+10:00,2023-06-05,08:52,3,0,3
58,2023-06-05T08:52:00+10:00,2023-06-05,08:52,19,5,24
63,2023-06-05T08:52:00+10:00,2023-06-05,08:52,6,4,10
4,2023-06-05T08:51:00+10:00,2023-06-05,08:51,9,6,15
39,2023-06-05T08:51:00+10:00,2023-06-05,08:51,2,4,6
42,2023-06-05T08:51:00+10:00,2023-06-05,08:51,6,0,6
47,2023-06-05T08:51:00+10:00,2023-06-05,08:51,6,19,25
54,2023-06-05T08:51:00+10:00,2023-06-05,08:51,1,0,1
70,2023-06-05T08:51:00+10:00,2023-06-05,08:51,1,0,1
71,2023-06-05T08:51:00+10:00,2023-06-05,08:51,2,1,3
108,2023-06-05T08:51:00+10:00,2023-06-05,08:51,1,22,23
1,2023-06-05T08:51:00+10:00,2023-06-05,08:51,4,4,8
9,2023-06-05T08:51:00+10:00,2023-06-05,08:51,0,29,29
11,2023-06-05T08:51:00+10:00,2023-06-05,08:51,0,1,1
12,2023-06-05T08:51:00+10:00,2023-06-05,08:51,1,2,3
23,2023-06-05T08:51:00+10:00,2023-06-05,08:51,11,1,12
27,2023-06-05T08:51:00+10:00,2023-06-05,08:51,1,4,5
46,2023-06-05T08:51:00+10:00,2023-06-05,08:51,0,1,1
51,2023-06-05T08:51:00+10:00,2023-06-05,08:51,0,1,1
52,2023-06-05T08:51:00+10:00,2023-06-05,08:51,2,7,9
53,2023-06-05T08:51:00+10:00,2023-06-05,08:51,17,9,26
56,2023-06-05T08:51:00+10:00,2023-06-05,08:51,1,1,2
58,2023-06-05T08:51:00+10:00,2023-06-05,08:51,31,2,33
62,2023-06-05T08:51:00+10:00,2023-06-05,08:51,0,1,1
72,2023-06-05T08:51:00+10:00,2023-06-05,08:51,15,1,16
76,2023-06-05T08:51:00+10:00,2023-06-05,08:51,3,2,5
6,2023-06-05T08:51:00+10:00,2023-06-05,08:51,18,13,31
8,2023-06-05T08:51:00+10:00,2023-06-05,08:51,0,1,1
21,2023-06-05T08:51:00+10:00,2023-06-05,08:51,5,3,8
36,2023-06-05T08:51:00+10:00,2023-06-05,08:51,5,1,6
37,2023-06-05T08:51:00+10:00,2023-06-05,08:51,1,3,4
40,2023-06-05T08:51:00+10:00,2023-06-05,08:51,6,6,12
41,2023-06-05T08:51:00+10:00,2023-06-05,08:51,24,10,34
45,2023-06-05T08:51:00+10:00,2023-06-05,08:51,8,4,12
50,2023-06-05T08:51:00+10:00,2023-06-05,08:51,1,7,8
69,2023-06-05T08:51:00+10:00,2023-06-05,08:51,2,3,5
2,2023-06-05T08:51:00+10:00,2023-06-05,08:51,4,5,9
10,2023-06-05T08:51:00+10:00,2023-06-05,08:51,3,3,6
17,2023-06-05T08:51:00+10:00,2023-06-05,08:51,21,1,22
19,2023-06-05T08:51:00+10:00,2023-06-05,08:51,1,3,4
20,2023-06-05T08:51:00+10:00,2023-06-05,08:51,1,3,4
24,2023-06-05T08:51:00+10:00,2023-06-05,08:51,33,12,45
30,2023-06-05T08:51:00+10:00,2023-06-05,08:51,0,1,1
35,2023-06-05T08:51:00+10:00,2023-06-05,08:51,4,19,23
57,2023-06-05T08:51:00+10:00,2023-06-05,08:51,8,12,20
79,2023-06-05T08:51:00+10:00,2023-06-05,08:51,19,8,27
3,2023-06-05T08:51:00+10:00,2023-06-05,08:51,9,7,16
5,2023-06-05T08:51:00+10:00,2023-06-05,08:51,8,4,12
14,2023-06-05T08:51:00+10:00,2023-06-05,08:51,3,3,6
26,2023-06-05T08:51:00+10:00,2023-06-05,08:51,5,6,11
28,2023-06-05T08:51:00+10:00,2023-06-05,08:51,6,2,8
29,2023-06-05T08:51:00+10:00,2023-06-05,08:51,1,1,2
44,2023-06-05T08:51:00+10:00,2023-06-05,08:51,0,1,1
55,2023-06-05T08:51:00+10:00,2023-06-05,08:51,8,16,24
61,2023-06-05T08:51:00+10:00,2023-06-05,08:51,9,2,11
65,2023-06-05T08:51:00+10:00,2023-06-05,08:51,6,2,8
66,2023-06-05T08:51:00+10:00,2023-06-05,08:51,4,12,16
75,2023-06-05T08:51:00+10:00,2023-06-05,08:51,2,2,4
77,2023-06-05T08:51:00+10:00,2023-06-05,08:51,4,1,5
78,2023-06-05T08:51:00+10:00,2023-06-05,08:51,0,3,3
87,2023-06-05T08:51:00+10:00,2023-06-05,08:51,0,2,2
18,2023-06-05T08:51:00+10:00,2023-06-05,08:51,1,13,14
48,2023-06-05T08:51:00+10:00,2023-06-05,08:51,6,1,7
63,2023-06-05T08:51:00+10:00,2023-06-05,08:51,2,2,4
67,2023-06-05T08:51:00+10:00,2023-06-05,08:51,2,10,12
68,2023-06-05T08:51:00+10:00,2023-06-05,08:51,6,4,10
86,2023-06-05T08:51:00+10:00,2023-06-05,08:51,0,1,1
29,2023-06-05T08:50:00+10:00,2023-06-05,08:50,3,0,3
31,2023-06-05T08:50:00+10:00,2023-06-05,08:50,1,0,1
36,2023-06-05T08:50:00+10:00,2023-06-05,08:50,12,2,14
40,2023-06-05T08:50:00+10:00,2023-06-05,08:50,2,2,4
54,2023-06-05T08:50:00+10:00,2023-06-05,08:50,4,0,4
59,2023-06-05T08:50:00+10:00,2023-06-05,08:50,36,20,56
61,2023-06-05T08:50:00+10:00,2023-06-05,08:50,0,4,4
65,2023-06-05T08:50:00+10:00,2023-06-05,08:50,6,4,10
69,2023-06-05T08:50:00+10:00,2023-06-05,08:50,2,1,3
71,2023-06-05T08:50:00+10:00,2023-06-05,08:50,1,1,2
87,2023-06-05T08:50:00+10:00,2023-06-05,08:50,2,4,6
107,2023-06-05T08:50:00+10:00,2023-06-05,08:50,7,25,32
20,2023-06-05T08:50:00+10:00,2023-06-05,08:50,0,1,1
24,2023-06-05T08:50:00+10:00,2023-06-05,08:50,52,1,53
27,2023-06-05T08:50:00+10:00,2023-06-05,08:50,4,1,5
35,2023-06-05T08:50:00+10:00,2023-06-05,08:50,1,13,14
48,2023-06-05T08:50:00+10:00,2023-06-05,08:50,1,1,2
52,2023-06-05T08:50:00+10:00,2023-06-05,08:50,5,6,11
53,2023-06-05T08:50:00+10:00,2023-06-05,08:50,6,2,8
67,2023-06-05T08:50:00+10:00,2023-06-05,08:50,6,7,13
76,2023-06-05T08:50:00+10:00,2023-06-05,08:50,1,0,1
79,2023-06-05T08:50:00+10:00,2023-06-05,08:50,6,12,18
85,2023-06-05T08:50:00+10:00,2023-06-05,08:50,1,1,2
86,2023-06-05T08:50:00+10:00,2023-06-05,08:50,0,2,2
109,2023-06-05T08:50:00+10:00,2023-06-05,08:50,5,54,59
117,2023-06-05T08:50:00+10:00,2023-06-05,08:50,36,7,43
4,2023-06-05T08:50:00+10:00,2023-06-05,08:50,9,7,16
5,2023-06-05T08:50:00+10:00,2023-06-05,08:50,4,7,11
6,2023-06-05T08:50:00+10:00,2023-06-05,08:50,13,27,40
8,2023-06-05T08:50:00+10:00,2023-06-05,08:50,3,1,4
26,2023-06-05T08:50:00+10:00,2023-06-05,08:50,2,2,4
41,2023-06-05T08:50:00+10:00,2023-06-05,08:50,35,5,40
42,2023-06-05T08:50:00+10:00,2023-06-05,08:50,2,0,2
44,2023-06-05T08:50:00+10:00,2023-06-05,08:50,0,1,1
45,2023-06-05T08:50:00+10:00,2023-06-05,08:50,1,4,5
50,2023-06-05T08:50:00+10:00,2023-06-05,08:50,2,1,3
70,2023-06-05T08:50:00+10:00,2023-06-05,08:50,1,1,2
84,2023-06-05T08:50:00+10:00,2023-06-05,08:50,85,15,100
108,2023-06-05T08:50:00+10:00,2023-06-05,08:50,3,14,17
118,2023-06-05T08:50:00+10:00,2023-06-05,08:50,2,3,5
1,2023-06-05T08:50:00+10:00,2023-06-05,08:50,3,3,6
12,2023-06-05T08:50:00+10:00,2023-06-05,08:50,3,2,5
18,2023-06-05T08:50:00+10:00,2023-06-05,08:50,0,33,33
23,2023-06-05T08:50:00+10:00,2023-06-05,08:50,13,4,17
30,2023-06-05T08:50:00+10:00,2023-06-05,08:50,4,2,6
56,2023-06-05T08:50:00+10:00,2023-06-05,08:50,2,2,4
63,2023-06-05T08:50:00+10:00,2023-06-05,08:50,2,6,8
3,2023-06-05T08:50:00+10:00,2023-06-05,08:50,3,5,8
14,2023-06-05T08:50:00+10:00,2023-06-05,08:50,5,2,7
28,2023-06-05T08:50:00+10:00,2023-06-05,08:50,5,6,11
39,2023-06-05T08:50:00+10:00,2023-06-05,08:50,1,4,5
47,2023-06-05T08:50:00+10:00,2023-06-05,08:50,8,17,25
55,2023-06-05T08:50:00+10:00,2023-06-05,08:50,6,6,12
66,2023-06-05T08:50:00+10:00,2023-06-05,08:50,4,13,17
75,2023-06-05T08:50:00+10:00,2023-06-05,08:50,1,0,1
77,2023-06-05T08:50:00+10:00,2023-06-05,08:50,2,5,7
78,2023-06-05T08:50:00+10:00,2023-06-05,08:50,1,1,2
2,2023-06-05T08:50:00+10:00,2023-06-05,08:50,1,4,5
9,2023-06-05T08:50:00+10:00,2023-06-05,08:50,2,28,30
10,2023-06-05T08:50:00+10:00,2023-06-05,08:50,0,6,6
11,2023-06-05T08:50:00+10:00,2023-06-05,08:50,2,1,3
17,2023-06-05T08:50:00+10:00,2023-06-05,08:50,12,2,14
19,2023-06-05T08:50:00+10:00,2023-06-05,08:50,2,0,2
46,2023-06-05T08:50:00+10:00,2023-06-05,08:50,2,3,5
49,2023-06-05T08:50:00+10:00,2023-06-05,08:50,2,2,4
57,2023-06-05T08:50:00+10:00,2023-06-05,08:50,2,14,16
58,2023-06-05T08:50:00+10:00,2023-06-05,08:50,59,0,59
62,2023-06-05T08:50:00+10:00,2023-06-05,08:50,1,2,3
68,2023-06-05T08:50:00+10:00,2023-06-05,08:50,3,0,3
72,2023-06-05T08:50:00+10:00,2023-06-05,08:50,9,0,9
6,2023-06-05T08:49:00+10:00,2023-06-05,08:49,9,9,18
14,2023-06-05T08:49:00+10:00,2023-06-05,08:49,7,4,11
31,2023-06-05T08:49:00+10:00,2023-06-05,08:49,2,1,3
45,2023-06-05T08:49:00+10:00,2023-06-05,08:49,2,6,8
47,2023-06-05T08:49:00+10:00,2023-06-05,08:49,5,2,7
77,2023-06-05T08:49:00+10:00,2023-06-05,08:49,4,0,4
19,2023-06-05T08:49:00+10:00,2023-06-05,08:49,1,2,3
30,2023-06-05T08:49:00+10:00,2023-06-05,08:49,0,2,2
51,2023-06-05T08:49:00+10:00,2023-06-05,08:49,1,0,1
52,2023-06-05T08:49:00+10:00,2023-06-05,08:49,2,6,8
58,2023-06-05T08:49:00+10:00,2023-06-05,08:49,14,0,14
62,2023-06-05T08:49:00+10:00,2023-06-05,08:49,4,1,5
67,2023-06-05T08:49:00+10:00,2023-06-05,08:49,4,8,12
72,2023-06-05T08:49:00+10:00,2023-06-05,08:49,5,0,5
76,2023-06-05T08:49:00+10:00,2023-06-05,08:49,1,0,1
86,2023-06-05T08:49:00+10:00,2023-06-05,08:49,2,2,4
4,2023-06-05T08:49:00+10:00,2023-06-05,08:49,7,5,12
21,2023-06-05T08:49:00+10:00,2023-06-05,08:49,0,7,7
26,2023-06-05T08:49:00+10:00,2023-06-05,08:49,4,1,5
41,2023-06-05T08:49:00+10:00,2023-06-05,08:49,22,1,23
42,2023-06-05T08:49:00+10:00,2023-06-05,08:49,0,2,2
44,2023-06-05T08:49:00+10:00,2023-06-05,08:49,1,1,2
66,2023-06-05T08:49:00+10:00,2023-06-05,08:49,3,3,6
69,2023-06-05T08:49:00+10:00,2023-06-05,08:49,1,0,1
70,2023-06-05T08:49:00+10:00,2023-06-05,08:49,0,1,1
75,2023-06-05T08:49:00+10:00,2023-06-05,08:49,0,3,3
78,2023-06-05T08:49:00+10:00,2023-06-05,08:49,2,6,8
108,2023-06-05T08:49:00+10:00,2023-06-05,08:49,4,33,37
1,2023-06-05T08:49:00+10:00,2023-06-05,08:49,4,3,7
9,2023-06-05T08:49:00+10:00,2023-06-05,08:49,0,24,24
10,2023-06-05T08:49:00+10:00,2023-06-05,08:49,5,1,6
18,2023-06-05T08:49:00+10:00,2023-06-05,08:49,2,20,22
20,2023-06-05T08:49:00+10:00,2023-06-05,08:49,1,2,3
35,2023-06-05T08:49:00+10:00,2023-06-05,08:49,14,19,33
46,2023-06-05T08:49:00+10:00,2023-06-05,08:49,0,2,2
56,2023-06-05T08:49:00+10:00,2023-06-05,08:49,3,4,7
63,2023-06-05T08:49:00+10:00,2023-06-05,08:49,2,3,5
3,2023-06-05T08:49:00+10:00,2023-06-05,08:49,6,6,12
5,2023-06-05T08:49:00+10:00,2023-06-05,08:49,4,14,18
8,2023-06-05T08:49:00+10:00,2023-06-05,08:49,6,5,11
28,2023-06-05T08:49:00+10:00,2023-06-05,08:49,17,4,21
29,2023-06-05T08:49:00+10:00,2023-06-05,08:49,1,3,4
36,2023-06-05T08:49:00+10:00,2023-06-05,08:49,5,1,6
37,2023-06-05T08:49:00+10:00,2023-06-05,08:49,0,1,1
39,2023-06-05T08:49:00+10:00,2023-06-05,08:49,13,5,18
40,2023-06-05T08:49:00+10:00,2023-06-05,08:49,1,7,8
50,2023-06-05T08:49:00+10:00,2023-06-05,08:49,2,0,2
54,2023-06-05T08:49:00+10:00,2023-06-05,08:49,2,0,2
55,2023-06-05T08:49:00+10:00,2023-06-05,08:49,13,7,20
61,2023-06-05T08:49:00+10:00,2023-06-05,08:49,4,4,8
65,2023-06-05T08:49:00+10:00,2023-06-05,08:49,9,4,13
87,2023-06-05T08:49:00+10:00,2023-06-05,08:49,2,1,3
2,2023-06-05T08:49:00+10:00,2023-06-05,08:49,3,4,7
17,2023-06-05T08:49:00+10:00,2023-06-05,08:49,24,3,27
23,2023-06-05T08:49:00+10:00,2023-06-05,08:49,3,7,10
24,2023-06-05T08:49:00+10:00,2023-06-05,08:49,12,19,31
27,2023-06-05T08:49:00+10:00,2023-06-05,08:49,2,0,2
48,2023-06-05T08:49:00+10:00,2023-06-05,08:49,3,1,4
53,2023-06-05T08:49:00+10:00,2023-06-05,08:49,5,5,10
57,2023-06-05T08:49:00+10:00,2023-06-05,08:49,1,7,8
68,2023-06-05T08:49:00+10:00,2023-06-05,08:49,5,0,5
79,2023-06-05T08:49:00+10:00,2023-06-05,08:49,6,3,9
85,2023-06-05T08:49:00+10:00,2023-06-05,08:49,2,2,4
3,2023-06-05T08:48:00+10:00,2023-06-05,08:48,7,7,14
6,2023-06-05T08:48:00+10:00,2023-06-05,08:48,5,13,18
29,2023-06-05T08:48:00+10:00,2023-06-05,08:48,1,2,3
37,2023-06-05T08:48:00+10:00,2023-06-05,08:48,1,1,2
55,2023-06-05T08:48:00+10:00,2023-06-05,08:48,8,6,14
65,2023-06-05T08:48:00+10:00,2023-06-05,08:48,4,3,7
69,2023-06-05T08:48:00+10:00,2023-06-05,08:48,3,0,3
75,2023-06-05T08:48:00+10:00,2023-06-05,08:48,1,0,1
87,2023-06-05T08:48:00+10:00,2023-06-05,08:48,2,1,3
108,2023-06-05T08:48:00+10:00,2023-06-05,08:48,4,10,14
11,2023-06-05T08:48:00+10:00,2023-06-05,08:48,2,0,2
19,2023-06-05T08:48:00+10:00,2023-06-05,08:48,1,1,2
24,2023-06-05T08:48:00+10:00,2023-06-05,08:48,61,4,65
27,2023-06-05T08:48:00+10:00,2023-06-05,08:48,1,4,5
46,2023-06-05T08:48:00+10:00,2023-06-05,08:48,0,3,3
49,2023-06-05T08:48:00+10:00,2023-06-05,08:48,2,0,2
52,2023-06-05T08:48:00+10:00,2023-06-05,08:48,0,5,5
57,2023-06-05T08:48:00+10:00,2023-06-05,08:48,1,12,13
67,2023-06-05T08:48:00+10:00,2023-06-05,08:48,4,5,9
72,2023-06-05T08:48:00+10:00,2023-06-05,08:48,17,5,22
76,2023-06-05T08:48:00+10:00,2023-06-05,08:48,3,1,4
79,2023-06-05T08:48:00+10:00,2023-06-05,08:48,1,7,8
4,2023-06-05T08:48:00+10:00,2023-06-05,08:48,13,2,15
8,2023-06-05T08:48:00+10:00,2023-06-05,08:48,5,0,5
14,2023-06-05T08:48:00+10:00,2023-06-05,08:48,2,9,11
21,2023-06-05T08:48:00+10:00,2023-06-05,08:48,1,0,1
28,2023-06-05T08:48:00+10:00,2023-06-05,08:48,9,9,18
31,2023-06-05T08:48:00+10:00,2023-06-05,08:48,2,1,3
39,2023-06-05T08:48:00+10:00,2023-06-05,08:48,7,3,10
44,2023-06-05T08:48:00+10:00,2023-06-05,08:48,1,0,1
50,2023-06-05T08:48:00+10:00,2023-06-05,08:48,1,0,1
54,2023-06-05T08:48:00+10:00,2023-06-05,08:48,4,1,5
61,2023-06-05T08:48:00+10:00,2023-06-05,08:48,3,4,7
66,2023-06-05T08:48:00+10:00,2023-06-05,08:48,4,6,10
1,2023-06-05T08:48:00+10:00,2023-06-05,08:48,3,2,5
10,2023-06-05T08:48:00+10:00,2023-06-05,08:48,0,4,4
17,2023-06-05T08:48:00+10:00,2023-06-05,08:48,30,7,37
20,2023-06-05T08:48:00+10:00,2023-06-05,08:48,1,2,3
35,2023-06-05T08:48:00+10:00,2023-06-05,08:48,3,26,29
48,2023-06-05T08:48:00+10:00,2023-06-05,08:48,1,1,2
53,2023-06-05T08:48:00+10:00,2023-06-05,08:48,4,3,7
56,2023-06-05T08:48:00+10:00,2023-06-05,08:48,1,2,3
62,2023-06-05T08:48:00+10:00,2023-06-05,08:48,2,0,2
63,2023-06-05T08:48:00+10:00,2023-06-05,08:48,2,2,4
85,2023-06-05T08:48:00+10:00,2023-06-05,08:48,1,0,1
5,2023-06-05T08:48:00+10:00,2023-06-05,08:48,3,6,9
26,2023-06-05T08:48:00+10:00,2023-06-05,08:48,11,2,13
36,2023-06-05T08:48:00+10:00,2023-06-05,08:48,12,6,18
40,2023-06-05T08:48:00+10:00,2023-06-05,08:48,2,5,7
41,2023-06-05T08:48:00+10:00,2023-06-05,08:48,30,9,39
42,2023-06-05T08:48:00+10:00,2023-06-05,08:48,3,1,4
45,2023-06-05T08:48:00+10:00,2023-06-05,08:48,5,2,7
47,2023-06-05T08:48:00+10:00,2023-06-05,08:48,0,6,6
70,2023-06-05T08:48:00+10:00,2023-06-05,08:48,1,3,4
77,2023-06-05T08:48:00+10:00,2023-06-05,08:48,2,2,4
2,2023-06-05T08:48:00+10:00,2023-06-05,08:48,0,6,6
9,2023-06-05T08:48:00+10:00,2023-06-05,08:48,2,55,57
12,2023-06-05T08:48:00+10:00,2023-06-05,08:48,1,3,4
18,2023-06-05T08:48:00+10:00,2023-06-05,08:48,2,24,26
23,2023-06-05T08:48:00+10:00,2023-06-05,08:48,14,3,17
30,2023-06-05T08:48:00+10:00,2023-06-05,08:48,1,1,2
51,2023-06-05T08:48:00+10:00,2023-06-05,08:48,1,1,2
58,2023-06-05T08:48:00+10:00,2023-06-05,08:48,21,1,22
68,2023-06-05T08:48:00+10:00,2023-06-05,08:48,2,5,7
86,2023-06-05T08:48:00+10:00,2023-06-05,08:48,1,1,2
5,2023-06-05T08:47:00+10:00,2023-06-05,08:47,8,7,15
6,2023-06-05T08:47:00+10:00,2023-06-05,08:47,7,17,24
26,2023-06-05T08:47:00+10:00,2023-06-05,08:47,5,1,6
36,2023-06-05T08:47:00+10:00,2023-06-05,08:47,5,2,7
45,2023-06-05T08:47:00+10:00,2023-06-05,08:47,4,4,8
55,2023-06-05T08:47:00+10:00,2023-06-05,08:47,1,11,12
61,2023-06-05T08:47:00+10:00,2023-06-05,08:47,5,4,9
77,2023-06-05T08:47:00+10:00,2023-06-05,08:47,4,3,7
87,2023-06-05T08:47:00+10:00,2023-06-05,08:47,2,1,3
108,2023-06-05T08:47:00+10:00,2023-06-05,08:47,1,4,5
1,2023-06-05T08:47:00+10:00,2023-06-05,08:47,5,6,11
2,2023-06-05T08:47:00+10:00,2023-06-05,08:47,2,3,5
9,2023-06-05T08:47:00+10:00,2023-06-05,08:47,0,42,42
10,2023-06-05T08:47:00+10:00,2023-06-05,08:47,1,3,4
20,2023-06-05T08:47:00+10:00,2023-06-05,08:47,1,1,2
23,2023-06-05T08:47:00+10:00,2023-06-05,08:47,10,7,17
24,2023-06-05T08:47:00+10:00,2023-06-05,08:47,20,3,23
46,2023-06-05T08:47:00+10:00,2023-06-05,08:47,5,6,11
48,2023-06-05T08:47:00+10:00,2023-06-05,08:47,4,3,7
56,2023-06-05T08:47:00+10:00,2023-06-05,08:47,0,3,3
63,2023-06-05T08:47:00+10:00,2023-06-05,08:47,1,4,5
67,2023-06-05T08:47:00+10:00,2023-06-05,08:47,4,6,10
68,2023-06-05T08:47:00+10:00,2023-06-05,08:47,2,1,3
72,2023-06-05T08:47:00+10:00,2023-06-05,08:47,6,1,7
76,2023-06-05T08:47:00+10:00,2023-06-05,08:47,1,1,2
79,2023-06-05T08:47:00+10:00,2023-06-05,08:47,13,5,18
85,2023-06-05T08:47:00+10:00,2023-06-05,08:47,3,0,3
3,2023-06-05T08:47:00+10:00,2023-06-05,08:47,3,4,7
8,2023-06-05T08:47:00+10:00,2023-06-05,08:47,3,3,6
14,2023-06-05T08:47:00+10:00,2023-06-05,08:47,7,3,10
21,2023-06-05T08:47:00+10:00,2023-06-05,08:47,1,2,3
29,2023-06-05T08:47:00+10:00,2023-06-05,08:47,1,2,3
40,2023-06-05T08:47:00+10:00,2023-06-05,08:47,2,9,11
42,2023-06-05T08:47:00+10:00,2023-06-05,08:47,2,2,4
65,2023-06-05T08:47:00+10:00,2023-06-05,08:47,15,4,19
66,2023-06-05T08:47:00+10:00,2023-06-05,08:47,6,5,11
69,2023-06-05T08:47:00+10:00,2023-06-05,08:47,2,0,2
12,2023-06-05T08:47:00+10:00,2023-06-05,08:47,0,1,1
30,2023-06-05T08:47:00+10:00,2023-06-05,08:47,4,5,9
51,2023-06-05T08:47:00+10:00,2023-06-05,08:47,4,1,5
52,2023-06-05T08:47:00+10:00,2023-06-05,08:47,0,5,5
86,2023-06-05T08:47:00+10:00,2023-06-05,08:47,0,2,2
4,2023-06-05T08:47:00+10:00,2023-06-05,08:47,7,2,9
28,2023-06-05T08:47:00+10:00,2023-06-05,08:47,10,4,14
31,2023-06-05T08:47:00+10:00,2023-06-05,08:47,3,1,4
39,2023-06-05T08:47:00+10:00,2023-06-05,08:47,2,1,3
41,2023-06-05T08:47:00+10:00,2023-06-05,08:47,21,1,22
44,2023-06-05T08:47:00+10:00,2023-06-05,08:47,0,1,1
47,2023-06-05T08:47:00+10:00,2023-06-05,08:47,6,11,17
50,2023-06-05T08:47:00+10:00,2023-06-05,08:47,1,1,2
54,2023-06-05T08:47:00+10:00,2023-06-05,08:47,7,0,7
70,2023-06-05T08:47:00+10:00,2023-06-05,08:47,1,0,1
78,2023-06-05T08:47:00+10:00,2023-06-05,08:47,1,3,4
17,2023-06-05T08:47:00+10:00,2023-06-05,08:47,22,1,23
18,2023-06-05T08:47:00+10:00,2023-06-05,08:47,1,22,23
19,2023-06-05T08:47:00+10:00,2023-06-05,08:47,1,1,2
27,2023-06-05T08:47:00+10:00,2023-06-05,08:47,2,1,3
35,2023-06-05T08:47:00+10:00,2023-06-05,08:47,8,21,29
53,2023-06-05T08:47:00+10:00,2023-06-05,08:47,14,3,17
57,2023-06-05T08:47:00+10:00,2023-06-05,08:47,6,19,25
58,2023-06-05T08:47:00+10:00,2023-06-05,08:47,45,8,53
62,2023-06-05T08:47:00+10:00,2023-06-05,08:47,1,1,2
8,2023-06-05T08:46:00+10:00,2023-06-05,08:46,3,2,5
26,2023-06-05T08:46:00+10:00,2023-06-05,08:46,1,1,2
29,2023-06-05T08:46:00+10:00,2023-06-05,08:46,1,0,1
37,2023-06-05T08:46:00+10:00,2023-06-05,08:46,1,2,3
39,2023-06-05T08:46:00+10:00,2023-06-05,08:46,2,2,4
40,2023-06-05T08:46:00+10:00,2023-06-05,08:46,4,15,19
41,2023-06-05T08:46:00+10:00,2023-06-05,08:46,11,5,16
50,2023-06-05T08:46:00+10:00,2023-06-05,08:46,0,2,2
61,2023-06-05T08:46:00+10:00,2023-06-05,08:46,4,7,11
65,2023-06-05T08:46:00+10:00,2023-06-05,08:46,11,5,16
75,2023-06-05T08:46:00+10:00,2023-06-05,08:46,0,1,1
87,2023-06-05T08:46:00+10:00,2023-06-05,08:46,2,0,2
1,2023-06-05T08:46:00+10:00,2023-06-05,08:46,4,7,11
12,2023-06-05T08:46:00+10:00,2023-06-05,08:46,2,2,4
20,2023-06-05T08:46:00+10:00,2023-06-05,08:46,1,0,1
23,2023-06-05T08:46:00+10:00,2023-06-05,08:46,22,1,23
27,2023-06-05T08:46:00+10:00,2023-06-05,08:46,0,2,2
52,2023-06-05T08:46:00+10:00,2023-06-05,08:46,0,3,3
56,2023-06-05T08:46:00+10:00,2023-06-05,08:46,1,0,1
58,2023-06-05T08:46:00+10:00,2023-06-05,08:46,2,3,5
76,2023-06-05T08:46:00+10:00,2023-06-05,08:46,1,0,1
4,2023-06-05T08:46:00+10:00,2023-06-05,08:46,13,9,22
6,2023-06-05T08:46:00+10:00,2023-06-05,08:46,7,41,48
21,2023-06-05T08:46:00+10:00,2023-06-05,08:46,7,0,7
42,2023-06-05T08:46:00+10:00,2023-06-05,08:46,3,4,7
45,2023-06-05T08:46:00+10:00,2023-06-05,08:46,8,4,12
54,2023-06-05T08:46:00+10:00,2023-06-05,08:46,1,0,1
55,2023-06-05T08:46:00+10:00,2023-06-05,08:46,7,8,15
66,2023-06-05T08:46:00+10:00,2023-06-05,08:46,5,2,7
69,2023-06-05T08:46:00+10:00,2023-06-05,08:46,3,0,3
77,2023-06-05T08:46:00+10:00,2023-06-05,08:46,6,2,8
78,2023-06-05T08:46:00+10:00,2023-06-05,08:46,1,3,4
11,2023-06-05T08:46:00+10:00,2023-06-05,08:46,0,1,1
18,2023-06-05T08:46:00+10:00,2023-06-05,08:46,1,22,23
30,2023-06-05T08:46:00+10:00,2023-06-05,08:46,2,3,5
35,2023-06-05T08:46:00+10:00,2023-06-05,08:46,5,30,35
51,2023-06-05T08:46:00+10:00,2023-06-05,08:46,2,2,4
53,2023-06-05T08:46:00+10:00,2023-06-05,08:46,3,3,6
62,2023-06-05T08:46:00+10:00,2023-06-05,08:46,0,1,1
79,2023-06-05T08:46:00+10:00,2023-06-05,08:46,21,10,31
3,2023-06-05T08:46:00+10:00,2023-06-05,08:46,1,5,6
5,2023-06-05T08:46:00+10:00,2023-06-05,08:46,5,15,20
14,2023-06-05T08:46:00+10:00,2023-06-05,08:46,5,9,14
28,2023-06-05T08:46:00+10:00,2023-06-05,08:46,9,7,16
31,2023-06-05T08:46:00+10:00,2023-06-05,08:46,0,1,1
36,2023-06-05T08:46:00+10:00,2023-06-05,08:46,5,3,8
47,2023-06-05T08:46:00+10:00,2023-06-05,08:46,4,6,10
70,2023-06-05T08:46:00+10:00,2023-06-05,08:46,3,0,3
108,2023-06-05T08:46:00+10:00,2023-06-05,08:46,3,11,14
2,2023-06-05T08:46:00+10:00,2023-06-05,08:46,1,2,3
9,2023-06-05T08:46:00+10:00,2023-06-05,08:46,1,42,43
10,2023-06-05T08:46:00+10:00,2023-06-05,08:46,2,2,4
17,2023-06-05T08:46:00+10:00,2023-06-05,08:46,19,4,23
24,2023-06-05T08:46:00+10:00,2023-06-05,08:46,40,3,43
46,2023-06-05T08:46:00+10:00,2023-06-05,08:46,0,1,1
48,2023-06-05T08:46:00+10:00,2023-06-05,08:46,1,0,1
57,2023-06-05T08:46:00+10:00,2023-06-05,08:46,7,13,20
63,2023-06-05T08:46:00+10:00,2023-06-05,08:46,3,4,7
67,2023-06-05T08:46:00+10:00,2023-06-05,08:46,9,7,16
68,2023-06-05T08:46:00+10:00,2023-06-05,08:46,1,0,1
72,2023-06-05T08:46:00+10:00,2023-06-05,08:46,4,1,5
85,2023-06-05T08:46:00+10:00,2023-06-05,08:46,1,2,3
4,2023-06-05T08:45:00+10:00,2023-06-05,08:45,9,2,11
6,2023-06-05T08:45:00+10:00,2023-06-05,08:45,24,34,58
8,2023-06-05T08:45:00+10:00,2023-06-05,08:45,2,1,3
28,2023-06-05T08:45:00+10:00,2023-06-05,08:45,6,9,15
37,2023-06-05T08:45:00+10:00,2023-06-05,08:45,0,1,1
39,2023-06-05T08:45:00+10:00,2023-06-05,08:45,1,1,2
41,2023-06-05T08:45:00+10:00,2023-06-05,08:45,18,7,25
45,2023-06-05T08:45:00+10:00,2023-06-05,08:45,7,8,15
47,2023-06-05T08:45:00+10:00,2023-06-05,08:45,10,24,34
65,2023-06-05T08:45:00+10:00,2023-06-05,08:45,14,6,20
69,2023-06-05T08:45:00+10:00,2023-06-05,08:45,6,0,6
75,2023-06-05T08:45:00+10:00,2023-06-05,08:45,1,1,2
77,2023-06-05T08:45:00+10:00,2023-06-05,08:45,3,1,4
118,2023-06-05T08:45:00+10:00,2023-06-05,08:45,2,0,2
11,2023-06-05T08:45:00+10:00,2023-06-05,08:45,2,2,4
18,2023-06-05T08:45:00+10:00,2023-06-05,08:45,0,28,28
23,2023-06-05T08:45:00+10:00,2023-06-05,08:45,17,4,21
48,2023-06-05T08:45:00+10:00,2023-06-05,08:45,2,2,4
51,2023-06-05T08:45:00+10:00,2023-06-05,08:45,2,0,2
52,2023-06-05T08:45:00+10:00,2023-06-05,08:45,3,6,9
57,2023-06-05T08:45:00+10:00,2023-06-05,08:45,10,15,25
63,2023-06-05T08:45:00+10:00,2023-06-05,08:45,3,1,4
86,2023-06-05T08:45:00+10:00,2023-06-05,08:45,1,0,1
3,2023-06-05T08:45:00+10:00,2023-06-05,08:45,3,7,10
5,2023-06-05T08:45:00+10:00,2023-06-05,08:45,8,13,21
26,2023-06-05T08:45:00+10:00,2023-06-05,08:45,2,1,3
36,2023-06-05T08:45:00+10:00,2023-06-05,08:45,9,3,12
40,2023-06-05T08:45:00+10:00,2023-06-05,08:45,8,7,15
55,2023-06-05T08:45:00+10:00,2023-06-05,08:45,6,13,19
61,2023-06-05T08:45:00+10:00,2023-06-05,08:45,2,11,13
70,2023-06-05T08:45:00+10:00,2023-06-05,08:45,2,3,5
84,2023-06-05T08:45:00+10:00,2023-06-05,08:45,96,26,122
1,2023-06-05T08:45:00+10:00,2023-06-05,08:45,7,4,11
10,2023-06-05T08:45:00+10:00,2023-06-05,08:45,0,2,2
17,2023-06-05T08:45:00+10:00,2023-06-05,08:45,13,2,15
20,2023-06-05T08:45:00+10:00,2023-06-05,08:45,2,2,4
24,2023-06-05T08:45:00+10:00,2023-06-05,08:45,70,0,70
35,2023-06-05T08:45:00+10:00,2023-06-05,08:45,8,11,19
58,2023-06-05T08:45:00+10:00,2023-06-05,08:45,51,0,51
68,2023-06-05T08:45:00+10:00,2023-06-05,08:45,0,3,3
72,2023-06-05T08:45:00+10:00,2023-06-05,08:45,7,1,8
76,2023-06-05T08:45:00+10:00,2023-06-05,08:45,1,3,4
85,2023-06-05T08:45:00+10:00,2023-06-05,08:45,0,2,2
109,2023-06-05T08:45:00+10:00,2023-06-05,08:45,9,44,53
14,2023-06-05T08:45:00+10:00,2023-06-05,08:45,1,5,6
21,2023-06-05T08:45:00+10:00,2023-06-05,08:45,2,3,5
31,2023-06-05T08:45:00+10:00,2023-06-05,08:45,1,2,3
42,2023-06-05T08:45:00+10:00,2023-06-05,08:45,4,3,7
54,2023-06-05T08:45:00+10:00,2023-06-05,08:45,6,0,6
59,2023-06-05T08:45:00+10:00,2023-06-05,08:45,37,12,49
66,2023-06-05T08:45:00+10:00,2023-06-05,08:45,2,12,14
71,2023-06-05T08:45:00+10:00,2023-06-05,08:45,0,1,1
78,2023-06-05T08:45:00+10:00,2023-06-05,08:45,0,2,2
87,2023-06-05T08:45:00+10:00,2023-06-05,08:45,1,1,2
107,2023-06-05T08:45:00+10:00,2023-06-05,08:45,4,26,30
108,2023-06-05T08:45:00+10:00,2023-06-05,08:45,5,16,21
2,2023-06-05T08:45:00+10:00,2023-06-05,08:45,0,4,4
9,2023-06-05T08:45:00+10:00,2023-06-05,08:45,2,37,39
12,2023-06-05T08:45:00+10:00,2023-06-05,08:45,2,3,5
27,2023-06-05T08:45:00+10:00,2023-06-05,08:45,1,3,4
53,2023-06-05T08:45:00+10:00,2023-06-05,08:45,8,9,17
56,2023-06-05T08:45:00+10:00,2023-06-05,08:45,3,0,3
62,2023-06-05T08:45:00+10:00,2023-06-05,08:45,0,1,1
67,2023-06-05T08:45:00+10:00,2023-06-05,08:45,5,9,14
79,2023-06-05T08:45:00+10:00,2023-06-05,08:45,8,4,12
117,2023-06-05T08:45:00+10:00,2023-06-05,08:45,40,6,46
39,2023-06-05T08:44:00+10:00,2023-06-05,08:44,2,2,4
47,2023-06-05T08:44:00+10:00,2023-06-05,08:44,6,16,22
50,2023-06-05T08:44:00+10:00,2023-06-05,08:44,1,0,1
61,2023-06-05T08:44:00+10:00,2023-06-05,08:44,3,1,4
66,2023-06-05T08:44:00+10:00,2023-06-05,08:44,5,11,16
70,2023-06-05T08:44:00+10:00,2023-06-05,08:44,1,3,4
71,2023-06-05T08:44:00+10:00,2023-06-05,08:44,1,2,3
77,2023-06-05T08:44:00+10:00,2023-06-05,08:44,0,3,3
87,2023-06-05T08:44:00+10:00,2023-06-05,08:44,0,2,2
108,2023-06-05T08:44:00+10:00,2023-06-05,08:44,8,12,20
2,2023-06-05T08:44:00+10:00,2023-06-05,08:44,5,3,8
9,2023-06-05T08:44:00+10:00,2023-06-05,08:44,2,44,46
10,2023-06-05T08:44:00+10:00,2023-06-05,08:44,0,4,4
51,2023-06-05T08:44:00+10:00,2023-06-05,08:44,1,0,1
56,2023-06-05T08:44:00+10:00,2023-06-05,08:44,1,4,5
58,2023-06-05T08:44:00+10:00,2023-06-05,08:44,1,1,2
67,2023-06-05T08:44:00+10:00,2023-06-05,08:44,8,6,14
85,2023-06-05T08:44:00+10:00,2023-06-05,08:44,1,2,3
5,2023-06-05T08:44:00+10:00,2023-06-05,08:44,2,19,21
6,2023-06-05T08:44:00+10:00,2023-06-05,08:44,10,11,21
8,2023-06-05T08:44:00+10:00,2023-06-05,08:44,2,1,3
14,2023-06-05T08:44:00+10:00,2023-06-05,08:44,2,12,14
21,2023-06-05T08:44:00+10:00,2023-06-05,08:44,2,4,6
28,2023-06-05T08:44:00+10:00,2023-06-05,08:44,15,5,20
29,2023-06-05T08:44:00+10:00,2023-06-05,08:44,1,0,1
37,2023-06-05T08:44:00+10:00,2023-06-05,08:44,2,0,2
41,2023-06-05T08:44:00+10:00,2023-06-05,08:44,22,4,26
45,2023-06-05T08:44:00+10:00,2023-06-05,08:44,4,3,7
54,2023-06-05T08:44:00+10:00,2023-06-05,08:44,8,1,9
65,2023-06-05T08:44:00+10:00,2023-06-05,08:44,10,3,13
69,2023-06-05T08:44:00+10:00,2023-06-05,08:44,3,0,3
78,2023-06-05T08:44:00+10:00,2023-06-05,08:44,3,0,3
1,2023-06-05T08:44:00+10:00,2023-06-05,08:44,5,1,6
12,2023-06-05T08:44:00+10:00,2023-06-05,08:44,1,0,1
20,2023-06-05T08:44:00+10:00,2023-06-05,08:44,2,0,2
24,2023-06-05T08:44:00+10:00,2023-06-05,08:44,15,11,26
57,2023-06-05T08:44:00+10:00,2023-06-05,08:44,7,20,27
68,2023-06-05T08:44:00+10:00,2023-06-05,08:44,1,1,2
72,2023-06-05T08:44:00+10:00,2023-06-05,08:44,13,0,13
79,2023-06-05T08:44:00+10:00,2023-06-05,08:44,4,7,11
3,2023-06-05T08:44:00+10:00,2023-06-05,08:44,6,3,9
4,2023-06-05T08:44:00+10:00,2023-06-05,08:44,2,3,5
26,2023-06-05T08:44:00+10:00,2023-06-05,08:44,4,2,6
31,2023-06-05T08:44:00+10:00,2023-06-05,08:44,1,3,4
36,2023-06-05T08:44:00+10:00,2023-06-05,08:44,8,2,10
40,2023-06-05T08:44:00+10:00,2023-06-05,08:44,5,14,19
55,2023-06-05T08:44:00+10:00,2023-06-05,08:44,3,6,9
75,2023-06-05T08:44:00+10:00,2023-06-05,08:44,2,0,2
17,2023-06-05T08:44:00+10:00,2023-06-05,08:44,15,1,16
18,2023-06-05T08:44:00+10:00,2023-06-05,08:44,0,14,14
19,2023-06-05T08:44:00+10:00,2023-06-05,08:44,1,1,2
23,2023-06-05T08:44:00+10:00,2023-06-05,08:44,0,4,4
30,2023-06-05T08:44:00+10:00,2023-06-05,08:44,2,5,7
35,2023-06-05T08:44:00+10:00,2023-06-05,08:44,5,13,18
46,2023-06-05T08:44:00+10:00,2023-06-05,08:44,1,1,2
48,2023-06-05T08:44:00+10:00,2023-06-05,08:44,3,1,4
52,2023-06-05T08:44:00+10:00,2023-06-05,08:44,10,3,13
53,2023-06-05T08:44:00+10:00,2023-06-05,08:44,5,3,8
62,2023-06-05T08:44:00+10:00,2023-06-05,08:44,2,0,2
63,2023-06-05T08:44:00+10:00,2023-06-05,08:44,1,4,5
76,2023-06-05T08:44:00+10:00,2023-06-05,08:44,2,1,3
3,2023-06-05T08:43:00+10:00,2023-06-05,08:43,2,5,7
14,2023-06-05T08:43:00+10:00,2023-06-05,08:43,5,11,16
26,2023-06-05T08:43:00+10:00,2023-06-05,08:43,2,1,3
36,2023-06-05T08:43:00+10:00,2023-06-05,08:43,5,4,9
37,2023-06-05T08:43:00+10:00,2023-06-05,08:43,1,1,2
47,2023-06-05T08:43:00+10:00,2023-06-05,08:43,0,3,3
54,2023-06-05T08:43:00+10:00,2023-06-05,08:43,2,0,2
61,2023-06-05T08:43:00+10:00,2023-06-05,08:43,1,5,6
69,2023-06-05T08:43:00+10:00,2023-06-05,08:43,3,0,3
77,2023-06-05T08:43:00+10:00,2023-06-05,08:43,8,1,9
87,2023-06-05T08:43:00+10:00,2023-06-05,08:43,1,1,2
1,2023-06-05T08:43:00+10:00,2023-06-05,08:43,6,10,16
9,2023-06-05T08:43:00+10:00,2023-06-05,08:43,4,36,40
11,2023-06-05T08:43:00+10:00,2023-06-05,08:43,1,0,1
12,2023-06-05T08:43:00+10:00,2023-06-05,08:43,5,1,6
20,2023-06-05T08:43:00+10:00,2023-06-05,08:43,2,1,3
52,2023-06-05T08:43:00+10:00,2023-06-05,08:43,2,3,5
62,2023-06-05T08:43:00+10:00,2023-06-05,08:43,2,1,3
72,2023-06-05T08:43:00+10:00,2023-06-05,08:43,18,2,20
76,2023-06-05T08:43:00+10:00,2023-06-05,08:43,3,1,4
5,2023-06-05T08:43:00+10:00,2023-06-05,08:43,1,9,10
8,2023-06-05T08:43:00+10:00,2023-06-05,08:43,2,4,6
21,2023-06-05T08:43:00+10:00,2023-06-05,08:43,1,3,4
28,2023-06-05T08:43:00+10:00,2023-06-05,08:43,15,6,21
39,2023-06-05T08:43:00+10:00,2023-06-05,08:43,14,4,18
41,2023-06-05T08:43:00+10:00,2023-06-05,08:43,54,3,57
55,2023-06-05T08:43:00+10:00,2023-06-05,08:43,11,7,18
65,2023-06-05T08:43:00+10:00,2023-06-05,08:43,18,7,25
78,2023-06-05T08:43:00+10:00,2023-06-05,08:43,1,5,6
108,2023-06-05T08:43:00+10:00,2023-06-05,08:43,2,36,38
2,2023-06-05T08:43:00+10:00,2023-06-05,08:43,3,8,11
10,2023-06-05T08:43:00+10:00,2023-06-05,08:43,1,4,5
17,2023-06-05T08:43:00+10:00,2023-06-05,08:43,27,3,30
19,2023-06-05T08:43:00+10:00,2023-06-05,08:43,1,0,1
24,2023-06-05T08:43:00+10:00,2023-06-05,08:43,50,6,56
35,2023-06-05T08:43:00+10:00,2023-06-05,08:43,5,31,36
46,2023-06-05T08:43:00+10:00,2023-06-05,08:43,1,1,2
48,2023-06-05T08:43:00+10:00,2023-06-05,08:43,4,1,5
51,2023-06-05T08:43:00+10:00,2023-06-05,08:43,1,2,3
53,2023-06-05T08:43:00+10:00,2023-06-05,08:43,10,0,10
56,2023-06-05T08:43:00+10:00,2023-06-05,08:43,0,1,1
67,2023-06-05T08:43:00+10:00,2023-06-05,08:43,3,12,15
79,2023-06-05T08:43:00+10:00,2023-06-05,08:43,12,4,16
4,2023-06-05T08:43:00+10:00,2023-06-05,08:43,8,4,12
6,2023-06-05T08:43:00+10:00,2023-06-05,08:43,8,17,25
29,2023-06-05T08:43:00+10:00,2023-06-05,08:43,2,1,3
31,2023-06-05T08:43:00+10:00,2023-06-05,08:43,1,1,2
40,2023-06-05T08:43:00+10:00,2023-06-05,08:43,7,4,11
44,2023-06-05T08:43:00+10:00,2023-06-05,08:43,1,1,2
45,2023-06-05T08:43:00+10:00,2023-06-05,08:43,3,4,7
66,2023-06-05T08:43:00+10:00,2023-06-05,08:43,2,3,5
70,2023-06-05T08:43:00+10:00,2023-06-05,08:43,4,0,4
18,2023-06-05T08:43:00+10:00,2023-06-05,08:43,2,16,18
23,2023-06-05T08:43:00+10:00,2023-06-05,08:43,9,8,17
27,2023-06-05T08:43:00+10:00,2023-06-05,08:43,0,1,1
30,2023-06-05T08:43:00+10:00,2023-06-05,08:43,7,2,9
57,2023-06-05T08:43:00+10:00,2023-06-05,08:43,7,17,24
58,2023-06-05T08:43:00+10:00,2023-06-05,08:43,31,3,34
63,2023-06-05T08:43:00+10:00,2023-06-05,08:43,6,7,13
68,2023-06-05T08:43:00+10:00,2023-06-05,08:43,1,1,2
85,2023-06-05T08:43:00+10:00,2023-06-05,08:43,0,1,1
4,2023-06-05T08:42:00+10:00,2023-06-05,08:42,12,2,14
5,2023-06-05T08:42:00+10:00,2023-06-05,08:42,5,7,12
8,2023-06-05T08:42:00+10:00,2023-06-05,08:42,4,3,7
28,2023-06-05T08:42:00+10:00,2023-06-05,08:42,13,4,17
29,2023-06-05T08:42:00+10:00,2023-06-05,08:42,2,2,4
31,2023-06-05T08:42:00+10:00,2023-06-05,08:42,0,1,1
36,2023-06-05T08:42:00+10:00,2023-06-05,08:42,6,3,9
37,2023-06-05T08:42:00+10:00,2023-06-05,08:42,2,4,6
40,2023-06-05T08:42:00+10:00,2023-06-05,08:42,3,14,17
42,2023-06-05T08:42:00+10:00,2023-06-05,08:42,3,0,3
47,2023-06-05T08:42:00+10:00,2023-06-05,08:42,5,4,9
61,2023-06-05T08:42:00+10:00,2023-06-05,08:42,3,1,4
87,2023-06-05T08:42:00+10:00,2023-06-05,08:42,3,4,7
1,2023-06-05T08:42:00+10:00,2023-06-05,08:42,3,2,5
10,2023-06-05T08:42:00+10:00,2023-06-05,08:42,2,4,6
20,2023-06-05T08:42:00+10:00,2023-06-05,08:42,0,1,1
23,2023-06-05T08:42:00+10:00,2023-06-05,08:42,10,0,10
24,2023-06-05T08:42:00+10:00,2023-06-05,08:42,12,14,26
56,2023-06-05T08:42:00+10:00,2023-06-05,08:42,0,2,2
58,2023-06-05T08:42:00+10:00,2023-06-05,08:42,19,0,19
63,2023-06-05T08:42:00+10:00,2023-06-05,08:42,4,1,5
3,2023-06-05T08:42:00+10:00,2023-06-05,08:42,7,6,13
6,2023-06-05T08:42:00+10:00,2023-06-05,08:42,8,11,19
14,2023-06-05T08:42:00+10:00,2023-06-05,08:42,4,0,4
55,2023-06-05T08:42:00+10:00,2023-06-05,08:42,14,5,19
66,2023-06-05T08:42:00+10:00,2023-06-05,08:42,9,14,23
69,2023-06-05T08:42:00+10:00,2023-06-05,08:42,4,1,5
77,2023-06-05T08:42:00+10:00,2023-06-05,08:42,1,1,2
2,2023-06-05T08:42:00+10:00,2023-06-05,08:42,4,5,9
12,2023-06-05T08:42:00+10:00,2023-06-05,08:42,2,1,3
18,2023-06-05T08:42:00+10:00,2023-06-05,08:42,2,33,35
27,2023-06-05T08:42:00+10:00,2023-06-05,08:42,1,1,2
52,2023-06-05T08:42:00+10:00,2023-06-05,08:42,1,3,4
57,2023-06-05T08:42:00+10:00,2023-06-05,08:42,8,14,22
62,2023-06-05T08:42:00+10:00,2023-06-05,08:42,2,0,2
67,2023-06-05T08:42:00+10:00,2023-06-05,08:42,7,5,12
72,2023-06-05T08:42:00+10:00,2023-06-05,08:42,30,3,33
85,2023-06-05T08:42:00+10:00,2023-06-05,08:42,0,2,2
21,2023-06-05T08:42:00+10:00,2023-06-05,08:42,2,6,8
26,2023-06-05T08:42:00+10:00,2023-06-05,08:42,1,1,2
39,2023-06-05T08:42:00+10:00,2023-06-05,08:42,5,0,5
41,2023-06-05T08:42:00+10:00,2023-06-05,08:42,25,2,27
45,2023-06-05T08:42:00+10:00,2023-06-05,08:42,9,7,16
50,2023-06-05T08:42:00+10:00,2023-06-05,08:42,0,1,1
54,2023-06-05T08:42:00+10:00,2023-06-05,08:42,3,1,4
65,2023-06-05T08:42:00+10:00,2023-06-05,08:42,17,2,19
108,2023-06-05T08:42:00+10:00,2023-06-05,08:42,0,29,29
9,2023-06-05T08:42:00+10:00,2023-06-05,08:42,4,21,25
11,2023-06-05T08:42:00+10:00,2023-06-05,08:42,2,0,2
17,2023-06-05T08:42:00+10:00,2023-06-05,08:42,30,0,30
30,2023-06-05T08:42:00+10:00,2023-06-05,08:42,5,1,6
35,2023-06-05T08:42:00+10:00,2023-06-05,08:42,8,31,39
48,2023-06-05T08:42:00+10:00,2023-06-05,08:42,3,1,4
53,2023-06-05T08:42:00+10:00,2023-06-05,08:42,5,2,7
68,2023-06-05T08:42:00+10:00,2023-06-05,08:42,4,4,8
76,2023-06-05T08:42:00+10:00,2023-06-05,08:42,8,2,10
79,2023-06-05T08:42:00+10:00,2023-06-05,08:42,21,10,31
29,2023-06-05T08:41:00+10:00,2023-06-05,08:41,5,1,6
36,2023-06-05T08:41:00+10:00,2023-06-05,08:41,7,5,12
39,2023-06-05T08:41:00+10:00,2023-06-05,08:41,2,5,7
44,2023-06-05T08:41:00+10:00,2023-06-05,08:41,1,0,1
45,2023-06-05T08:41:00+10:00,2023-06-05,08:41,8,4,12
50,2023-06-05T08:41:00+10:00,2023-06-05,08:41,3,0,3
55,2023-06-05T08:41:00+10:00,2023-06-05,08:41,0,6,6
61,2023-06-05T08:41:00+10:00,2023-06-05,08:41,2,6,8
75,2023-06-05T08:41:00+10:00,2023-06-05,08:41,1,0,1
87,2023-06-05T08:41:00+10:00,2023-06-05,08:41,3,3,6
108,2023-06-05T08:41:00+10:00,2023-06-05,08:41,6,36,42
2,2023-06-05T08:41:00+10:00,2023-06-05,08:41,2,7,9
9,2023-06-05T08:41:00+10:00,2023-06-05,08:41,1,24,25
11,2023-06-05T08:41:00+10:00,2023-06-05,08:41,0,3,3
18,2023-06-05T08:41:00+10:00,2023-06-05,08:41,0,27,27
23,2023-06-05T08:41:00+10:00,2023-06-05,08:41,3,8,11
27,2023-06-05T08:41:00+10:00,2023-06-05,08:41,2,1,3
48,2023-06-05T08:41:00+10:00,2023-06-05,08:41,1,0,1
53,2023-06-05T08:41:00+10:00,2023-06-05,08:41,8,7,15
56,2023-06-05T08:41:00+10:00,2023-06-05,08:41,2,3,5
57,2023-06-05T08:41:00+10:00,2023-06-05,08:41,2,0,2
76,2023-06-05T08:41:00+10:00,2023-06-05,08:41,1,4,5
79,2023-06-05T08:41:00+10:00,2023-06-05,08:41,7,8,15
3,2023-06-05T08:41:00+10:00,2023-06-05,08:41,1,4,5
4,2023-06-05T08:41:00+10:00,2023-06-05,08:41,16,5,21
5,2023-06-05T08:41:00+10:00,2023-06-05,08:41,7,18,25
26,2023-06-05T08:41:00+10:00,2023-06-05,08:41,3,2,5
31,2023-06-05T08:41:00+10:00,2023-06-05,08:41,2,1,3
40,2023-06-05T08:41:00+10:00,2023-06-05,08:41,4,10,14
41,2023-06-05T08:41:00+10:00,2023-06-05,08:41,51,1,52
42,2023-06-05T08:41:00+10:00,2023-06-05,08:41,2,1,3
65,2023-06-05T08:41:00+10:00,2023-06-05,08:41,26,1,27
66,2023-06-05T08:41:00+10:00,2023-06-05,08:41,1,12,13
69,2023-06-05T08:41:00+10:00,2023-06-05,08:41,1,1,2
1,2023-06-05T08:41:00+10:00,2023-06-05,08:41,7,2,9
10,2023-06-05T08:41:00+10:00,2023-06-05,08:41,1,5,6
12,2023-06-05T08:41:00+10:00,2023-06-05,08:41,2,3,5
17,2023-06-05T08:41:00+10:00,2023-06-05,08:41,7,1,8
24,2023-06-05T08:41:00+10:00,2023-06-05,08:41,35,8,43
46,2023-06-05T08:41:00+10:00,2023-06-05,08:41,1,0,1
49,2023-06-05T08:41:00+10:00,2023-06-05,08:41,0,1,1
51,2023-06-05T08:41:00+10:00,2023-06-05,08:41,2,0,2
62,2023-06-05T08:41:00+10:00,2023-06-05,08:41,2,0,2
67,2023-06-05T08:41:00+10:00,2023-06-05,08:41,7,6,13
68,2023-06-05T08:41:00+10:00,2023-06-05,08:41,7,3,10
72,2023-06-05T08:41:00+10:00,2023-06-05,08:41,5,0,5
85,2023-06-05T08:41:00+10:00,2023-06-05,08:41,10,6,16
86,2023-06-05T08:41:00+10:00,2023-06-05,08:41,1,0,1
6,2023-06-05T08:41:00+10:00,2023-06-05,08:41,4,26,30
8,2023-06-05T08:41:00+10:00,2023-06-05,08:41,5,2,7
14,2023-06-05T08:41:00+10:00,2023-06-05,08:41,5,12,17
21,2023-06-05T08:41:00+10:00,2023-06-05,08:41,2,3,5
28,2023-06-05T08:41:00+10:00,2023-06-05,08:41,4,11,15
37,2023-06-05T08:41:00+10:00,2023-06-05,08:41,1,2,3
47,2023-06-05T08:41:00+10:00,2023-06-05,08:41,1,14,15
54,2023-06-05T08:41:00+10:00,2023-06-05,08:41,2,0,2
77,2023-06-05T08:41:00+10:00,2023-06-05,08:41,3,1,4
19,2023-06-05T08:41:00+10:00,2023-06-05,08:41,0,1,1
30,2023-06-05T08:41:00+10:00,2023-06-05,08:41,3,5,8
35,2023-06-05T08:41:00+10:00,2023-06-05,08:41,8,25,33
52,2023-06-05T08:41:00+10:00,2023-06-05,08:41,3,2,5
58,2023-06-05T08:41:00+10:00,2023-06-05,08:41,5,2,7
63,2023-06-05T08:41:00+10:00,2023-06-05,08:41,2,5,7
5,2023-06-05T08:40:00+10:00,2023-06-05,08:40,13,15,28
6,2023-06-05T08:40:00+10:00,2023-06-05,08:40,19,33,52
8,2023-06-05T08:40:00+10:00,2023-06-05,08:40,6,2,8
31,2023-06-05T08:40:00+10:00,2023-06-05,08:40,0,1,1
36,2023-06-05T08:40:00+10:00,2023-06-05,08:40,4,4,8
42,2023-06-05T08:40:00+10:00,2023-06-05,08:40,7,1,8
50,2023-06-05T08:40:00+10:00,2023-06-05,08:40,0,3,3
71,2023-06-05T08:40:00+10:00,2023-06-05,08:40,2,1,3
75,2023-06-05T08:40:00+10:00,2023-06-05,08:40,1,0,1
77,2023-06-05T08:40:00+10:00,2023-06-05,08:40,2,2,4
84,2023-06-05T08:40:00+10:00,2023-06-05,08:40,123,29,152
118,2023-06-05T08:40:00+10:00,2023-06-05,08:40,1,1,2
18,2023-06-05T08:40:00+10:00,2023-06-05,08:40,1,19,20
19,2023-06-05T08:40:00+10:00,2023-06-05,08:40,1,0,1
24,2023-06-05T08:40:00+10:00,2023-06-05,08:40,31,1,32
27,2023-06-05T08:40:00+10:00,2023-06-05,08:40,0,3,3
30,2023-06-05T08:40:00+10:00,2023-06-05,08:40,3,2,5
35,2023-06-05T08:40:00+10:00,2023-06-05,08:40,6,7,13
48,2023-06-05T08:40:00+10:00,2023-06-05,08:40,1,7,8
56,2023-06-05T08:40:00+10:00,2023-06-05,08:40,0,1,1
79,2023-06-05T08:40:00+10:00,2023-06-05,08:40,12,2,14
85,2023-06-05T08:40:00+10:00,2023-06-05,08:40,0,3,3
3,2023-06-05T08:40:00+10:00,2023-06-05,08:40,2,4,6
14,2023-06-05T08:40:00+10:00,2023-06-05,08:40,5,5,10
21,2023-06-05T08:40:00+10:00,2023-06-05,08:40,1,3,4
29,2023-06-05T08:40:00+10:00,2023-06-05,08:40,2,3,5
37,2023-06-05T08:40:00+10:00,2023-06-05,08:40,0,2,2
40,2023-06-05T08:40:00+10:00,2023-06-05,08:40,4,15,19
41,2023-06-05T08:40:00+10:00,2023-06-05,08:40,14,3,17
55,2023-06-05T08:40:00+10:00,2023-06-05,08:40,11,11,22
61,2023-06-05T08:40:00+10:00,2023-06-05,08:40,1,3,4
65,2023-06-05T08:40:00+10:00,2023-06-05,08:40,10,1,11
66,2023-06-05T08:40:00+10:00,2023-06-05,08:40,0,1,1
70,2023-06-05T08:40:00+10:00,2023-06-05,08:40,0,2,2
78,2023-06-05T08:40:00+10:00,2023-06-05,08:40,0,1,1
87,2023-06-05T08:40:00+10:00,2023-06-05,08:40,1,1,2
107,2023-06-05T08:40:00+10:00,2023-06-05,08:40,5,25,30
108,2023-06-05T08:40:00+10:00,2023-06-05,08:40,0,41,41
2,2023-06-05T08:40:00+10:00,2023-06-05,08:40,2,7,9
9,2023-06-05T08:40:00+10:00,2023-06-05,08:40,0,35,35
10,2023-06-05T08:40:00+10:00,2023-06-05,08:40,0,3,3
51,2023-06-05T08:40:00+10:00,2023-06-05,08:40,1,1,2
62,2023-06-05T08:40:00+10:00,2023-06-05,08:40,0,1,1
63,2023-06-05T08:40:00+10:00,2023-06-05,08:40,3,4,7
72,2023-06-05T08:40:00+10:00,2023-06-05,08:40,5,1,6
76,2023-06-05T08:40:00+10:00,2023-06-05,08:40,3,0,3
86,2023-06-05T08:40:00+10:00,2023-06-05,08:40,0,1,1
117,2023-06-05T08:40:00+10:00,2023-06-05,08:40,30,13,43
4,2023-06-05T08:40:00+10:00,2023-06-05,08:40,9,7,16
26,2023-06-05T08:40:00+10:00,2023-06-05,08:40,3,0,3
28,2023-06-05T08:40:00+10:00,2023-06-05,08:40,9,5,14
39,2023-06-05T08:40:00+10:00,2023-06-05,08:40,1,2,3
44,2023-06-05T08:40:00+10:00,2023-06-05,08:40,0,1,1
45,2023-06-05T08:40:00+10:00,2023-06-05,08:40,6,6,12
47,2023-06-05T08:40:00+10:00,2023-06-05,08:40,6,14,20
54,2023-06-05T08:40:00+10:00,2023-06-05,08:40,3,1,4
59,2023-06-05T08:40:00+10:00,2023-06-05,08:40,37,18,55
69,2023-06-05T08:40:00+10:00,2023-06-05,08:40,1,4,5
1,2023-06-05T08:40:00+10:00,2023-06-05,08:40,4,7,11
11,2023-06-05T08:40:00+10:00,2023-06-05,08:40,1,2,3
12,2023-06-05T08:40:00+10:00,2023-06-05,08:40,0,2,2
17,2023-06-05T08:40:00+10:00,2023-06-05,08:40,18,2,20
20,2023-06-05T08:40:00+10:00,2023-06-05,08:40,0,2,2
23,2023-06-05T08:40:00+10:00,2023-06-05,08:40,9,4,13
46,2023-06-05T08:40:00+10:00,2023-06-05,08:40,1,0,1
52,2023-06-05T08:40:00+10:00,2023-06-05,08:40,0,3,3
53,2023-06-05T08:40:00+10:00,2023-06-05,08:40,11,3,14
57,2023-06-05T08:40:00+10:00,2023-06-05,08:40,10,13,23
58,2023-06-05T08:40:00+10:00,2023-06-05,08:40,18,1,19
67,2023-06-05T08:40:00+10:00,2023-06-05,08:40,2,7,9
68,2023-06-05T08:40:00+10:00,2023-06-05,08:40,4,2,6
109,2023-06-05T08:40:00+10:00,2023-06-05,08:40,8,49,57
3,2023-06-05T08:39:00+10:00,2023-06-05,08:39,3,3,6
6,2023-06-05T08:39:00+10:00,2023-06-05,08:39,11,19,30
14,2023-06-05T08:39:00+10:00,2023-06-05,08:39,4,8,12
21,2023-06-05T08:39:00+10:00,2023-06-05,08:39,2,3,5
29,2023-06-05T08:39:00+10:00,2023-06-05,08:39,3,1,4
54,2023-06-05T08:39:00+10:00,2023-06-05,08:39,3,1,4
71,2023-06-05T08:39:00+10:00,2023-06-05,08:39,0,1,1
87,2023-06-05T08:39:00+10:00,2023-06-05,08:39,2,1,3
10,2023-06-05T08:39:00+10:00,2023-06-05,08:39,0,6,6
20,2023-06-05T08:39:00+10:00,2023-06-05,08:39,1,1,2
24,2023-06-05T08:39:00+10:00,2023-06-05,08:39,9,11,20
27,2023-06-05T08:39:00+10:00,2023-06-05,08:39,1,2,3
30,2023-06-05T08:39:00+10:00,2023-06-05,08:39,2,3,5
52,2023-06-05T08:39:00+10:00,2023-06-05,08:39,1,2,3
53,2023-06-05T08:39:00+10:00,2023-06-05,08:39,14,9,23
57,2023-06-05T08:39:00+10:00,2023-06-05,08:39,4,8,12
5,2023-06-05T08:39:00+10:00,2023-06-05,08:39,4,8,12
26,2023-06-05T08:39:00+10:00,2023-06-05,08:39,0,1,1
31,2023-06-05T08:39:00+10:00,2023-06-05,08:39,5,3,8
36,2023-06-05T08:39:00+10:00,2023-06-05,08:39,2,5,7
39,2023-06-05T08:39:00+10:00,2023-06-05,08:39,5,4,9
41,2023-06-05T08:39:00+10:00,2023-06-05,08:39,18,9,27
45,2023-06-05T08:39:00+10:00,2023-06-05,08:39,3,9,12
66,2023-06-05T08:39:00+10:00,2023-06-05,08:39,1,8,9
70,2023-06-05T08:39:00+10:00,2023-06-05,08:39,0,1,1
75,2023-06-05T08:39:00+10:00,2023-06-05,08:39,0,1,1
77,2023-06-05T08:39:00+10:00,2023-06-05,08:39,7,1,8
2,2023-06-05T08:39:00+10:00,2023-06-05,08:39,2,4,6
12,2023-06-05T08:39:00+10:00,2023-06-05,08:39,2,5,7
17,2023-06-05T08:39:00+10:00,2023-06-05,08:39,26,8,34
18,2023-06-05T08:39:00+10:00,2023-06-05,08:39,0,24,24
35,2023-06-05T08:39:00+10:00,2023-06-05,08:39,2,12,14
49,2023-06-05T08:39:00+10:00,2023-06-05,08:39,1,1,2
51,2023-06-05T08:39:00+10:00,2023-06-05,08:39,0,1,1
56,2023-06-05T08:39:00+10:00,2023-06-05,08:39,3,1,4
58,2023-06-05T08:39:00+10:00,2023-06-05,08:39,5,11,16
68,2023-06-05T08:39:00+10:00,2023-06-05,08:39,6,1,7
72,2023-06-05T08:39:00+10:00,2023-06-05,08:39,14,0,14
4,2023-06-05T08:39:00+10:00,2023-06-05,08:39,10,6,16
8,2023-06-05T08:39:00+10:00,2023-06-05,08:39,4,3,7
28,2023-06-05T08:39:00+10:00,2023-06-05,08:39,12,0,12
40,2023-06-05T08:39:00+10:00,2023-06-05,08:39,4,12,16
42,2023-06-05T08:39:00+10:00,2023-06-05,08:39,3,1,4
44,2023-06-05T08:39:00+10:00,2023-06-05,08:39,0,1,1
47,2023-06-05T08:39:00+10:00,2023-06-05,08:39,4,1,5
55,2023-06-05T08:39:00+10:00,2023-06-05,08:39,9,11,20
61,2023-06-05T08:39:00+10:00,2023-06-05,08:39,5,8,13
65,2023-06-05T08:39:00+10:00,2023-06-05,08:39,8,7,15
69,2023-06-05T08:39:00+10:00,2023-06-05,08:39,7,2,9
78,2023-06-05T08:39:00+10:00,2023-06-05,08:39,1,1,2
108,2023-06-05T08:39:00+10:00,2023-06-05,08:39,0,20,20
1,2023-06-05T08:39:00+10:00,2023-06-05,08:39,3,6,9
9,2023-06-05T08:39:00+10:00,2023-06-05,08:39,2,18,20
19,2023-06-05T08:39:00+10:00,2023-06-05,08:39,5,0,5
23,2023-06-05T08:39:00+10:00,2023-06-05,08:39,7,5,12
46,2023-06-05T08:39:00+10:00,2023-06-05,08:39,3,1,4
48,2023-06-05T08:39:00+10:00,2023-06-05,08:39,0,1,1
62,2023-06-05T08:39:00+10:00,2023-06-05,08:39,0,2,2
63,2023-06-05T08:39:00+10:00,2023-06-05,08:39,2,0,2
67,2023-06-05T08:39:00+10:00,2023-06-05,08:39,6,9,15
76,2023-06-05T08:39:00+10:00,2023-06-05,08:39,3,0,3
79,2023-06-05T08:39:00+10:00,2023-06-05,08:39,15,9,24
86,2023-06-05T08:39:00+10:00,2023-06-05,08:39,0,1,1
3,2023-06-05T08:38:00+10:00,2023-06-05,08:38,2,4,6
5,2023-06-05T08:38:00+10:00,2023-06-05,08:38,2,7,9
14,2023-06-05T08:38:00+10:00,2023-06-05,08:38,4,7,11
29,2023-06-05T08:38:00+10:00,2023-06-05,08:38,3,2,5
36,2023-06-05T08:38:00+10:00,2023-06-05,08:38,7,2,9
41,2023-06-05T08:38:00+10:00,2023-06-05,08:38,45,6,51
44,2023-06-05T08:38:00+10:00,2023-06-05,08:38,0,1,1
54,2023-06-05T08:38:00+10:00,2023-06-05,08:38,3,0,3
65,2023-06-05T08:38:00+10:00,2023-06-05,08:38,8,2,10
66,2023-06-05T08:38:00+10:00,2023-06-05,08:38,0,8,8
78,2023-06-05T08:38:00+10:00,2023-06-05,08:38,0,2,2
9,2023-06-05T08:38:00+10:00,2023-06-05,08:38,2,35,37
10,2023-06-05T08:38:00+10:00,2023-06-05,08:38,0,4,4
23,2023-06-05T08:38:00+10:00,2023-06-05,08:38,20,6,26
30,2023-06-05T08:38:00+10:00,2023-06-05,08:38,0,2,2
35,2023-06-05T08:38:00+10:00,2023-06-05,08:38,10,31,41
48,2023-06-05T08:38:00+10:00,2023-06-05,08:38,2,0,2
56,2023-06-05T08:38:00+10:00,2023-06-05,08:38,2,2,4
57,2023-06-05T08:38:00+10:00,2023-06-05,08:38,4,10,14
58,2023-06-05T08:38:00+10:00,2023-06-05,08:38,44,0,44
62,2023-06-05T08:38:00+10:00,2023-06-05,08:38,4,0,4
63,2023-06-05T08:38:00+10:00,2023-06-05,08:38,1,0,1
76,2023-06-05T08:38:00+10:00,2023-06-05,08:38,2,1,3
79,2023-06-05T08:38:00+10:00,2023-06-05,08:38,5,10,15
86,2023-06-05T08:38:00+10:00,2023-06-05,08:38,2,1,3
6,2023-06-05T08:38:00+10:00,2023-06-05,08:38,11,9,20
8,2023-06-05T08:38:00+10:00,2023-06-05,08:38,3,1,4
21,2023-06-05T08:38:00+10:00,2023-06-05,08:38,2,2,4
26,2023-06-05T08:38:00+10:00,2023-06-05,08:38,2,2,4
28,2023-06-05T08:38:00+10:00,2023-06-05,08:38,5,5,10
39,2023-06-05T08:38:00+10:00,2023-06-05,08:38,6,2,8
42,2023-06-05T08:38:00+10:00,2023-06-05,08:38,3,0,3
45,2023-06-05T08:38:00+10:00,2023-06-05,08:38,4,0,4
47,2023-06-05T08:38:00+10:00,2023-06-05,08:38,2,13,15
61,2023-06-05T08:38:00+10:00,2023-06-05,08:38,3,5,8
70,2023-06-05T08:38:00+10:00,2023-06-05,08:38,2,2,4
75,2023-06-05T08:38:00+10:00,2023-06-05,08:38,0,1,1
77,2023-06-05T08:38:00+10:00,2023-06-05,08:38,4,0,4
87,2023-06-05T08:38:00+10:00,2023-06-05,08:38,1,0,1
108,2023-06-05T08:38:00+10:00,2023-06-05,08:38,1,11,12
17,2023-06-05T08:38:00+10:00,2023-06-05,08:38,10,1,11
18,2023-06-05T08:38:00+10:00,2023-06-05,08:38,0,30,30
19,2023-06-05T08:38:00+10:00,2023-06-05,08:38,1,1,2
27,2023-06-05T08:38:00+10:00,2023-06-05,08:38,0,2,2
46,2023-06-05T08:38:00+10:00,2023-06-05,08:38,1,3,4
51,2023-06-05T08:38:00+10:00,2023-06-05,08:38,0,3,3
53,2023-06-05T08:38:00+10:00,2023-06-05,08:38,3,4,7
67,2023-06-05T08:38:00+10:00,2023-06-05,08:38,9,5,14
72,2023-06-05T08:38:00+10:00,2023-06-05,08:38,12,0,12
4,2023-06-05T08:38:00+10:00,2023-06-05,08:38,9,0,9
31,2023-06-05T08:38:00+10:00,2023-06-05,08:38,1,0,1
37,2023-06-05T08:38:00+10:00,2023-06-05,08:38,1,0,1
40,2023-06-05T08:38:00+10:00,2023-06-05,08:38,2,4,6
50,2023-06-05T08:38:00+10:00,2023-06-05,08:38,0,1,1
55,2023-06-05T08:38:00+10:00,2023-06-05,08:38,1,4,5
69,2023-06-05T08:38:00+10:00,2023-06-05,08:38,3,1,4
1,2023-06-05T08:38:00+10:00,2023-06-05,08:38,6,5,11
2,2023-06-05T08:38:00+10:00,2023-06-05,08:38,2,4,6
12,2023-06-05T08:38:00+10:00,2023-06-05,08:38,1,0,1
24,2023-06-05T08:38:00+10:00,2023-06-05,08:38,60,5,65
52,2023-06-05T08:38:00+10:00,2023-06-05,08:38,1,8,9
68,2023-06-05T08:38:00+10:00,2023-06-05,08:38,1,2,3
85,2023-06-05T08:38:00+10:00,2023-06-05,08:38,2,1,3
3,2023-06-05T08:37:00+10:00,2023-06-05,08:37,6,5,11
4,2023-06-05T08:37:00+10:00,2023-06-05,08:37,11,5,16
14,2023-06-05T08:37:00+10:00,2023-06-05,08:37,6,10,16
21,2023-06-05T08:37:00+10:00,2023-06-05,08:37,2,4,6
26,2023-06-05T08:37:00+10:00,2023-06-05,08:37,2,0,2
29,2023-06-05T08:37:00+10:00,2023-06-05,08:37,1,1,2
39,2023-06-05T08:37:00+10:00,2023-06-05,08:37,8,2,10
47,2023-06-05T08:37:00+10:00,2023-06-05,08:37,9,15,24
50,2023-06-05T08:37:00+10:00,2023-06-05,08:37,0,3,3
61,2023-06-05T08:37:00+10:00,2023-06-05,08:37,3,9,12
65,2023-06-05T08:37:00+10:00,2023-06-05,08:37,18,5,23
69,2023-06-05T08:37:00+10:00,2023-06-05,08:37,4,0,4
75,2023-06-05T08:37:00+10:00,2023-06-05,08:37,2,0,2
87,2023-06-05T08:37:00+10:00,2023-06-05,08:37,3,1,4
10,2023-06-05T08:37:00+10:00,2023-06-05,08:37,0,5,5
11,2023-06-05T08:37:00+10:00,2023-06-05,08:37,0,2,2
23,2023-06-05T08:37:00+10:00,2023-06-05,08:37,9,3,12
24,2023-06-05T08:37:00+10:00,2023-06-05,08:37,22,12,34
27,2023-06-05T08:37:00+10:00,2023-06-05,08:37,2,0,2
30,2023-06-05T08:37:00+10:00,2023-06-05,08:37,4,2,6
46,2023-06-05T08:37:00+10:00,2023-06-05,08:37,1,1,2
56,2023-06-05T08:37:00+10:00,2023-06-05,08:37,1,3,4
63,2023-06-05T08:37:00+10:00,2023-06-05,08:37,2,6,8
76,2023-06-05T08:37:00+10:00,2023-06-05,08:37,1,0,1
6,2023-06-05T08:37:00+10:00,2023-06-05,08:37,5,11,16
8,2023-06-05T08:37:00+10:00,2023-06-05,08:37,2,2,4
31,2023-06-05T08:37:00+10:00,2023-06-05,08:37,0,1,1
40,2023-06-05T08:37:00+10:00,2023-06-05,08:37,0,9,9
41,2023-06-05T08:37:00+10:00,2023-06-05,08:37,57,14,71
66,2023-06-05T08:37:00+10:00,2023-06-05,08:37,4,3,7
71,2023-06-05T08:37:00+10:00,2023-06-05,08:37,0,1,1
77,2023-06-05T08:37:00+10:00,2023-06-05,08:37,3,0,3
108,2023-06-05T08:37:00+10:00,2023-06-05,08:37,3,10,13
1,2023-06-05T08:37:00+10:00,2023-06-05,08:37,3,1,4
9,2023-06-05T08:37:00+10:00,2023-06-05,08:37,2,54,56
19,2023-06-05T08:37:00+10:00,2023-06-05,08:37,1,1,2
20,2023-06-05T08:37:00+10:00,2023-06-05,08:37,1,0,1
35,2023-06-05T08:37:00+10:00,2023-06-05,08:37,9,36,45
48,2023-06-05T08:37:00+10:00,2023-06-05,08:37,4,0,4
52,2023-06-05T08:37:00+10:00,2023-06-05,08:37,5,4,9
53,2023-06-05T08:37:00+10:00,2023-06-05,08:37,12,6,18
67,2023-06-05T08:37:00+10:00,2023-06-05,08:37,6,3,9
79,2023-06-05T08:37:00+10:00,2023-06-05,08:37,2,14,16
85,2023-06-05T08:37:00+10:00,2023-06-05,08:37,1,3,4
86,2023-06-05T08:37:00+10:00,2023-06-05,08:37,1,0,1
5,2023-06-05T08:37:00+10:00,2023-06-05,08:37,2,8,10
28,2023-06-05T08:37:00+10:00,2023-06-05,08:37,5,6,11
36,2023-06-05T08:37:00+10:00,2023-06-05,08:37,2,3,5
37,2023-06-05T08:37:00+10:00,2023-06-05,08:37,1,0,1
42,2023-06-05T08:37:00+10:00,2023-06-05,08:37,0,2,2
45,2023-06-05T08:37:00+10:00,2023-06-05,08:37,4,4,8
54,2023-06-05T08:37:00+10:00,2023-06-05,08:37,1,2,3
55,2023-06-05T08:37:00+10:00,2023-06-05,08:37,5,6,11
78,2023-06-05T08:37:00+10:00,2023-06-05,08:37,1,3,4
2,2023-06-05T08:37:00+10:00,2023-06-05,08:37,1,2,3
12,2023-06-05T08:37:00+10:00,2023-06-05,08:37,2,4,6
17,2023-06-05T08:37:00+10:00,2023-06-05,08:37,34,2,36
18,2023-06-05T08:37:00+10:00,2023-06-05,08:37,1,22,23
49,2023-06-05T08:37:00+10:00,2023-06-05,08:37,2,3,5
57,2023-06-05T08:37:00+10:00,2023-06-05,08:37,4,5,9
58,2023-06-05T08:37:00+10:00,2023-06-05,08:37,25,2,27
68,2023-06-05T08:37:00+10:00,2023-06-05,08:37,0,2,2
72,2023-06-05T08:37:00+10:00,2023-06-05,08:37,15,0,15
3,2023-06-05T08:36:00+10:00,2023-06-05,08:36,3,7,10
5,2023-06-05T08:36:00+10:00,2023-06-05,08:36,8,13,21
14,2023-06-05T08:36:00+10:00,2023-06-05,08:36,4,7,11
36,2023-06-05T08:36:00+10:00,2023-06-05,08:36,5,0,5
37,2023-06-05T08:36:00+10:00,2023-06-05,08:36,0,2,2
47,2023-06-05T08:36:00+10:00,2023-06-05,08:36,1,4,5
55,2023-06-05T08:36:00+10:00,2023-06-05,08:36,7,12,19
70,2023-06-05T08:36:00+10:00,2023-06-05,08:36,2,5,7
75,2023-06-05T08:36:00+10:00,2023-06-05,08:36,1,1,2
2,2023-06-05T08:36:00+10:00,2023-06-05,08:36,0,5,5
9,2023-06-05T08:36:00+10:00,2023-06-05,08:36,1,28,29
17,2023-06-05T08:36:00+10:00,2023-06-05,08:36,17,1,18
23,2023-06-05T08:36:00+10:00,2023-06-05,08:36,2,4,6
46,2023-06-05T08:36:00+10:00,2023-06-05,08:36,1,2,3
52,2023-06-05T08:36:00+10:00,2023-06-05,08:36,3,3,6
57,2023-06-05T08:36:00+10:00,2023-06-05,08:36,7,13,20
58,2023-06-05T08:36:00+10:00,2023-06-05,08:36,12,0,12
62,2023-06-05T08:36:00+10:00,2023-06-05,08:36,1,1,2
67,2023-06-05T08:36:00+10:00,2023-06-05,08:36,7,7,14
76,2023-06-05T08:36:00+10:00,2023-06-05,08:36,10,0,10
4,2023-06-05T08:36:00+10:00,2023-06-05,08:36,8,9,17
6,2023-06-05T08:36:00+10:00,2023-06-05,08:36,6,42,48
28,2023-06-05T08:36:00+10:00,2023-06-05,08:36,6,8,14
31,2023-06-05T08:36:00+10:00,2023-06-05,08:36,2,1,3
40,2023-06-05T08:36:00+10:00,2023-06-05,08:36,3,9,12
50,2023-06-05T08:36:00+10:00,2023-06-05,08:36,2,0,2
54,2023-06-05T08:36:00+10:00,2023-06-05,08:36,1,2,3
65,2023-06-05T08:36:00+10:00,2023-06-05,08:36,9,5,14
66,2023-06-05T08:36:00+10:00,2023-06-05,08:36,2,16,18
69,2023-06-05T08:36:00+10:00,2023-06-05,08:36,3,1,4
77,2023-06-05T08:36:00+10:00,2023-06-05,08:36,3,3,6
108,2023-06-05T08:36:00+10:00,2023-06-05,08:36,8,27,35
1,2023-06-05T08:36:00+10:00,2023-06-05,08:36,0,4,4
10,2023-06-05T08:36:00+10:00,2023-06-05,08:36,3,4,7
12,2023-06-05T08:36:00+10:00,2023-06-05,08:36,0,1,1
19,2023-06-05T08:36:00+10:00,2023-06-05,08:36,1,3,4
24,2023-06-05T08:36:00+10:00,2023-06-05,08:36,21,8,29
27,2023-06-05T08:36:00+10:00,2023-06-05,08:36,2,2,4
35,2023-06-05T08:36:00+10:00,2023-06-05,08:36,3,17,20
48,2023-06-05T08:36:00+10:00,2023-06-05,08:36,1,1,2
51,2023-06-05T08:36:00+10:00,2023-06-05,08:36,1,3,4
53,2023-06-05T08:36:00+10:00,2023-06-05,08:36,4,4,8
72,2023-06-05T08:36:00+10:00,2023-06-05,08:36,23,3,26
85,2023-06-05T08:36:00+10:00,2023-06-05,08:36,1,3,4
8,2023-06-05T08:36:00+10:00,2023-06-05,08:36,2,1,3
21,2023-06-05T08:36:00+10:00,2023-06-05,08:36,2,2,4
26,2023-06-05T08:36:00+10:00,2023-06-05,08:36,6,4,10
29,2023-06-05T08:36:00+10:00,2023-06-05,08:36,2,2,4
39,2023-06-05T08:36:00+10:00,2023-06-05,08:36,1,1,2
41,2023-06-05T08:36:00+10:00,2023-06-05,08:36,41,5,46
42,2023-06-05T08:36:00+10:00,2023-06-05,08:36,1,0,1
45,2023-06-05T08:36:00+10:00,2023-06-05,08:36,7,6,13
61,2023-06-05T08:36:00+10:00,2023-06-05,08:36,4,3,7
87,2023-06-05T08:36:00+10:00,2023-06-05,08:36,0,1,1
18,2023-06-05T08:36:00+10:00,2023-06-05,08:36,0,16,16
20,2023-06-05T08:36:00+10:00,2023-06-05,08:36,2,0,2
30,2023-06-05T08:36:00+10:00,2023-06-05,08:36,1,4,5
56,2023-06-05T08:36:00+10:00,2023-06-05,08:36,1,2,3
63,2023-06-05T08:36:00+10:00,2023-06-05,08:36,3,0,3
68,2023-06-05T08:36:00+10:00,2023-06-05,08:36,3,2,5
79,2023-06-05T08:36:00+10:00,2023-06-05,08:36,28,4,32
86,2023-06-05T08:36:00+10:00,2023-06-05,08:36,1,0,1
21,2023-06-05T08:35:00+10:00,2023-06-05,08:35,1,2,3
26,2023-06-05T08:35:00+10:00,2023-06-05,08:35,8,3,11
29,2023-06-05T08:35:00+10:00,2023-06-05,08:35,2,1,3
31,2023-06-05T08:35:00+10:00,2023-06-05,08:35,8,1,9
36,2023-06-05T08:35:00+10:00,2023-06-05,08:35,7,2,9
41,2023-06-05T08:35:00+10:00,2023-06-05,08:35,27,15,42
54,2023-06-05T08:35:00+10:00,2023-06-05,08:35,1,0,1
61,2023-06-05T08:35:00+10:00,2023-06-05,08:35,6,9,15
69,2023-06-05T08:35:00+10:00,2023-06-05,08:35,3,2,5
70,2023-06-05T08:35:00+10:00,2023-06-05,08:35,4,0,4
84,2023-06-05T08:35:00+10:00,2023-06-05,08:35,124,27,151
107,2023-06-05T08:35:00+10:00,2023-06-05,08:35,5,13,18
118,2023-06-05T08:35:00+10:00,2023-06-05,08:35,8,2,10
2,2023-06-05T08:35:00+10:00,2023-06-05,08:35,2,2,4
12,2023-06-05T08:35:00+10:00,2023-06-05,08:35,2,2,4
17,2023-06-05T08:35:00+10:00,2023-06-05,08:35,9,4,13
27,2023-06-05T08:35:00+10:00,2023-06-05,08:35,1,0,1
67,2023-06-05T08:35:00+10:00,2023-06-05,08:35,6,4,10
76,2023-06-05T08:35:00+10:00,2023-06-05,08:35,0,3,3
85,2023-06-05T08:35:00+10:00,2023-06-05,08:35,3,1,4
86,2023-06-05T08:35:00+10:00,2023-06-05,08:35,1,0,1
109,2023-06-05T08:35:00+10:00,2023-06-05,08:35,11,54,65
3,2023-06-05T08:35:00+10:00,2023-06-05,08:35,5,4,9
4,2023-06-05T08:35:00+10:00,2023-06-05,08:35,13,10,23
5,2023-06-05T08:35:00+10:00,2023-06-05,08:35,5,4,9
14,2023-06-05T08:35:00+10:00,2023-06-05,08:35,2,12,14
39,2023-06-05T08:35:00+10:00,2023-06-05,08:35,2,2,4
42,2023-06-05T08:35:00+10:00,2023-06-05,08:35,8,2,10
55,2023-06-05T08:35:00+10:00,2023-06-05,08:35,1,6,7
65,2023-06-05T08:35:00+10:00,2023-06-05,08:35,11,2,13
77,2023-06-05T08:35:00+10:00,2023-06-05,08:35,4,0,4
78,2023-06-05T08:35:00+10:00,2023-06-05,08:35,1,0,1
87,2023-06-05T08:35:00+10:00,2023-06-05,08:35,1,0,1
108,2023-06-05T08:35:00+10:00,2023-06-05,08:35,2,24,26
10,2023-06-05T08:35:00+10:00,2023-06-05,08:35,0,9,9
18,2023-06-05T08:35:00+10:00,2023-06-05,08:35,0,14,14
19,2023-06-05T08:35:00+10:00,2023-06-05,08:35,0,2,2
20,2023-06-05T08:35:00+10:00,2023-06-05,08:35,0,1,1
23,2023-06-05T08:35:00+10:00,2023-06-05,08:35,23,1,24
24,2023-06-05T08:35:00+10:00,2023-06-05,08:35,41,4,45
30,2023-06-05T08:35:00+10:00,2023-06-05,08:35,2,1,3
35,2023-06-05T08:35:00+10:00,2023-06-05,08:35,6,18,24
46,2023-06-05T08:35:00+10:00,2023-06-05,08:35,0,3,3
48,2023-06-05T08:35:00+10:00,2023-06-05,08:35,5,0,5
57,2023-06-05T08:35:00+10:00,2023-06-05,08:35,7,5,12
63,2023-06-05T08:35:00+10:00,2023-06-05,08:35,2,4,6
72,2023-06-05T08:35:00+10:00,2023-06-05,08:35,20,1,21
79,2023-06-05T08:35:00+10:00,2023-06-05,08:35,8,4,12
117,2023-06-05T08:35:00+10:00,2023-06-05,08:35,37,7,44
6,2023-06-05T08:35:00+10:00,2023-06-05,08:35,15,35,50
8,2023-06-05T08:35:00+10:00,2023-06-05,08:35,3,1,4
28,2023-06-05T08:35:00+10:00,2023-06-05,08:35,8,4,12
40,2023-06-05T08:35:00+10:00,2023-06-05,08:35,8,4,12
44,2023-06-05T08:35:00+10:00,2023-06-05,08:35,1,2,3
45,2023-06-05T08:35:00+10:00,2023-06-05,08:35,3,2,5
47,2023-06-05T08:35:00+10:00,2023-06-05,08:35,2,10,12
59,2023-06-05T08:35:00+10:00,2023-06-05,08:35,43,12,55
66,2023-06-05T08:35:00+10:00,2023-06-05,08:35,1,12,13
1,2023-06-05T08:35:00+10:00,2023-06-05,08:35,5,1,6
9,2023-06-05T08:35:00+10:00,2023-06-05,08:35,3,26,29
11,2023-06-05T08:35:00+10:00,2023-06-05,08:35,4,2,6
49,2023-06-05T08:35:00+10:00,2023-06-05,08:35,2,1,3
52,2023-06-05T08:35:00+10:00,2023-06-05,08:35,4,4,8
53,2023-06-05T08:35:00+10:00,2023-06-05,08:35,6,6,12
56,2023-06-05T08:35:00+10:00,2023-06-05,08:35,1,1,2
58,2023-06-05T08:35:00+10:00,2023-06-05,08:35,41,3,44
62,2023-06-05T08:35:00+10:00,2023-06-05,08:35,1,1,2
68,2023-06-05T08:35:00+10:00,2023-06-05,08:35,1,1,2
5,2023-06-05T08:34:00+10:00,2023-06-05,08:34,6,14,20
21,2023-06-05T08:34:00+10:00,2023-06-05,08:34,1,6,7
26,2023-06-05T08:34:00+10:00,2023-06-05,08:34,5,2,7
31,2023-06-05T08:34:00+10:00,2023-06-05,08:34,1,0,1
36,2023-06-05T08:34:00+10:00,2023-06-05,08:34,3,7,10
39,2023-06-05T08:34:00+10:00,2023-06-05,08:34,4,4,8
41,2023-06-05T08:34:00+10:00,2023-06-05,08:34,57,2,59
44,2023-06-05T08:34:00+10:00,2023-06-05,08:34,1,0,1
47,2023-06-05T08:34:00+10:00,2023-06-05,08:34,6,18,24
50,2023-06-05T08:34:00+10:00,2023-06-05,08:34,0,3,3
75,2023-06-05T08:34:00+10:00,2023-06-05,08:34,3,1,4
77,2023-06-05T08:34:00+10:00,2023-06-05,08:34,1,8,9
87,2023-06-05T08:34:00+10:00,2023-06-05,08:34,4,0,4
1,2023-06-05T08:34:00+10:00,2023-06-05,08:34,5,4,9
9,2023-06-05T08:34:00+10:00,2023-06-05,08:34,2,44,46
17,2023-06-05T08:34:00+10:00,2023-06-05,08:34,18,2,20
19,2023-06-05T08:34:00+10:00,2023-06-05,08:34,2,2,4
23,2023-06-05T08:34:00+10:00,2023-06-05,08:34,4,5,9
24,2023-06-05T08:34:00+10:00,2023-06-05,08:34,9,3,12
27,2023-06-05T08:34:00+10:00,2023-06-05,08:34,0,1,1
30,2023-06-05T08:34:00+10:00,2023-06-05,08:34,4,1,5
48,2023-06-05T08:34:00+10:00,2023-06-05,08:34,6,4,10
52,2023-06-05T08:34:00+10:00,2023-06-05,08:34,5,2,7
58,2023-06-05T08:34:00+10:00,2023-06-05,08:34,1,1,2
67,2023-06-05T08:34:00+10:00,2023-06-05,08:34,5,4,9
79,2023-06-05T08:34:00+10:00,2023-06-05,08:34,12,7,19
86,2023-06-05T08:34:00+10:00,2023-06-05,08:34,1,0,1
3,2023-06-05T08:34:00+10:00,2023-06-05,08:34,1,9,10
14,2023-06-05T08:34:00+10:00,2023-06-05,08:34,6,4,10
40,2023-06-05T08:34:00+10:00,2023-06-05,08:34,2,1,3
55,2023-06-05T08:34:00+10:00,2023-06-05,08:34,7,7,14
61,2023-06-05T08:34:00+10:00,2023-06-05,08:34,1,8,9
69,2023-06-05T08:34:00+10:00,2023-06-05,08:34,2,1,3
78,2023-06-05T08:34:00+10:00,2023-06-05,08:34,0,1,1
10,2023-06-05T08:34:00+10:00,2023-06-05,08:34,2,2,4
11,2023-06-05T08:34:00+10:00,2023-06-05,08:34,0,1,1
12,2023-06-05T08:34:00+10:00,2023-06-05,08:34,1,2,3
18,2023-06-05T08:34:00+10:00,2023-06-05,08:34,2,15,17
20,2023-06-05T08:34:00+10:00,2023-06-05,08:34,2,0,2
49,2023-06-05T08:34:00+10:00,2023-06-05,08:34,1,0,1
53,2023-06-05T08:34:00+10:00,2023-06-05,08:34,7,4,11
63,2023-06-05T08:34:00+10:00,2023-06-05,08:34,5,0,5
4,2023-06-05T08:34:00+10:00,2023-06-05,08:34,6,5,11
6,2023-06-05T08:34:00+10:00,2023-06-05,08:34,6,17,23
8,2023-06-05T08:34:00+10:00,2023-06-05,08:34,3,0,3
28,2023-06-05T08:34:00+10:00,2023-06-05,08:34,11,5,16
29,2023-06-05T08:34:00+10:00,2023-06-05,08:34,8,1,9
42,2023-06-05T08:34:00+10:00,2023-06-05,08:34,1,1,2
45,2023-06-05T08:34:00+10:00,2023-06-05,08:34,8,9,17
65,2023-06-05T08:34:00+10:00,2023-06-05,08:34,4,10,14
66,2023-06-05T08:34:00+10:00,2023-06-05,08:34,6,3,9
70,2023-06-05T08:34:00+10:00,2023-06-05,08:34,1,3,4
108,2023-06-05T08:34:00+10:00,2023-06-05,08:34,3,22,25
2,2023-06-05T08:34:00+10:00,2023-06-05,08:34,2,4,6
35,2023-06-05T08:34:00+10:00,2023-06-05,08:34,6,29,35
46,2023-06-05T08:34:00+10:00,2023-06-05,08:34,1,1,2
51,2023-06-05T08:34:00+10:00,2023-06-05,08:34,1,0,1
56,2023-06-05T08:34:00+10:00,2023-06-05,08:34,0,2,2
57,2023-06-05T08:34:00+10:00,2023-06-05,08:34,16,20,36
68,2023-06-05T08:34:00+10:00,2023-06-05,08:34,1,2,3
72,2023-06-05T08:34:00+10:00,2023-06-05,08:34,10,3,13
76,2023-06-05T08:34:00+10:00,2023-06-05,08:34,3,0,3
85,2023-06-05T08:34:00+10:00,2023-06-05,08:34,1,0,1
5,2023-06-05T08:33:00+10:00,2023-06-05,08:33,5,10,15
14,2023-06-05T08:33:00+10:00,2023-06-05,08:33,4,8,12
28,2023-06-05T08:33:00+10:00,2023-06-05,08:33,5,5,10
36,2023-06-05T08:33:00+10:00,2023-06-05,08:33,5,6,11
61,2023-06-05T08:33:00+10:00,2023-06-05,08:33,4,7,11
69,2023-06-05T08:33:00+10:00,2023-06-05,08:33,2,1,3
77,2023-06-05T08:33:00+10:00,2023-06-05,08:33,2,2,4
108,2023-06-05T08:33:00+10:00,2023-06-05,08:33,4,20,24
1,2023-06-05T08:33:00+10:00,2023-06-05,08:33,5,1,6
2,2023-06-05T08:33:00+10:00,2023-06-05,08:33,1,3,4
9,2023-06-05T08:33:00+10:00,2023-06-05,08:33,0,47,47
20,2023-06-05T08:33:00+10:00,2023-06-05,08:33,0,4,4
68,2023-06-05T08:33:00+10:00,2023-06-05,08:33,1,1,2
86,2023-06-05T08:33:00+10:00,2023-06-05,08:33,1,3,4
3,2023-06-05T08:33:00+10:00,2023-06-05,08:33,3,2,5
8,2023-06-05T08:33:00+10:00,2023-06-05,08:33,3,0,3
21,2023-06-05T08:33:00+10:00,2023-06-05,08:33,0,2,2
54,2023-06-05T08:33:00+10:00,2023-06-05,08:33,1,1,2
75,2023-06-05T08:33:00+10:00,2023-06-05,08:33,0,1,1
87,2023-06-05T08:33:00+10:00,2023-06-05,08:33,2,1,3
12,2023-06-05T08:33:00+10:00,2023-06-05,08:33,2,4,6
18,2023-06-05T08:33:00+10:00,2023-06-05,08:33,0,20,20
19,2023-06-05T08:33:00+10:00,2023-06-05,08:33,2,0,2
24,2023-06-05T08:33:00+10:00,2023-06-05,08:33,50,3,53
52,2023-06-05T08:33:00+10:00,2023-06-05,08:33,3,9,12
53,2023-06-05T08:33:00+10:00,2023-06-05,08:33,2,2,4
63,2023-06-05T08:33:00+10:00,2023-06-05,08:33,2,3,5
67,2023-06-05T08:33:00+10:00,2023-06-05,08:33,11,4,15
72,2023-06-05T08:33:00+10:00,2023-06-05,08:33,8,2,10
76,2023-06-05T08:33:00+10:00,2023-06-05,08:33,3,0,3
79,2023-06-05T08:33:00+10:00,2023-06-05,08:33,8,6,14
85,2023-06-05T08:33:00+10:00,2023-06-05,08:33,1,2,3
4,2023-06-05T08:33:00+10:00,2023-06-05,08:33,4,1,5
6,2023-06-05T08:33:00+10:00,2023-06-05,08:33,5,24,29
26,2023-06-05T08:33:00+10:00,2023-06-05,08:33,5,5,10
29,2023-06-05T08:33:00+10:00,2023-06-05,08:33,2,2,4
31,2023-06-05T08:33:00+10:00,2023-06-05,08:33,1,1,2
37,2023-06-05T08:33:00+10:00,2023-06-05,08:33,0,3,3
39,2023-06-05T08:33:00+10:00,2023-06-05,08:33,9,2,11
40,2023-06-05T08:33:00+10:00,2023-06-05,08:33,5,3,8
41,2023-06-05T08:33:00+10:00,2023-06-05,08:33,16,4,20
44,2023-06-05T08:33:00+10:00,2023-06-05,08:33,0,4,4
45,2023-06-05T08:33:00+10:00,2023-06-05,08:33,5,6,11
47,2023-06-05T08:33:00+10:00,2023-06-05,08:33,0,2,2
55,2023-06-05T08:33:00+10:00,2023-06-05,08:33,19,11,30
65,2023-06-05T08:33:00+10:00,2023-06-05,08:33,12,4,16
66,2023-06-05T08:33:00+10:00,2023-06-05,08:33,0,10,10
70,2023-06-05T08:33:00+10:00,2023-06-05,08:33,1,2,3
10,2023-06-05T08:33:00+10:00,2023-06-05,08:33,2,7,9
17,2023-06-05T08:33:00+10:00,2023-06-05,08:33,22,5,27
23,2023-06-05T08:33:00+10:00,2023-06-05,08:33,16,7,23
27,2023-06-05T08:33:00+10:00,2023-06-05,08:33,3,0,3
35,2023-06-05T08:33:00+10:00,2023-06-05,08:33,10,23,33
46,2023-06-05T08:33:00+10:00,2023-06-05,08:33,2,2,4
48,2023-06-05T08:33:00+10:00,2023-06-05,08:33,4,3,7
51,2023-06-05T08:33:00+10:00,2023-06-05,08:33,0,2,2
57,2023-06-05T08:33:00+10:00,2023-06-05,08:33,9,15,24
58,2023-06-05T08:33:00+10:00,2023-06-05,08:33,43,3,46
62,2023-06-05T08:33:00+10:00,2023-06-05,08:33,1,2,3
3,2023-06-05T08:32:00+10:00,2023-06-05,08:32,1,4,5
4,2023-06-05T08:32:00+10:00,2023-06-05,08:32,13,7,20
5,2023-06-05T08:32:00+10:00,2023-06-05,08:32,6,9,15
6,2023-06-05T08:32:00+10:00,2023-06-05,08:32,8,49,57
8,2023-06-05T08:32:00+10:00,2023-06-05,08:32,3,2,5
14,2023-06-05T08:32:00+10:00,2023-06-05,08:32,4,11,15
21,2023-06-05T08:32:00+10:00,2023-06-05,08:32,1,3,4
31,2023-06-05T08:32:00+10:00,2023-06-05,08:32,1,0,1
39,2023-06-05T08:32:00+10:00,2023-06-05,08:32,4,3,7
45,2023-06-05T08:32:00+10:00,2023-06-05,08:32,0,6,6
47,2023-06-05T08:32:00+10:00,2023-06-05,08:32,3,17,20
65,2023-06-05T08:32:00+10:00,2023-06-05,08:32,8,1,9
66,2023-06-05T08:32:00+10:00,2023-06-05,08:32,2,11,13
69,2023-06-05T08:32:00+10:00,2023-06-05,08:32,3,1,4
87,2023-06-05T08:32:00+10:00,2023-06-05,08:32,1,2,3
2,2023-06-05T08:32:00+10:00,2023-06-05,08:32,3,3,6
10,2023-06-05T08:32:00+10:00,2023-06-05,08:32,3,11,14
12,2023-06-05T08:32:00+10:00,2023-06-05,08:32,0,1,1
23,2023-06-05T08:32:00+10:00,2023-06-05,08:32,16,5,21
30,2023-06-05T08:32:00+10:00,2023-06-05,08:32,2,3,5
49,2023-06-05T08:32:00+10:00,2023-06-05,08:32,1,1,2
52,2023-06-05T08:32:00+10:00,2023-06-05,08:32,1,1,2
56,2023-06-05T08:32:00+10:00,2023-06-05,08:32,0,1,1
57,2023-06-05T08:32:00+10:00,2023-06-05,08:32,9,21,30
62,2023-06-05T08:32:00+10:00,2023-06-05,08:32,0,1,1
79,2023-06-05T08:32:00+10:00,2023-06-05,08:32,1,8,9
28,2023-06-05T08:32:00+10:00,2023-06-05,08:32,17,5,22
41,2023-06-05T08:32:00+10:00,2023-06-05,08:32,45,2,47
54,2023-06-05T08:32:00+10:00,2023-06-05,08:32,5,0,5
77,2023-06-05T08:32:00+10:00,2023-06-05,08:32,2,5,7
78,2023-06-05T08:32:00+10:00,2023-06-05,08:32,2,3,5
17,2023-06-05T08:32:00+10:00,2023-06-05,08:32,16,2,18
18,2023-06-05T08:32:00+10:00,2023-06-05,08:32,0,28,28
19,2023-06-05T08:32:00+10:00,2023-06-05,08:32,1,1,2
24,2023-06-05T08:32:00+10:00,2023-06-05,08:32,44,5,49
51,2023-06-05T08:32:00+10:00,2023-06-05,08:32,3,1,4
53,2023-06-05T08:32:00+10:00,2023-06-05,08:32,7,4,11
58,2023-06-05T08:32:00+10:00,2023-06-05,08:32,39,0,39
72,2023-06-05T08:32:00+10:00,2023-06-05,08:32,8,1,9
76,2023-06-05T08:32:00+10:00,2023-06-05,08:32,2,1,3
26,2023-06-05T08:32:00+10:00,2023-06-05,08:32,2,3,5
29,2023-06-05T08:32:00+10:00,2023-06-05,08:32,1,2,3
36,2023-06-05T08:32:00+10:00,2023-06-05,08:32,6,3,9
40,2023-06-05T08:32:00+10:00,2023-06-05,08:32,2,5,7
42,2023-06-05T08:32:00+10:00,2023-06-05,08:32,3,3,6
50,2023-06-05T08:32:00+10:00,2023-06-05,08:32,0,2,2
55,2023-06-05T08:32:00+10:00,2023-06-05,08:32,1,11,12
61,2023-06-05T08:32:00+10:00,2023-06-05,08:32,5,5,10
70,2023-06-05T08:32:00+10:00,2023-06-05,08:32,0,1,1
71,2023-06-05T08:32:00+10:00,2023-06-05,08:32,1,1,2
75,2023-06-05T08:32:00+10:00,2023-06-05,08:32,2,2,4
108,2023-06-05T08:32:00+10:00,2023-06-05,08:32,2,16,18
1,2023-06-05T08:32:00+10:00,2023-06-05,08:32,9,4,13
9,2023-06-05T08:32:00+10:00,2023-06-05,08:32,0,58,58
27,2023-06-05T08:32:00+10:00,2023-06-05,08:32,2,4,6
35,2023-06-05T08:32:00+10:00,2023-06-05,08:32,3,34,37
46,2023-06-05T08:32:00+10:00,2023-06-05,08:32,3,6,9
63,2023-06-05T08:32:00+10:00,2023-06-05,08:32,3,8,11
67,2023-06-05T08:32:00+10:00,2023-06-05,08:32,8,6,14
68,2023-06-05T08:32:00+10:00,2023-06-05,08:32,2,6,8
85,2023-06-05T08:32:00+10:00,2023-06-05,08:32,2,1,3
28,2023-06-05T08:31:00+10:00,2023-06-05,08:31,8,3,11
37,2023-06-05T08:31:00+10:00,2023-06-05,08:31,0,2,2
40,2023-06-05T08:31:00+10:00,2023-06-05,08:31,3,5,8
42,2023-06-05T08:31:00+10:00,2023-06-05,08:31,1,1,2
47,2023-06-05T08:31:00+10:00,2023-06-05,08:31,6,21,27
55,2023-06-05T08:31:00+10:00,2023-06-05,08:31,6,5,11
65,2023-06-05T08:31:00+10:00,2023-06-05,08:31,9,0,9
66,2023-06-05T08:31:00+10:00,2023-06-05,08:31,5,8,13
69,2023-06-05T08:31:00+10:00,2023-06-05,08:31,4,1,5
75,2023-06-05T08:31:00+10:00,2023-06-05,08:31,2,2,4
10,2023-06-05T08:31:00+10:00,2023-06-05,08:31,0,4,4
12,2023-06-05T08:31:00+10:00,2023-06-05,08:31,2,0,2
20,2023-06-05T08:31:00+10:00,2023-06-05,08:31,1,1,2
23,2023-06-05T08:31:00+10:00,2023-06-05,08:31,10,0,10
27,2023-06-05T08:31:00+10:00,2023-06-05,08:31,0,4,4
49,2023-06-05T08:31:00+10:00,2023-06-05,08:31,1,0,1
52,2023-06-05T08:31:00+10:00,2023-06-05,08:31,3,5,8
57,2023-06-05T08:31:00+10:00,2023-06-05,08:31,3,22,25
58,2023-06-05T08:31:00+10:00,2023-06-05,08:31,9,5,14
41,2023-06-05T08:31:00+10:00,2023-06-05,08:31,51,4,55
45,2023-06-05T08:31:00+10:00,2023-06-05,08:31,9,4,13
54,2023-06-05T08:31:00+10:00,2023-06-05,08:31,8,0,8
70,2023-06-05T08:31:00+10:00,2023-06-05,08:31,0,2,2
78,2023-06-05T08:31:00+10:00,2023-06-05,08:31,0,1,1
87,2023-06-05T08:31:00+10:00,2023-06-05,08:31,2,2,4
108,2023-06-05T08:31:00+10:00,2023-06-05,08:31,2,19,21
1,2023-06-05T08:31:00+10:00,2023-06-05,08:31,3,5,8
2,2023-06-05T08:31:00+10:00,2023-06-05,08:31,0,2,2
9,2023-06-05T08:31:00+10:00,2023-06-05,08:31,1,20,21
11,2023-06-05T08:31:00+10:00,2023-06-05,08:31,0,1,1
17,2023-06-05T08:31:00+10:00,2023-06-05,08:31,28,0,28
24,2023-06-05T08:31:00+10:00,2023-06-05,08:31,37,1,38
30,2023-06-05T08:31:00+10:00,2023-06-05,08:31,1,0,1
62,2023-06-05T08:31:00+10:00,2023-06-05,08:31,4,1,5
67,2023-06-05T08:31:00+10:00,2023-06-05,08:31,9,6,15
72,2023-06-05T08:31:00+10:00,2023-06-05,08:31,10,1,11
86,2023-06-05T08:31:00+10:00,2023-06-05,08:31,1,0,1
3,2023-06-05T08:31:00+10:00,2023-06-05,08:31,2,10,12
4,2023-06-05T08:31:00+10:00,2023-06-05,08:31,14,9,23
5,2023-06-05T08:31:00+10:00,2023-06-05,08:31,3,8,11
6,2023-06-05T08:31:00+10:00,2023-06-05,08:31,3,34,37
8,2023-06-05T08:31:00+10:00,2023-06-05,08:31,4,1,5
14,2023-06-05T08:31:00+10:00,2023-06-05,08:31,3,6,9
21,2023-06-05T08:31:00+10:00,2023-06-05,08:31,0,7,7
26,2023-06-05T08:31:00+10:00,2023-06-05,08:31,3,2,5
29,2023-06-05T08:31:00+10:00,2023-06-05,08:31,2,4,6
31,2023-06-05T08:31:00+10:00,2023-06-05,08:31,0,1,1
36,2023-06-05T08:31:00+10:00,2023-06-05,08:31,2,2,4
39,2023-06-05T08:31:00+10:00,2023-06-05,08:31,3,2,5
44,2023-06-05T08:31:00+10:00,2023-06-05,08:31,0,2,2
61,2023-06-05T08:31:00+10:00,2023-06-05,08:31,0,11,11
77,2023-06-05T08:31:00+10:00,2023-06-05,08:31,4,3,7
18,2023-06-05T08:31:00+10:00,2023-06-05,08:31,2,29,31
19,2023-06-05T08:31:00+10:00,2023-06-05,08:31,1,3,4
35,2023-06-05T08:31:00+10:00,2023-06-05,08:31,9,24,33
46,2023-06-05T08:31:00+10:00,2023-06-05,08:31,1,0,1
48,2023-06-05T08:31:00+10:00,2023-06-05,08:31,4,1,5
53,2023-06-05T08:31:00+10:00,2023-06-05,08:31,5,2,7
56,2023-06-05T08:31:00+10:00,2023-06-05,08:31,0,1,1
63,2023-06-05T08:31:00+10:00,2023-06-05,08:31,3,2,5
68,2023-06-05T08:31:00+10:00,2023-06-05,08:31,3,2,5
76,2023-06-05T08:31:00+10:00,2023-06-05,08:31,3,2,5
79,2023-06-05T08:31:00+10:00,2023-06-05,08:31,9,4,13
85,2023-06-05T08:31:00+10:00,2023-06-05,08:31,3,1,4
4,2023-06-05T08:30:00+10:00,2023-06-05,08:30,8,9,17
5,2023-06-05T08:30:00+10:00,2023-06-05,08:30,11,10,21
6,2023-06-05T08:30:00+10:00,2023-06-05,08:30,12,25,37
28,2023-06-05T08:30:00+10:00,2023-06-05,08:30,8,7,15
29,2023-06-05T08:30:00+10:00,2023-06-05,08:30,3,1,4
37,2023-06-05T08:30:00+10:00,2023-06-05,08:30,0,2,2
41,2023-06-05T08:30:00+10:00,2023-06-05,08:30,37,6,43
45,2023-06-05T08:30:00+10:00,2023-06-05,08:30,4,6,10
47,2023-06-05T08:30:00+10:00,2023-06-05,08:30,5,2,7
55,2023-06-05T08:30:00+10:00,2023-06-05,08:30,9,10,19
59,2023-06-05T08:30:00+10:00,2023-06-05,08:30,36,11,47
69,2023-06-05T08:30:00+10:00,2023-06-05,08:30,2,0,2
75,2023-06-05T08:30:00+10:00,2023-06-05,08:30,1,1,2
77,2023-06-05T08:30:00+10:00,2023-06-05,08:30,2,4,6
108,2023-06-05T08:30:00+10:00,2023-06-05,08:30,3,28,31
118,2023-06-05T08:30:00+10:00,2023-06-05,08:30,1,1,2
2,2023-06-05T08:30:00+10:00,2023-06-05,08:30,1,2,3
18,2023-06-05T08:30:00+10:00,2023-06-05,08:30,1,22,23
35,2023-06-05T08:30:00+10:00,2023-06-05,08:30,6,26,32
52,2023-06-05T08:30:00+10:00,2023-06-05,08:30,4,9,13
57,2023-06-05T08:30:00+10:00,2023-06-05,08:30,3,8,11
58,2023-06-05T08:30:00+10:00,2023-06-05,08:30,47,4,51
67,2023-06-05T08:30:00+10:00,2023-06-05,08:30,2,8,10
76,2023-06-05T08:30:00+10:00,2023-06-05,08:30,3,0,3
85,2023-06-05T08:30:00+10:00,2023-06-05,08:30,1,1,2
8,2023-06-05T08:30:00+10:00,2023-06-05,08:30,5,6,11
21,2023-06-05T08:30:00+10:00,2023-06-05,08:30,0,2,2
31,2023-06-05T08:30:00+10:00,2023-06-05,08:30,1,2,3
40,2023-06-05T08:30:00+10:00,2023-06-05,08:30,6,11,17
42,2023-06-05T08:30:00+10:00,2023-06-05,08:30,2,5,7
50,2023-06-05T08:30:00+10:00,2023-06-05,08:30,0,1,1
54,2023-06-05T08:30:00+10:00,2023-06-05,08:30,1,0,1
61,2023-06-05T08:30:00+10:00,2023-06-05,08:30,0,4,4
65,2023-06-05T08:30:00+10:00,2023-06-05,08:30,5,3,8
66,2023-06-05T08:30:00+10:00,2023-06-05,08:30,1,14,15
78,2023-06-05T08:30:00+10:00,2023-06-05,08:30,1,0,1
84,2023-06-05T08:30:00+10:00,2023-06-05,08:30,126,29,155
87,2023-06-05T08:30:00+10:00,2023-06-05,08:30,1,0,1
107,2023-06-05T08:30:00+10:00,2023-06-05,08:30,8,19,27
10,2023-06-05T08:30:00+10:00,2023-06-05,08:30,2,2,4
11,2023-06-05T08:30:00+10:00,2023-06-05,08:30,3,2,5
12,2023-06-05T08:30:00+10:00,2023-06-05,08:30,2,1,3
17,2023-06-05T08:30:00+10:00,2023-06-05,08:30,23,4,27
23,2023-06-05T08:30:00+10:00,2023-06-05,08:30,16,6,22
46,2023-06-05T08:30:00+10:00,2023-06-05,08:30,3,1,4
48,2023-06-05T08:30:00+10:00,2023-06-05,08:30,2,0,2
51,2023-06-05T08:30:00+10:00,2023-06-05,08:30,1,1,2
53,2023-06-05T08:30:00+10:00,2023-06-05,08:30,8,5,13
56,2023-06-05T08:30:00+10:00,2023-06-05,08:30,1,2,3
68,2023-06-05T08:30:00+10:00,2023-06-05,08:30,2,4,6
79,2023-06-05T08:30:00+10:00,2023-06-05,08:30,14,13,27
86,2023-06-05T08:30:00+10:00,2023-06-05,08:30,2,0,2
109,2023-06-05T08:30:00+10:00,2023-06-05,08:30,9,58,67
3,2023-06-05T08:30:00+10:00,2023-06-05,08:30,6,5,11
14,2023-06-05T08:30:00+10:00,2023-06-05,08:30,5,5,10
26,2023-06-05T08:30:00+10:00,2023-06-05,08:30,4,1,5
36,2023-06-05T08:30:00+10:00,2023-06-05,08:30,12,2,14
39,2023-06-05T08:30:00+10:00,2023-06-05,08:30,1,2,3
70,2023-06-05T08:30:00+10:00,2023-06-05,08:30,0,1,1
1,2023-06-05T08:30:00+10:00,2023-06-05,08:30,3,1,4
9,2023-06-05T08:30:00+10:00,2023-06-05,08:30,1,36,37
19,2023-06-05T08:30:00+10:00,2023-06-05,08:30,1,2,3
24,2023-06-05T08:30:00+10:00,2023-06-05,08:30,70,1,71
27,2023-06-05T08:30:00+10:00,2023-06-05,08:30,0,1,1
49,2023-06-05T08:30:00+10:00,2023-06-05,08:30,1,0,1
62,2023-06-05T08:30:00+10:00,2023-06-05,08:30,1,0,1
63,2023-06-05T08:30:00+10:00,2023-06-05,08:30,1,2,3
72,2023-06-05T08:30:00+10:00,2023-06-05,08:30,21,2,23
117,2023-06-05T08:30:00+10:00,2023-06-05,08:30,29,10,39
8,2023-06-05T08:29:00+10:00,2023-06-05,08:29,4,3,7
14,2023-06-05T08:29:00+10:00,2023-06-05,08:29,6,6,12
31,2023-06-05T08:29:00+10:00,2023-06-05,08:29,2,2,4
36,2023-06-05T08:29:00+10:00,2023-06-05,08:29,5,2,7
37,2023-06-05T08:29:00+10:00,2023-06-05,08:29,0,1,1
39,2023-06-05T08:29:00+10:00,2023-06-05,08:29,1,1,2
44,2023-06-05T08:29:00+10:00,2023-06-05,08:29,0,4,4
50,2023-06-05T08:29:00+10:00,2023-06-05,08:29,2,0,2
55,2023-06-05T08:29:00+10:00,2023-06-05,08:29,3,9,12
61,2023-06-05T08:29:00+10:00,2023-06-05,08:29,7,5,12
65,2023-06-05T08:29:00+10:00,2023-06-05,08:29,5,5,10
70,2023-06-05T08:29:00+10:00,2023-06-05,08:29,1,1,2
75,2023-06-05T08:29:00+10:00,2023-06-05,08:29,3,2,5
9,2023-06-05T08:29:00+10:00,2023-06-05,08:29,3,50,53
10,2023-06-05T08:29:00+10:00,2023-06-05,08:29,0,7,7
24,2023-06-05T08:29:00+10:00,2023-06-05,08:29,13,9,22
46,2023-06-05T08:29:00+10:00,2023-06-05,08:29,0,3,3
57,2023-06-05T08:29:00+10:00,2023-06-05,08:29,3,13,16
67,2023-06-05T08:29:00+10:00,2023-06-05,08:29,4,8,12
72,2023-06-05T08:29:00+10:00,2023-06-05,08:29,5,5,10
85,2023-06-05T08:29:00+10:00,2023-06-05,08:29,3,1,4
86,2023-06-05T08:29:00+10:00,2023-06-05,08:29,1,1,2
3,2023-06-05T08:29:00+10:00,2023-06-05,08:29,2,4,6
5,2023-06-05T08:29:00+10:00,2023-06-05,08:29,8,14,22
21,2023-06-05T08:29:00+10:00,2023-06-05,08:29,4,4,8
26,2023-06-05T08:29:00+10:00,2023-06-05,08:29,2,1,3
28,2023-06-05T08:29:00+10:00,2023-06-05,08:29,4,10,14
40,2023-06-05T08:29:00+10:00,2023-06-05,08:29,1,7,8
42,2023-06-05T08:29:00+10:00,2023-06-05,08:29,3,0,3
45,2023-06-05T08:29:00+10:00,2023-06-05,08:29,3,5,8
47,2023-06-05T08:29:00+10:00,2023-06-05,08:29,11,12,23
66,2023-06-05T08:29:00+10:00,2023-06-05,08:29,2,7,9
69,2023-06-05T08:29:00+10:00,2023-06-05,08:29,7,0,7
87,2023-06-05T08:29:00+10:00,2023-06-05,08:29,6,2,8
108,2023-06-05T08:29:00+10:00,2023-06-05,08:29,2,26,28
1,2023-06-05T08:29:00+10:00,2023-06-05,08:29,3,0,3
11,2023-06-05T08:29:00+10:00,2023-06-05,08:29,1,0,1
17,2023-06-05T08:29:00+10:00,2023-06-05,08:29,14,3,17
19,2023-06-05T08:29:00+10:00,2023-06-05,08:29,1,1,2
27,2023-06-05T08:29:00+10:00,2023-06-05,08:29,1,2,3
56,2023-06-05T08:29:00+10:00,2023-06-05,08:29,2,3,5
58,2023-06-05T08:29:00+10:00,2023-06-05,08:29,4,2,6
63,2023-06-05T08:29:00+10:00,2023-06-05,08:29,2,1,3
4,2023-06-05T08:29:00+10:00,2023-06-05,08:29,11,4,15
6,2023-06-05T08:29:00+10:00,2023-06-05,08:29,10,24,34
29,2023-06-05T08:29:00+10:00,2023-06-05,08:29,2,4,6
41,2023-06-05T08:29:00+10:00,2023-06-05,08:29,36,3,39
54,2023-06-05T08:29:00+10:00,2023-06-05,08:29,2,0,2
77,2023-06-05T08:29:00+10:00,2023-06-05,08:29,0,3,3
2,2023-06-05T08:29:00+10:00,2023-06-05,08:29,2,3,5
12,2023-06-05T08:29:00+10:00,2023-06-05,08:29,2,1,3
18,2023-06-05T08:29:00+10:00,2023-06-05,08:29,2,20,22
23,2023-06-05T08:29:00+10:00,2023-06-05,08:29,1,13,14
30,2023-06-05T08:29:00+10:00,2023-06-05,08:29,3,2,5
35,2023-06-05T08:29:00+10:00,2023-06-05,08:29,8,19,27
48,2023-06-05T08:29:00+10:00,2023-06-05,08:29,2,3,5
51,2023-06-05T08:29:00+10:00,2023-06-05,08:29,0,1,1
52,2023-06-05T08:29:00+10:00,2023-06-05,08:29,9,6,15
53,2023-06-05T08:29:00+10:00,2023-06-05,08:29,14,6,20
62,2023-06-05T08:29:00+10:00,2023-06-05,08:29,0,1,1
68,2023-06-05T08:29:00+10:00,2023-06-05,08:29,1,2,3
79,2023-06-05T08:29:00+10:00,2023-06-05,08:29,5,5,10
5,2023-06-05T08:28:00+10:00,2023-06-05,08:28,6,5,11
6,2023-06-05T08:28:00+10:00,2023-06-05,08:28,9,5,14
8,2023-06-05T08:28:00+10:00,2023-06-05,08:28,3,7,10
28,2023-06-05T08:28:00+10:00,2023-06-05,08:28,11,7,18
36,2023-06-05T08:28:00+10:00,2023-06-05,08:28,4,5,9
37,2023-06-05T08:28:00+10:00,2023-06-05,08:28,0,2,2
41,2023-06-05T08:28:00+10:00,2023-06-05,08:28,45,8,53
45,2023-06-05T08:28:00+10:00,2023-06-05,08:28,2,8,10
55,2023-06-05T08:28:00+10:00,2023-06-05,08:28,8,5,13
61,2023-06-05T08:28:00+10:00,2023-06-05,08:28,1,6,7
66,2023-06-05T08:28:00+10:00,2023-06-05,08:28,0,1,1
69,2023-06-05T08:28:00+10:00,2023-06-05,08:28,2,0,2
17,2023-06-05T08:28:00+10:00,2023-06-05,08:28,23,3,26
18,2023-06-05T08:28:00+10:00,2023-06-05,08:28,4,29,33
30,2023-06-05T08:28:00+10:00,2023-06-05,08:28,5,5,10
58,2023-06-05T08:28:00+10:00,2023-06-05,08:28,32,3,35
63,2023-06-05T08:28:00+10:00,2023-06-05,08:28,2,3,5
72,2023-06-05T08:28:00+10:00,2023-06-05,08:28,3,2,5
79,2023-06-05T08:28:00+10:00,2023-06-05,08:28,24,2,26
85,2023-06-05T08:28:00+10:00,2023-06-05,08:28,0,1,1
29,2023-06-05T08:28:00+10:00,2023-06-05,08:28,2,0,2
39,2023-06-05T08:28:00+10:00,2023-06-05,08:28,5,3,8
40,2023-06-05T08:28:00+10:00,2023-06-05,08:28,6,6,12
44,2023-06-05T08:28:00+10:00,2023-06-05,08:28,0,1,1
54,2023-06-05T08:28:00+10:00,2023-06-05,08:28,1,1,2
65,2023-06-05T08:28:00+10:00,2023-06-05,08:28,13,2,15
71,2023-06-05T08:28:00+10:00,2023-06-05,08:28,1,0,1
78,2023-06-05T08:28:00+10:00,2023-06-05,08:28,1,1,2
9,2023-06-05T08:28:00+10:00,2023-06-05,08:28,0,27,27
11,2023-06-05T08:28:00+10:00,2023-06-05,08:28,3,0,3
12,2023-06-05T08:28:00+10:00,2023-06-05,08:28,3,2,5
20,2023-06-05T08:28:00+10:00,2023-06-05,08:28,1,2,3
24,2023-06-05T08:28:00+10:00,2023-06-05,08:28,61,6,67
51,2023-06-05T08:28:00+10:00,2023-06-05,08:28,1,1,2
53,2023-06-05T08:28:00+10:00,2023-06-05,08:28,2,5,7
56,2023-06-05T08:28:00+10:00,2023-06-05,08:28,1,3,4
57,2023-06-05T08:28:00+10:00,2023-06-05,08:28,7,18,25
62,2023-06-05T08:28:00+10:00,2023-06-05,08:28,3,1,4
67,2023-06-05T08:28:00+10:00,2023-06-05,08:28,3,8,11
68,2023-06-05T08:28:00+10:00,2023-06-05,08:28,2,2,4
3,2023-06-05T08:28:00+10:00,2023-06-05,08:28,1,6,7
4,2023-06-05T08:28:00+10:00,2023-06-05,08:28,9,4,13
14,2023-06-05T08:28:00+10:00,2023-06-05,08:28,7,5,12
21,2023-06-05T08:28:00+10:00,2023-06-05,08:28,0,6,6
26,2023-06-05T08:28:00+10:00,2023-06-05,08:28,5,4,9
31,2023-06-05T08:28:00+10:00,2023-06-05,08:28,1,1,2
42,2023-06-05T08:28:00+10:00,2023-06-05,08:28,2,1,3
47,2023-06-05T08:28:00+10:00,2023-06-05,08:28,5,11,16
50,2023-06-05T08:28:00+10:00,2023-06-05,08:28,0,2,2
75,2023-06-05T08:28:00+10:00,2023-06-05,08:28,1,0,1
77,2023-06-05T08:28:00+10:00,2023-06-05,08:28,3,4,7
108,2023-06-05T08:28:00+10:00,2023-06-05,08:28,4,18,22
1,2023-06-05T08:28:00+10:00,2023-06-05,08:28,2,3,5
2,2023-06-05T08:28:00+10:00,2023-06-05,08:28,0,1,1
10,2023-06-05T08:28:00+10:00,2023-06-05,08:28,0,8,8
23,2023-06-05T08:28:00+10:00,2023-06-05,08:28,8,4,12
27,2023-06-05T08:28:00+10:00,2023-06-05,08:28,1,3,4
35,2023-06-05T08:28:00+10:00,2023-06-05,08:28,3,12,15
48,2023-06-05T08:28:00+10:00,2023-06-05,08:28,2,1,3
52,2023-06-05T08:28:00+10:00,2023-06-05,08:28,1,2,3
5,2023-06-05T08:27:00+10:00,2023-06-05,08:27,6,6,12
21,2023-06-05T08:27:00+10:00,2023-06-05,08:27,0,3,3
29,2023-06-05T08:27:00+10:00,2023-06-05,08:27,0,2,2
36,2023-06-05T08:27:00+10:00,2023-06-05,08:27,8,2,10
39,2023-06-05T08:27:00+10:00,2023-06-05,08:27,4,4,8
42,2023-06-05T08:27:00+10:00,2023-06-05,08:27,2,4,6
55,2023-06-05T08:27:00+10:00,2023-06-05,08:27,5,9,14
66,2023-06-05T08:27:00+10:00,2023-06-05,08:27,1,12,13
1,2023-06-05T08:27:00+10:00,2023-06-05,08:27,7,6,13
9,2023-06-05T08:27:00+10:00,2023-06-05,08:27,4,12,16
10,2023-06-05T08:27:00+10:00,2023-06-05,08:27,1,4,5
12,2023-06-05T08:27:00+10:00,2023-06-05,08:27,0,3,3
24,2023-06-05T08:27:00+10:00,2023-06-05,08:27,25,1,26
27,2023-06-05T08:27:00+10:00,2023-06-05,08:27,1,1,2
57,2023-06-05T08:27:00+10:00,2023-06-05,08:27,7,17,24
62,2023-06-05T08:27:00+10:00,2023-06-05,08:27,1,0,1
4,2023-06-05T08:27:00+10:00,2023-06-05,08:27,6,3,9
6,2023-06-05T08:27:00+10:00,2023-06-05,08:27,15,15,30
8,2023-06-05T08:27:00+10:00,2023-06-05,08:27,3,4,7
14,2023-06-05T08:27:00+10:00,2023-06-05,08:27,4,5,9
37,2023-06-05T08:27:00+10:00,2023-06-05,08:27,2,1,3
40,2023-06-05T08:27:00+10:00,2023-06-05,08:27,2,3,5
41,2023-06-05T08:27:00+10:00,2023-06-05,08:27,25,13,38
47,2023-06-05T08:27:00+10:00,2023-06-05,08:27,4,8,12
54,2023-06-05T08:27:00+10:00,2023-06-05,08:27,1,0,1
69,2023-06-05T08:27:00+10:00,2023-06-05,08:27,6,0,6
77,2023-06-05T08:27:00+10:00,2023-06-05,08:27,1,2,3
87,2023-06-05T08:27:00+10:00,2023-06-05,08:27,5,0,5
17,2023-06-05T08:27:00+10:00,2023-06-05,08:27,32,4,36
18,2023-06-05T08:27:00+10:00,2023-06-05,08:27,1,40,41
35,2023-06-05T08:27:00+10:00,2023-06-05,08:27,10,33,43
52,2023-06-05T08:27:00+10:00,2023-06-05,08:27,0,3,3
53,2023-06-05T08:27:00+10:00,2023-06-05,08:27,10,8,18
63,2023-06-05T08:27:00+10:00,2023-06-05,08:27,4,2,6
68,2023-06-05T08:27:00+10:00,2023-06-05,08:27,5,3,8
72,2023-06-05T08:27:00+10:00,2023-06-05,08:27,17,0,17
3,2023-06-05T08:27:00+10:00,2023-06-05,08:27,2,9,11
26,2023-06-05T08:27:00+10:00,2023-06-05,08:27,5,2,7
28,2023-06-05T08:27:00+10:00,2023-06-05,08:27,15,4,19
31,2023-06-05T08:27:00+10:00,2023-06-05,08:27,4,2,6
44,2023-06-05T08:27:00+10:00,2023-06-05,08:27,0,2,2
45,2023-06-05T08:27:00+10:00,2023-06-05,08:27,3,1,4
50,2023-06-05T08:27:00+10:00,2023-06-05,08:27,1,0,1
61,2023-06-05T08:27:00+10:00,2023-06-05,08:27,3,3,6
65,2023-06-05T08:27:00+10:00,2023-06-05,08:27,4,6,10
70,2023-06-05T08:27:00+10:00,2023-06-05,08:27,1,1,2
75,2023-06-05T08:27:00+10:00,2023-06-05,08:27,0,1,1
78,2023-06-05T08:27:00+10:00,2023-06-05,08:27,1,1,2
108,2023-06-05T08:27:00+10:00,2023-06-05,08:27,1,22,23
2,2023-06-05T08:27:00+10:00,2023-06-05,08:27,2,1,3
19,2023-06-05T08:27:00+10:00,2023-06-05,08:27,1,2,3
23,2023-06-05T08:27:00+10:00,2023-06-05,08:27,9,0,9
30,2023-06-05T08:27:00+10:00,2023-06-05,08:27,2,2,4
46,2023-06-05T08:27:00+10:00,2023-06-05,08:27,0,2,2
48,2023-06-05T08:27:00+10:00,2023-06-05,08:27,0,1,1
49,2023-06-05T08:27:00+10:00,2023-06-05,08:27,0,1,1
56,2023-06-05T08:27:00+10:00,2023-06-05,08:27,1,3,4
58,2023-06-05T08:27:00+10:00,2023-06-05,08:27,15,0,15
67,2023-06-05T08:27:00+10:00,2023-06-05,08:27,7,11,18
76,2023-06-05T08:27:00+10:00,2023-06-05,08:27,1,1,2
79,2023-06-05T08:27:00+10:00,2023-06-05,08:27,9,7,16
85,2023-06-05T08:27:00+10:00,2023-06-05,08:27,1,0,1
3,2023-06-05T08:26:00+10:00,2023-06-05,08:26,0,10,10
6,2023-06-05T08:26:00+10:00,2023-06-05,08:26,15,10,25
14,2023-06-05T08:26:00+10:00,2023-06-05,08:26,5,2,7
21,2023-06-05T08:26:00+10:00,2023-06-05,08:26,0,1,1
26,2023-06-05T08:26:00+10:00,2023-06-05,08:26,5,4,9
29,2023-06-05T08:26:00+10:00,2023-06-05,08:26,1,3,4
41,2023-06-05T08:26:00+10:00,2023-06-05,08:26,49,3,52
45,2023-06-05T08:26:00+10:00,2023-06-05,08:26,3,3,6
47,2023-06-05T08:26:00+10:00,2023-06-05,08:26,1,8,9
50,2023-06-05T08:26:00+10:00,2023-06-05,08:26,0,1,1
54,2023-06-05T08:26:00+10:00,2023-06-05,08:26,3,2,5
69,2023-06-05T08:26:00+10:00,2023-06-05,08:26,4,2,6
70,2023-06-05T08:26:00+10:00,2023-06-05,08:26,0,3,3
78,2023-06-05T08:26:00+10:00,2023-06-05,08:26,0,2,2
108,2023-06-05T08:26:00+10:00,2023-06-05,08:26,7,12,19
12,2023-06-05T08:26:00+10:00,2023-06-05,08:26,5,2,7
24,2023-06-05T08:26:00+10:00,2023-06-05,08:26,40,5,45
30,2023-06-05T08:26:00+10:00,2023-06-05,08:26,0,2,2
48,2023-06-05T08:26:00+10:00,2023-06-05,08:26,1,0,1
49,2023-06-05T08:26:00+10:00,2023-06-05,08:26,0,3,3
53,2023-06-05T08:26:00+10:00,2023-06-05,08:26,8,6,14
56,2023-06-05T08:26:00+10:00,2023-06-05,08:26,1,2,3
57,2023-06-05T08:26:00+10:00,2023-06-05,08:26,6,6,12
63,2023-06-05T08:26:00+10:00,2023-06-05,08:26,0,1,1
67,2023-06-05T08:26:00+10:00,2023-06-05,08:26,6,3,9
4,2023-06-05T08:26:00+10:00,2023-06-05,08:26,10,3,13
5,2023-06-05T08:26:00+10:00,2023-06-05,08:26,2,12,14
8,2023-06-05T08:26:00+10:00,2023-06-05,08:26,2,6,8
28,2023-06-05T08:26:00+10:00,2023-06-05,08:26,12,3,15
31,2023-06-05T08:26:00+10:00,2023-06-05,08:26,4,0,4
36,2023-06-05T08:26:00+10:00,2023-06-05,08:26,9,3,12
39,2023-06-05T08:26:00+10:00,2023-06-05,08:26,1,2,3
65,2023-06-05T08:26:00+10:00,2023-06-05,08:26,7,1,8
66,2023-06-05T08:26:00+10:00,2023-06-05,08:26,0,6,6
77,2023-06-05T08:26:00+10:00,2023-06-05,08:26,3,4,7
87,2023-06-05T08:26:00+10:00,2023-06-05,08:26,2,1,3
2,2023-06-05T08:26:00+10:00,2023-06-05,08:26,3,7,10
9,2023-06-05T08:26:00+10:00,2023-06-05,08:26,1,32,33
10,2023-06-05T08:26:00+10:00,2023-06-05,08:26,0,2,2
17,2023-06-05T08:26:00+10:00,2023-06-05,08:26,8,1,9
18,2023-06-05T08:26:00+10:00,2023-06-05,08:26,0,21,21
19,2023-06-05T08:26:00+10:00,2023-06-05,08:26,0,2,2
27,2023-06-05T08:26:00+10:00,2023-06-05,08:26,2,0,2
58,2023-06-05T08:26:00+10:00,2023-06-05,08:26,26,1,27
72,2023-06-05T08:26:00+10:00,2023-06-05,08:26,9,0,9
76,2023-06-05T08:26:00+10:00,2023-06-05,08:26,2,0,2
40,2023-06-05T08:26:00+10:00,2023-06-05,08:26,3,6,9
55,2023-06-05T08:26:00+10:00,2023-06-05,08:26,0,9,9
61,2023-06-05T08:26:00+10:00,2023-06-05,08:26,0,6,6
1,2023-06-05T08:26:00+10:00,2023-06-05,08:26,4,11,15
20,2023-06-05T08:26:00+10:00,2023-06-05,08:26,0,1,1
23,2023-06-05T08:26:00+10:00,2023-06-05,08:26,3,4,7
35,2023-06-05T08:26:00+10:00,2023-06-05,08:26,5,14,19
46,2023-06-05T08:26:00+10:00,2023-06-05,08:26,0,1,1
52,2023-06-05T08:26:00+10:00,2023-06-05,08:26,2,1,3
62,2023-06-05T08:26:00+10:00,2023-06-05,08:26,0,4,4
68,2023-06-05T08:26:00+10:00,2023-06-05,08:26,2,0,2
79,2023-06-05T08:26:00+10:00,2023-06-05,08:26,8,3,11
85,2023-06-05T08:26:00+10:00,2023-06-05,08:26,4,1,5
4,2023-06-05T08:25:00+10:00,2023-06-05,08:25,6,7,13
6,2023-06-05T08:25:00+10:00,2023-06-05,08:25,14,20,34
14,2023-06-05T08:25:00+10:00,2023-06-05,08:25,3,3,6
28,2023-06-05T08:25:00+10:00,2023-06-05,08:25,12,2,14
36,2023-06-05T08:25:00+10:00,2023-06-05,08:25,1,4,5
45,2023-06-05T08:25:00+10:00,2023-06-05,08:25,2,2,4
50,2023-06-05T08:25:00+10:00,2023-06-05,08:25,2,0,2
54,2023-06-05T08:25:00+10:00,2023-06-05,08:25,3,1,4
59,2023-06-05T08:25:00+10:00,2023-06-05,08:25,32,13,45
65,2023-06-05T08:25:00+10:00,2023-06-05,08:25,3,5,8
66,2023-06-05T08:25:00+10:00,2023-06-05,08:25,4,0,4
69,2023-06-05T08:25:00+10:00,2023-06-05,08:25,2,1,3
75,2023-06-05T08:25:00+10:00,2023-06-05,08:25,2,0,2
87,2023-06-05T08:25:00+10:00,2023-06-05,08:25,4,3,7
12,2023-06-05T08:25:00+10:00,2023-06-05,08:25,4,1,5
17,2023-06-05T08:25:00+10:00,2023-06-05,08:25,39,4,43
24,2023-06-05T08:25:00+10:00,2023-06-05,08:25,53,4,57
27,2023-06-05T08:25:00+10:00,2023-06-05,08:25,2,2,4
30,2023-06-05T08:25:00+10:00,2023-06-05,08:25,0,1,1
35,2023-06-05T08:25:00+10:00,2023-06-05,08:25,4,19,23
63,2023-06-05T08:25:00+10:00,2023-06-05,08:25,1,3,4
67,2023-06-05T08:25:00+10:00,2023-06-05,08:25,4,5,9
68,2023-06-05T08:25:00+10:00,2023-06-05,08:25,3,1,4
79,2023-06-05T08:25:00+10:00,2023-06-05,08:25,3,5,8
26,2023-06-05T08:25:00+10:00,2023-06-05,08:25,6,3,9
29,2023-06-05T08:25:00+10:00,2023-06-05,08:25,3,1,4
37,2023-06-05T08:25:00+10:00,2023-06-05,08:25,1,1,2
47,2023-06-05T08:25:00+10:00,2023-06-05,08:25,3,19,22
61,2023-06-05T08:25:00+10:00,2023-06-05,08:25,1,10,11
70,2023-06-05T08:25:00+10:00,2023-06-05,08:25,0,1,1
108,2023-06-05T08:25:00+10:00,2023-06-05,08:25,3,9,12
118,2023-06-05T08:25:00+10:00,2023-06-05,08:25,2,0,2
1,2023-06-05T08:25:00+10:00,2023-06-05,08:25,1,2,3
2,2023-06-05T08:25:00+10:00,2023-06-05,08:25,4,4,8
9,2023-06-05T08:25:00+10:00,2023-06-05,08:25,0,18,18
11,2023-06-05T08:25:00+10:00,2023-06-05,08:25,6,8,14
19,2023-06-05T08:25:00+10:00,2023-06-05,08:25,4,0,4
48,2023-06-05T08:25:00+10:00,2023-06-05,08:25,1,1,2
51,2023-06-05T08:25:00+10:00,2023-06-05,08:25,3,0,3
72,2023-06-05T08:25:00+10:00,2023-06-05,08:25,7,2,9
109,2023-06-05T08:25:00+10:00,2023-06-05,08:25,10,52,62
3,2023-06-05T08:25:00+10:00,2023-06-05,08:25,5,6,11
5,2023-06-05T08:25:00+10:00,2023-06-05,08:25,6,13,19
8,2023-06-05T08:25:00+10:00,2023-06-05,08:25,1,5,6
21,2023-06-05T08:25:00+10:00,2023-06-05,08:25,1,1,2
31,2023-06-05T08:25:00+10:00,2023-06-05,08:25,0,2,2
39,2023-06-05T08:25:00+10:00,2023-06-05,08:25,4,4,8
40,2023-06-05T08:25:00+10:00,2023-06-05,08:25,5,12,17
41,2023-06-05T08:25:00+10:00,2023-06-05,08:25,19,9,28
42,2023-06-05T08:25:00+10:00,2023-06-05,08:25,0,1,1
55,2023-06-05T08:25:00+10:00,2023-06-05,08:25,10,14,24
77,2023-06-05T08:25:00+10:00,2023-06-05,08:25,3,0,3
78,2023-06-05T08:25:00+10:00,2023-06-05,08:25,2,0,2
84,2023-06-05T08:25:00+10:00,2023-06-05,08:25,105,45,150
107,2023-06-05T08:25:00+10:00,2023-06-05,08:25,7,30,37
10,2023-06-05T08:25:00+10:00,2023-06-05,08:25,1,3,4
18,2023-06-05T08:25:00+10:00,2023-06-05,08:25,1,16,17
23,2023-06-05T08:25:00+10:00,2023-06-05,08:25,13,7,20
49,2023-06-05T08:25:00+10:00,2023-06-05,08:25,0,2,2
52,2023-06-05T08:25:00+10:00,2023-06-05,08:25,12,3,15
53,2023-06-05T08:25:00+10:00,2023-06-05,08:25,12,2,14
56,2023-06-05T08:25:00+10:00,2023-06-05,08:25,5,0,5
57,2023-06-05T08:25:00+10:00,2023-06-05,08:25,7,17,24
58,2023-06-05T08:25:00+10:00,2023-06-05,08:25,26,1,27
76,2023-06-05T08:25:00+10:00,2023-06-05,08:25,2,1,3
85,2023-06-05T08:25:00+10:00,2023-06-05,08:25,3,0,3
86,2023-06-05T08:25:00+10:00,2023-06-05,08:25,1,0,1
117,2023-06-05T08:25:00+10:00,2023-06-05,08:25,25,5,30
3,2023-06-05T08:24:00+10:00,2023-06-05,08:24,2,3,5
8,2023-06-05T08:24:00+10:00,2023-06-05,08:24,1,3,4
21,2023-06-05T08:24:00+10:00,2023-06-05,08:24,2,1,3
42,2023-06-05T08:24:00+10:00,2023-06-05,08:24,0,1,1
44,2023-06-05T08:24:00+10:00,2023-06-05,08:24,1,3,4
47,2023-06-05T08:24:00+10:00,2023-06-05,08:24,9,2,11
55,2023-06-05T08:24:00+10:00,2023-06-05,08:24,1,14,15
69,2023-06-05T08:24:00+10:00,2023-06-05,08:24,5,0,5
70,2023-06-05T08:24:00+10:00,2023-06-05,08:24,2,1,3
87,2023-06-05T08:24:00+10:00,2023-06-05,08:24,3,1,4
108,2023-06-05T08:24:00+10:00,2023-06-05,08:24,3,17,20
1,2023-06-05T08:24:00+10:00,2023-06-05,08:24,3,6,9
2,2023-06-05T08:24:00+10:00,2023-06-05,08:24,5,3,8
10,2023-06-05T08:24:00+10:00,2023-06-05,08:24,0,7,7
11,2023-06-05T08:24:00+10:00,2023-06-05,08:24,1,0,1
18,2023-06-05T08:24:00+10:00,2023-06-05,08:24,1,16,17
27,2023-06-05T08:24:00+10:00,2023-06-05,08:24,1,2,3
35,2023-06-05T08:24:00+10:00,2023-06-05,08:24,3,18,21
46,2023-06-05T08:24:00+10:00,2023-06-05,08:24,0,1,1
49,2023-06-05T08:24:00+10:00,2023-06-05,08:24,0,1,1
57,2023-06-05T08:24:00+10:00,2023-06-05,08:24,4,15,19
58,2023-06-05T08:24:00+10:00,2023-06-05,08:24,4,1,5
63,2023-06-05T08:24:00+10:00,2023-06-05,08:24,5,1,6
67,2023-06-05T08:24:00+10:00,2023-06-05,08:24,4,4,8
68,2023-06-05T08:24:00+10:00,2023-06-05,08:24,1,2,3
4,2023-06-05T08:24:00+10:00,2023-06-05,08:24,9,7,16
14,2023-06-05T08:24:00+10:00,2023-06-05,08:24,7,8,15
29,2023-06-05T08:24:00+10:00,2023-06-05,08:24,6,2,8
31,2023-06-05T08:24:00+10:00,2023-06-05,08:24,0,1,1
39,2023-06-05T08:24:00+10:00,2023-06-05,08:24,2,2,4
40,2023-06-05T08:24:00+10:00,2023-06-05,08:24,2,3,5
41,2023-06-05T08:24:00+10:00,2023-06-05,08:24,39,6,45
77,2023-06-05T08:24:00+10:00,2023-06-05,08:24,0,2,2
78,2023-06-05T08:24:00+10:00,2023-06-05,08:24,1,0,1
9,2023-06-05T08:24:00+10:00,2023-06-05,08:24,2,16,18
12,2023-06-05T08:24:00+10:00,2023-06-05,08:24,2,2,4
17,2023-06-05T08:24:00+10:00,2023-06-05,08:24,20,2,22
52,2023-06-05T08:24:00+10:00,2023-06-05,08:24,0,3,3
5,2023-06-05T08:24:00+10:00,2023-06-05,08:24,10,16,26
6,2023-06-05T08:24:00+10:00,2023-06-05,08:24,8,28,36
26,2023-06-05T08:24:00+10:00,2023-06-05,08:24,4,1,5
28,2023-06-05T08:24:00+10:00,2023-06-05,08:24,7,4,11
36,2023-06-05T08:24:00+10:00,2023-06-05,08:24,4,3,7
45,2023-06-05T08:24:00+10:00,2023-06-05,08:24,4,3,7
54,2023-06-05T08:24:00+10:00,2023-06-05,08:24,0,1,1
61,2023-06-05T08:24:00+10:00,2023-06-05,08:24,1,7,8
65,2023-06-05T08:24:00+10:00,2023-06-05,08:24,7,2,9
66,2023-06-05T08:24:00+10:00,2023-06-05,08:24,3,9,12
20,2023-06-05T08:24:00+10:00,2023-06-05,08:24,3,0,3
23,2023-06-05T08:24:00+10:00,2023-06-05,08:24,2,4,6
24,2023-06-05T08:24:00+10:00,2023-06-05,08:24,7,16,23
48,2023-06-05T08:24:00+10:00,2023-06-05,08:24,3,0,3
53,2023-06-05T08:24:00+10:00,2023-06-05,08:24,7,6,13
56,2023-06-05T08:24:00+10:00,2023-06-05,08:24,4,1,5
62,2023-06-05T08:24:00+10:00,2023-06-05,08:24,0,1,1
72,2023-06-05T08:24:00+10:00,2023-06-05,08:24,10,0,10
76,2023-06-05T08:24:00+10:00,2023-06-05,08:24,2,1,3
79,2023-06-05T08:24:00+10:00,2023-06-05,08:24,14,7,21
3,2023-06-05T08:23:00+10:00,2023-06-05,08:23,8,4,12
14,2023-06-05T08:23:00+10:00,2023-06-05,08:23,5,11,16
21,2023-06-05T08:23:00+10:00,2023-06-05,08:23,3,0,3
28,2023-06-05T08:23:00+10:00,2023-06-05,08:23,17,6,23
31,2023-06-05T08:23:00+10:00,2023-06-05,08:23,1,1,2
45,2023-06-05T08:23:00+10:00,2023-06-05,08:23,6,5,11
61,2023-06-05T08:23:00+10:00,2023-06-05,08:23,1,4,5
65,2023-06-05T08:23:00+10:00,2023-06-05,08:23,15,2,17
66,2023-06-05T08:23:00+10:00,2023-06-05,08:23,4,7,11
2,2023-06-05T08:23:00+10:00,2023-06-05,08:23,1,0,1
10,2023-06-05T08:23:00+10:00,2023-06-05,08:23,2,9,11
11,2023-06-05T08:23:00+10:00,2023-06-05,08:23,1,0,1
12,2023-06-05T08:23:00+10:00,2023-06-05,08:23,1,0,1
18,2023-06-05T08:23:00+10:00,2023-06-05,08:23,2,13,15
23,2023-06-05T08:23:00+10:00,2023-06-05,08:23,12,6,18
27,2023-06-05T08:23:00+10:00,2023-06-05,08:23,1,0,1
48,2023-06-05T08:23:00+10:00,2023-06-05,08:23,1,1,2
57,2023-06-05T08:23:00+10:00,2023-06-05,08:23,2,4,6
62,2023-06-05T08:23:00+10:00,2023-06-05,08:23,1,0,1
68,2023-06-05T08:23:00+10:00,2023-06-05,08:23,4,1,5
4,2023-06-05T08:23:00+10:00,2023-06-05,08:23,8,6,14
6,2023-06-05T08:23:00+10:00,2023-06-05,08:23,6,21,27
36,2023-06-05T08:23:00+10:00,2023-06-05,08:23,8,1,9
42,2023-06-05T08:23:00+10:00,2023-06-05,08:23,3,0,3
47,2023-06-05T08:23:00+10:00,2023-06-05,08:23,2,10,12
50,2023-06-05T08:23:00+10:00,2023-06-05,08:23,0,2,2
54,2023-06-05T08:23:00+10:00,2023-06-05,08:23,3,0,3
75,2023-06-05T08:23:00+10:00,2023-06-05,08:23,2,0,2
77,2023-06-05T08:23:00+10:00,2023-06-05,08:23,1,5,6
87,2023-06-05T08:23:00+10:00,2023-06-05,08:23,1,0,1
1,2023-06-05T08:23:00+10:00,2023-06-05,08:23,3,2,5
17,2023-06-05T08:23:00+10:00,2023-06-05,08:23,10,2,12
19,2023-06-05T08:23:00+10:00,2023-06-05,08:23,0,1,1
24,2023-06-05T08:23:00+10:00,2023-06-05,08:23,46,8,54
52,2023-06-05T08:23:00+10:00,2023-06-05,08:23,3,4,7
53,2023-06-05T08:23:00+10:00,2023-06-05,08:23,7,9,16
58,2023-06-05T08:23:00+10:00,2023-06-05,08:23,31,9,40
63,2023-06-05T08:23:00+10:00,2023-06-05,08:23,4,5,9
67,2023-06-05T08:23:00+10:00,2023-06-05,08:23,4,7,11
76,2023-06-05T08:23:00+10:00,2023-06-05,08:23,2,1,3
5,2023-06-05T08:23:00+10:00,2023-06-05,08:23,4,11,15
8,2023-06-05T08:23:00+10:00,2023-06-05,08:23,2,2,4
29,2023-06-05T08:23:00+10:00,2023-06-05,08:23,3,2,5
39,2023-06-05T08:23:00+10:00,2023-06-05,08:23,5,1,6
40,2023-06-05T08:23:00+10:00,2023-06-05,08:23,2,8,10
41,2023-06-05T08:23:00+10:00,2023-06-05,08:23,7,4,11
55,2023-06-05T08:23:00+10:00,2023-06-05,08:23,4,4,8
69,2023-06-05T08:23:00+10:00,2023-06-05,08:23,6,3,9
70,2023-06-05T08:23:00+10:00,2023-06-05,08:23,1,5,6
108,2023-06-05T08:23:00+10:00,2023-06-05,08:23,3,10,13
9,2023-06-05T08:23:00+10:00,2023-06-05,08:23,0,38,38
30,2023-06-05T08:23:00+10:00,2023-06-05,08:23,4,1,5
35,2023-06-05T08:23:00+10:00,2023-06-05,08:23,9,11,20
49,2023-06-05T08:23:00+10:00,2023-06-05,08:23,0,2,2
56,2023-06-05T08:23:00+10:00,2023-06-05,08:23,1,4,5
72,2023-06-05T08:23:00+10:00,2023-06-05,08:23,3,0,3
79,2023-06-05T08:23:00+10:00,2023-06-05,08:23,4,5,9
85,2023-06-05T08:23:00+10:00,2023-06-05,08:23,1,2,3
86,2023-06-05T08:23:00+10:00,2023-06-05,08:23,1,0,1
6,2023-06-05T08:22:00+10:00,2023-06-05,08:22,7,12,19
8,2023-06-05T08:22:00+10:00,2023-06-05,08:22,2,3,5
29,2023-06-05T08:22:00+10:00,2023-06-05,08:22,0,2,2
31,2023-06-05T08:22:00+10:00,2023-06-05,08:22,2,0,2
39,2023-06-05T08:22:00+10:00,2023-06-05,08:22,2,5,7
41,2023-06-05T08:22:00+10:00,2023-06-05,08:22,35,5,40
42,2023-06-05T08:22:00+10:00,2023-06-05,08:22,5,1,6
54,2023-06-05T08:22:00+10:00,2023-06-05,08:22,4,1,5
61,2023-06-05T08:22:00+10:00,2023-06-05,08:22,3,11,14
69,2023-06-05T08:22:00+10:00,2023-06-05,08:22,3,3,6
78,2023-06-05T08:22:00+10:00,2023-06-05,08:22,1,0,1
1,2023-06-05T08:22:00+10:00,2023-06-05,08:22,4,4,8
9,2023-06-05T08:22:00+10:00,2023-06-05,08:22,2,34,36
11,2023-06-05T08:22:00+10:00,2023-06-05,08:22,1,1,2
17,2023-06-05T08:22:00+10:00,2023-06-05,08:22,6,2,8
46,2023-06-05T08:22:00+10:00,2023-06-05,08:22,2,2,4
52,2023-06-05T08:22:00+10:00,2023-06-05,08:22,2,7,9
56,2023-06-05T08:22:00+10:00,2023-06-05,08:22,1,1,2
62,2023-06-05T08:22:00+10:00,2023-06-05,08:22,1,0,1
63,2023-06-05T08:22:00+10:00,2023-06-05,08:22,2,2,4
68,2023-06-05T08:22:00+10:00,2023-06-05,08:22,1,0,1
76,2023-06-05T08:22:00+10:00,2023-06-05,08:22,2,1,3
86,2023-06-05T08:22:00+10:00,2023-06-05,08:22,0,1,1
3,2023-06-05T08:22:00+10:00,2023-06-05,08:22,1,5,6
5,2023-06-05T08:22:00+10:00,2023-06-05,08:22,3,10,13
14,2023-06-05T08:22:00+10:00,2023-06-05,08:22,6,9,15
21,2023-06-05T08:22:00+10:00,2023-06-05,08:22,1,5,6
28,2023-06-05T08:22:00+10:00,2023-06-05,08:22,6,6,12
36,2023-06-05T08:22:00+10:00,2023-06-05,08:22,3,4,7
45,2023-06-05T08:22:00+10:00,2023-06-05,08:22,2,5,7
55,2023-06-05T08:22:00+10:00,2023-06-05,08:22,4,11,15
66,2023-06-05T08:22:00+10:00,2023-06-05,08:22,3,4,7
71,2023-06-05T08:22:00+10:00,2023-06-05,08:22,1,1,2
75,2023-06-05T08:22:00+10:00,2023-06-05,08:22,2,0,2
77,2023-06-05T08:22:00+10:00,2023-06-05,08:22,3,2,5
12,2023-06-05T08:22:00+10:00,2023-06-05,08:22,2,0,2
18,2023-06-05T08:22:00+10:00,2023-06-05,08:22,3,12,15
19,2023-06-05T08:22:00+10:00,2023-06-05,08:22,1,0,1
24,2023-06-05T08:22:00+10:00,2023-06-05,08:22,22,8,30
27,2023-06-05T08:22:00+10:00,2023-06-05,08:22,1,4,5
30,2023-06-05T08:22:00+10:00,2023-06-05,08:22,1,6,7
48,2023-06-05T08:22:00+10:00,2023-06-05,08:22,2,3,5
51,2023-06-05T08:22:00+10:00,2023-06-05,08:22,0,2,2
53,2023-06-05T08:22:00+10:00,2023-06-05,08:22,8,1,9
67,2023-06-05T08:22:00+10:00,2023-06-05,08:22,5,10,15
85,2023-06-05T08:22:00+10:00,2023-06-05,08:22,2,2,4
4,2023-06-05T08:22:00+10:00,2023-06-05,08:22,12,12,24
26,2023-06-05T08:22:00+10:00,2023-06-05,08:22,3,0,3
37,2023-06-05T08:22:00+10:00,2023-06-05,08:22,1,0,1
40,2023-06-05T08:22:00+10:00,2023-06-05,08:22,2,3,5
47,2023-06-05T08:22:00+10:00,2023-06-05,08:22,2,15,17
50,2023-06-05T08:22:00+10:00,2023-06-05,08:22,0,1,1
65,2023-06-05T08:22:00+10:00,2023-06-05,08:22,18,2,20
87,2023-06-05T08:22:00+10:00,2023-06-05,08:22,0,2,2
108,2023-06-05T08:22:00+10:00,2023-06-05,08:22,2,13,15
2,2023-06-05T08:22:00+10:00,2023-06-05,08:22,3,1,4
10,2023-06-05T08:22:00+10:00,2023-06-05,08:22,1,5,6
23,2023-06-05T08:22:00+10:00,2023-06-05,08:22,12,3,15
35,2023-06-05T08:22:00+10:00,2023-06-05,08:22,5,21,26
57,2023-06-05T08:22:00+10:00,2023-06-05,08:22,3,12,15
58,2023-06-05T08:22:00+10:00,2023-06-05,08:22,34,2,36
72,2023-06-05T08:22:00+10:00,2023-06-05,08:22,11,1,12
79,2023-06-05T08:22:00+10:00,2023-06-05,08:22,26,4,30
6,2023-06-05T08:21:00+10:00,2023-06-05,08:21,4,13,17
8,2023-06-05T08:21:00+10:00,2023-06-05,08:21,4,4,8
14,2023-06-05T08:21:00+10:00,2023-06-05,08:21,6,3,9
26,2023-06-05T08:21:00+10:00,2023-06-05,08:21,3,5,8
28,2023-06-05T08:21:00+10:00,2023-06-05,08:21,8,8,16
29,2023-06-05T08:21:00+10:00,2023-06-05,08:21,1,0,1
47,2023-06-05T08:21:00+10:00,2023-06-05,08:21,4,5,9
66,2023-06-05T08:21:00+10:00,2023-06-05,08:21,2,6,8
70,2023-06-05T08:21:00+10:00,2023-06-05,08:21,2,0,2
108,2023-06-05T08:21:00+10:00,2023-06-05,08:21,1,15,16
2,2023-06-05T08:21:00+10:00,2023-06-05,08:21,3,3,6
12,2023-06-05T08:21:00+10:00,2023-06-05,08:21,2,0,2
17,2023-06-05T08:21:00+10:00,2023-06-05,08:21,3,3,6
18,2023-06-05T08:21:00+10:00,2023-06-05,08:21,2,11,13
19,2023-06-05T08:21:00+10:00,2023-06-05,08:21,1,2,3
46,2023-06-05T08:21:00+10:00,2023-06-05,08:21,0,1,1
52,2023-06-05T08:21:00+10:00,2023-06-05,08:21,17,5,22
56,2023-06-05T08:21:00+10:00,2023-06-05,08:21,1,2,3
58,2023-06-05T08:21:00+10:00,2023-06-05,08:21,17,0,17
63,2023-06-05T08:21:00+10:00,2023-06-05,08:21,1,2,3
3,2023-06-05T08:21:00+10:00,2023-06-05,08:21,3,5,8
5,2023-06-05T08:21:00+10:00,2023-06-05,08:21,12,23,35
21,2023-06-05T08:21:00+10:00,2023-06-05,08:21,1,2,3
31,2023-06-05T08:21:00+10:00,2023-06-05,08:21,1,1,2
36,2023-06-05T08:21:00+10:00,2023-06-05,08:21,3,1,4
40,2023-06-05T08:21:00+10:00,2023-06-05,08:21,4,3,7
45,2023-06-05T08:21:00+10:00,2023-06-05,08:21,3,12,15
55,2023-06-05T08:21:00+10:00,2023-06-05,08:21,6,5,11
61,2023-06-05T08:21:00+10:00,2023-06-05,08:21,0,1,1
65,2023-06-05T08:21:00+10:00,2023-06-05,08:21,2,2,4
69,2023-06-05T08:21:00+10:00,2023-06-05,08:21,2,0,2
75,2023-06-05T08:21:00+10:00,2023-06-05,08:21,1,2,3
78,2023-06-05T08:21:00+10:00,2023-06-05,08:21,1,1,2
87,2023-06-05T08:21:00+10:00,2023-06-05,08:21,4,1,5
23,2023-06-05T08:21:00+10:00,2023-06-05,08:21,3,1,4
30,2023-06-05T08:21:00+10:00,2023-06-05,08:21,1,0,1
48,2023-06-05T08:21:00+10:00,2023-06-05,08:21,1,0,1
51,2023-06-05T08:21:00+10:00,2023-06-05,08:21,1,0,1
57,2023-06-05T08:21:00+10:00,2023-06-05,08:21,2,16,18
67,2023-06-05T08:21:00+10:00,2023-06-05,08:21,5,3,8
72,2023-06-05T08:21:00+10:00,2023-06-05,08:21,26,4,30
79,2023-06-05T08:21:00+10:00,2023-06-05,08:21,8,11,19
4,2023-06-05T08:21:00+10:00,2023-06-05,08:21,5,2,7
37,2023-06-05T08:21:00+10:00,2023-06-05,08:21,2,0,2
39,2023-06-05T08:21:00+10:00,2023-06-05,08:21,3,2,5
41,2023-06-05T08:21:00+10:00,2023-06-05,08:21,41,4,45
50,2023-06-05T08:21:00+10:00,2023-06-05,08:21,1,2,3
77,2023-06-05T08:21:00+10:00,2023-06-05,08:21,1,0,1
1,2023-06-05T08:21:00+10:00,2023-06-05,08:21,4,5,9
9,2023-06-05T08:21:00+10:00,2023-06-05,08:21,1,18,19
10,2023-06-05T08:21:00+10:00,2023-06-05,08:21,3,1,4
24,2023-06-05T08:21:00+10:00,2023-06-05,08:21,24,3,27
35,2023-06-05T08:21:00+10:00,2023-06-05,08:21,5,25,30
53,2023-06-05T08:21:00+10:00,2023-06-05,08:21,2,9,11
62,2023-06-05T08:21:00+10:00,2023-06-05,08:21,1,1,2
68,2023-06-05T08:21:00+10:00,2023-06-05,08:21,1,2,3
76,2023-06-05T08:21:00+10:00,2023-06-05,08:21,2,0,2
85,2023-06-05T08:21:00+10:00,2023-06-05,08:21,0,1,1
3,2023-06-05T08:20:00+10:00,2023-06-05,08:20,3,3,6
5,2023-06-05T08:20:00+10:00,2023-06-05,08:20,6,15,21
29,2023-06-05T08:20:00+10:00,2023-06-05,08:20,3,0,3
41,2023-06-05T08:20:00+10:00,2023-06-05,08:20,67,6,73
65,2023-06-05T08:20:00+10:00,2023-06-05,08:20,13,3,16
71,2023-06-05T08:20:00+10:00,2023-06-05,08:20,1,0,1
87,2023-06-05T08:20:00+10:00,2023-06-05,08:20,1,0,1
9,2023-06-05T08:20:00+10:00,2023-06-05,08:20,1,46,47
10,2023-06-05T08:20:00+10:00,2023-06-05,08:20,0,5,5
12,2023-06-05T08:20:00+10:00,2023-06-05,08:20,1,2,3
17,2023-06-05T08:20:00+10:00,2023-06-05,08:20,8,1,9
46,2023-06-05T08:20:00+10:00,2023-06-05,08:20,0,3,3
48,2023-06-05T08:20:00+10:00,2023-06-05,08:20,1,3,4
52,2023-06-05T08:20:00+10:00,2023-06-05,08:20,5,0,5
63,2023-06-05T08:20:00+10:00,2023-06-05,08:20,0,2,2
67,2023-06-05T08:20:00+10:00,2023-06-05,08:20,8,3,11
68,2023-06-05T08:20:00+10:00,2023-06-05,08:20,1,1,2
85,2023-06-05T08:20:00+10:00,2023-06-05,08:20,5,0,5
6,2023-06-05T08:20:00+10:00,2023-06-05,08:20,17,25,42
14,2023-06-05T08:20:00+10:00,2023-06-05,08:20,3,8,11
21,2023-06-05T08:20:00+10:00,2023-06-05,08:20,1,3,4
31,2023-06-05T08:20:00+10:00,2023-06-05,08:20,0,1,1
47,2023-06-05T08:20:00+10:00,2023-06-05,08:20,5,19,24
54,2023-06-05T08:20:00+10:00,2023-06-05,08:20,5,0,5
59,2023-06-05T08:20:00+10:00,2023-06-05,08:20,27,6,33
61,2023-06-05T08:20:00+10:00,2023-06-05,08:20,3,4,7
69,2023-06-05T08:20:00+10:00,2023-06-05,08:20,4,0,4
70,2023-06-05T08:20:00+10:00,2023-06-05,08:20,0,2,2
75,2023-06-05T08:20:00+10:00,2023-06-05,08:20,2,2,4
77,2023-06-05T08:20:00+10:00,2023-06-05,08:20,1,0,1
84,2023-06-05T08:20:00+10:00,2023-06-05,08:20,113,27,140
108,2023-06-05T08:20:00+10:00,2023-06-05,08:20,5,21,26
11,2023-06-05T08:20:00+10:00,2023-06-05,08:20,6,1,7
19,2023-06-05T08:20:00+10:00,2023-06-05,08:20,0,3,3
23,2023-06-05T08:20:00+10:00,2023-06-05,08:20,14,7,21
24,2023-06-05T08:20:00+10:00,2023-06-05,08:20,55,1,56
51,2023-06-05T08:20:00+10:00,2023-06-05,08:20,1,0,1
56,2023-06-05T08:20:00+10:00,2023-06-05,08:20,1,4,5
57,2023-06-05T08:20:00+10:00,2023-06-05,08:20,1,6,7
58,2023-06-05T08:20:00+10:00,2023-06-05,08:20,40,9,49
62,2023-06-05T08:20:00+10:00,2023-06-05,08:20,0,3,3
72,2023-06-05T08:20:00+10:00,2023-06-05,08:20,17,2,19
79,2023-06-05T08:20:00+10:00,2023-06-05,08:20,10,11,21
117,2023-06-05T08:20:00+10:00,2023-06-05,08:20,27,5,32
4,2023-06-05T08:20:00+10:00,2023-06-05,08:20,9,4,13
26,2023-06-05T08:20:00+10:00,2023-06-05,08:20,1,0,1
28,2023-06-05T08:20:00+10:00,2023-06-05,08:20,8,4,12
36,2023-06-05T08:20:00+10:00,2023-06-05,08:20,5,0,5
39,2023-06-05T08:20:00+10:00,2023-06-05,08:20,4,0,4
40,2023-06-05T08:20:00+10:00,2023-06-05,08:20,1,1,2
42,2023-06-05T08:20:00+10:00,2023-06-05,08:20,4,2,6
44,2023-06-05T08:20:00+10:00,2023-06-05,08:20,0,2,2
45,2023-06-05T08:20:00+10:00,2023-06-05,08:20,3,5,8
50,2023-06-05T08:20:00+10:00,2023-06-05,08:20,0,1,1
55,2023-06-05T08:20:00+10:00,2023-06-05,08:20,2,10,12
66,2023-06-05T08:20:00+10:00,2023-06-05,08:20,4,15,19
107,2023-06-05T08:20:00+10:00,2023-06-05,08:20,4,18,22
118,2023-06-05T08:20:00+10:00,2023-06-05,08:20,0,1,1
1,2023-06-05T08:20:00+10:00,2023-06-05,08:20,3,2,5
2,2023-06-05T08:20:00+10:00,2023-06-05,08:20,0,2,2
18,2023-06-05T08:20:00+10:00,2023-06-05,08:20,1,6,7
27,2023-06-05T08:20:00+10:00,2023-06-05,08:20,0,2,2
30,2023-06-05T08:20:00+10:00,2023-06-05,08:20,1,0,1
35,2023-06-05T08:20:00+10:00,2023-06-05,08:20,5,24,29
53,2023-06-05T08:20:00+10:00,2023-06-05,08:20,4,4,8
109,2023-06-05T08:20:00+10:00,2023-06-05,08:20,14,55,69
8,2023-06-05T08:19:00+10:00,2023-06-05,08:19,0,2,2
14,2023-06-05T08:19:00+10:00,2023-06-05,08:19,8,5,13
21,2023-06-05T08:19:00+10:00,2023-06-05,08:19,1,3,4
26,2023-06-05T08:19:00+10:00,2023-06-05,08:19,2,1,3
29,2023-06-05T08:19:00+10:00,2023-06-05,08:19,1,4,5
36,2023-06-05T08:19:00+10:00,2023-06-05,08:19,2,4,6
37,2023-06-05T08:19:00+10:00,2023-06-05,08:19,0,5,5
42,2023-06-05T08:19:00+10:00,2023-06-05,08:19,2,3,5
50,2023-06-05T08:19:00+10:00,2023-06-05,08:19,0,2,2
70,2023-06-05T08:19:00+10:00,2023-06-05,08:19,3,0,3
2,2023-06-05T08:19:00+10:00,2023-06-05,08:19,1,4,5
10,2023-06-05T08:19:00+10:00,2023-06-05,08:19,2,9,11
12,2023-06-05T08:19:00+10:00,2023-06-05,08:19,2,2,4
24,2023-06-05T08:19:00+10:00,2023-06-05,08:19,5,6,11
27,2023-06-05T08:19:00+10:00,2023-06-05,08:19,2,2,4
53,2023-06-05T08:19:00+10:00,2023-06-05,08:19,4,8,12
56,2023-06-05T08:19:00+10:00,2023-06-05,08:19,0,1,1
58,2023-06-05T08:19:00+10:00,2023-06-05,08:19,18,1,19
68,2023-06-05T08:19:00+10:00,2023-06-05,08:19,0,2,2
85,2023-06-05T08:19:00+10:00,2023-06-05,08:19,0,1,1
86,2023-06-05T08:19:00+10:00,2023-06-05,08:19,1,0,1
40,2023-06-05T08:19:00+10:00,2023-06-05,08:19,2,2,4
41,2023-06-05T08:19:00+10:00,2023-06-05,08:19,36,4,40
45,2023-06-05T08:19:00+10:00,2023-06-05,08:19,1,4,5
47,2023-06-05T08:19:00+10:00,2023-06-05,08:19,3,3,6
55,2023-06-05T08:19:00+10:00,2023-06-05,08:19,10,12,22
69,2023-06-05T08:19:00+10:00,2023-06-05,08:19,2,1,3
77,2023-06-05T08:19:00+10:00,2023-06-05,08:19,1,1,2
78,2023-06-05T08:19:00+10:00,2023-06-05,08:19,1,0,1
9,2023-06-05T08:19:00+10:00,2023-06-05,08:19,0,49,49
11,2023-06-05T08:19:00+10:00,2023-06-05,08:19,2,0,2
17,2023-06-05T08:19:00+10:00,2023-06-05,08:19,6,4,10
18,2023-06-05T08:19:00+10:00,2023-06-05,08:19,3,2,5
19,2023-06-05T08:19:00+10:00,2023-06-05,08:19,1,0,1
20,2023-06-05T08:19:00+10:00,2023-06-05,08:19,0,1,1
46,2023-06-05T08:19:00+10:00,2023-06-05,08:19,1,2,3
48,2023-06-05T08:19:00+10:00,2023-06-05,08:19,2,1,3
51,2023-06-05T08:19:00+10:00,2023-06-05,08:19,0,1,1
57,2023-06-05T08:19:00+10:00,2023-06-05,08:19,3,20,23
63,2023-06-05T08:19:00+10:00,2023-06-05,08:19,3,2,5
3,2023-06-05T08:19:00+10:00,2023-06-05,08:19,1,1,2
4,2023-06-05T08:19:00+10:00,2023-06-05,08:19,4,3,7
5,2023-06-05T08:19:00+10:00,2023-06-05,08:19,9,17,26
6,2023-06-05T08:19:00+10:00,2023-06-05,08:19,18,35,53
28,2023-06-05T08:19:00+10:00,2023-06-05,08:19,4,4,8
31,2023-06-05T08:19:00+10:00,2023-06-05,08:19,1,1,2
39,2023-06-05T08:19:00+10:00,2023-06-05,08:19,8,6,14
54,2023-06-05T08:19:00+10:00,2023-06-05,08:19,2,2,4
61,2023-06-05T08:19:00+10:00,2023-06-05,08:19,7,4,11
65,2023-06-05T08:19:00+10:00,2023-06-05,08:19,10,3,13
66,2023-06-05T08:19:00+10:00,2023-06-05,08:19,2,2,4
75,2023-06-05T08:19:00+10:00,2023-06-05,08:19,0,1,1
87,2023-06-05T08:19:00+10:00,2023-06-05,08:19,4,0,4
108,2023-06-05T08:19:00+10:00,2023-06-05,08:19,2,41,43
1,2023-06-05T08:19:00+10:00,2023-06-05,08:19,2,2,4
23,2023-06-05T08:19:00+10:00,2023-06-05,08:19,4,4,8
30,2023-06-05T08:19:00+10:00,2023-06-05,08:19,2,0,2
35,2023-06-05T08:19:00+10:00,2023-06-05,08:19,5,19,24
49,2023-06-05T08:19:00+10:00,2023-06-05,08:19,1,0,1
52,2023-06-05T08:19:00+10:00,2023-06-05,08:19,1,8,9
62,2023-06-05T08:19:00+10:00,2023-06-05,08:19,0,1,1
67,2023-06-05T08:19:00+10:00,2023-06-05,08:19,3,6,9
72,2023-06-05T08:19:00+10:00,2023-06-05,08:19,5,2,7
79,2023-06-05T08:19:00+10:00,2023-06-05,08:19,24,5,29
3,2023-06-05T08:18:00+10:00,2023-06-05,08:18,4,4,8
4,2023-06-05T08:18:00+10:00,2023-06-05,08:18,3,2,5
5,2023-06-05T08:18:00+10:00,2023-06-05,08:18,2,15,17
8,2023-06-05T08:18:00+10:00,2023-06-05,08:18,3,2,5
26,2023-06-05T08:18:00+10:00,2023-06-05,08:18,3,2,5
42,2023-06-05T08:18:00+10:00,2023-06-05,08:18,8,3,11
47,2023-06-05T08:18:00+10:00,2023-06-05,08:18,5,10,15
55,2023-06-05T08:18:00+10:00,2023-06-05,08:18,10,6,16
65,2023-06-05T08:18:00+10:00,2023-06-05,08:18,5,2,7
69,2023-06-05T08:18:00+10:00,2023-06-05,08:18,2,0,2
70,2023-06-05T08:18:00+10:00,2023-06-05,08:18,1,0,1
12,2023-06-05T08:18:00+10:00,2023-06-05,08:18,0,3,3
18,2023-06-05T08:18:00+10:00,2023-06-05,08:18,2,21,23
23,2023-06-05T08:18:00+10:00,2023-06-05,08:18,17,6,23
35,2023-06-05T08:18:00+10:00,2023-06-05,08:18,5,18,23
46,2023-06-05T08:18:00+10:00,2023-06-05,08:18,1,1,2
48,2023-06-05T08:18:00+10:00,2023-06-05,08:18,4,0,4
53,2023-06-05T08:18:00+10:00,2023-06-05,08:18,3,3,6
67,2023-06-05T08:18:00+10:00,2023-06-05,08:18,2,5,7
6,2023-06-05T08:18:00+10:00,2023-06-05,08:18,6,15,21
28,2023-06-05T08:18:00+10:00,2023-06-05,08:18,2,5,7
29,2023-06-05T08:18:00+10:00,2023-06-05,08:18,0,1,1
31,2023-06-05T08:18:00+10:00,2023-06-05,08:18,0,1,1
36,2023-06-05T08:18:00+10:00,2023-06-05,08:18,5,4,9
39,2023-06-05T08:18:00+10:00,2023-06-05,08:18,5,3,8
41,2023-06-05T08:18:00+10:00,2023-06-05,08:18,15,3,18
45,2023-06-05T08:18:00+10:00,2023-06-05,08:18,7,1,8
54,2023-06-05T08:18:00+10:00,2023-06-05,08:18,0,3,3
71,2023-06-05T08:18:00+10:00,2023-06-05,08:18,1,0,1
78,2023-06-05T08:18:00+10:00,2023-06-05,08:18,2,0,2
1,2023-06-05T08:18:00+10:00,2023-06-05,08:18,4,2,6
10,2023-06-05T08:18:00+10:00,2023-06-05,08:18,2,7,9
27,2023-06-05T08:18:00+10:00,2023-06-05,08:18,2,0,2
49,2023-06-05T08:18:00+10:00,2023-06-05,08:18,2,1,3
52,2023-06-05T08:18:00+10:00,2023-06-05,08:18,0,2,2
63,2023-06-05T08:18:00+10:00,2023-06-05,08:18,1,0,1
68,2023-06-05T08:18:00+10:00,2023-06-05,08:18,2,1,3
79,2023-06-05T08:18:00+10:00,2023-06-05,08:18,3,5,8
86,2023-06-05T08:18:00+10:00,2023-06-05,08:18,0,1,1
14,2023-06-05T08:18:00+10:00,2023-06-05,08:18,1,5,6
21,2023-06-05T08:18:00+10:00,2023-06-05,08:18,2,2,4
40,2023-06-05T08:18:00+10:00,2023-06-05,08:18,3,4,7
61,2023-06-05T08:18:00+10:00,2023-06-05,08:18,6,2,8
66,2023-06-05T08:18:00+10:00,2023-06-05,08:18,2,8,10
77,2023-06-05T08:18:00+10:00,2023-06-05,08:18,2,1,3
108,2023-06-05T08:18:00+10:00,2023-06-05,08:18,3,15,18
2,2023-06-05T08:18:00+10:00,2023-06-05,08:18,3,1,4
9,2023-06-05T08:18:00+10:00,2023-06-05,08:18,2,17,19
17,2023-06-05T08:18:00+10:00,2023-06-05,08:18,16,2,18
24,2023-06-05T08:18:00+10:00,2023-06-05,08:18,51,5,56
30,2023-06-05T08:18:00+10:00,2023-06-05,08:18,0,2,2
57,2023-06-05T08:18:00+10:00,2023-06-05,08:18,2,23,25
58,2023-06-05T08:18:00+10:00,2023-06-05,08:18,32,6,38
62,2023-06-05T08:18:00+10:00,2023-06-05,08:18,1,3,4
72,2023-06-05T08:18:00+10:00,2023-06-05,08:18,2,3,5
76,2023-06-05T08:18:00+10:00,2023-06-05,08:18,2,0,2
8,2023-06-05T08:17:00+10:00,2023-06-05,08:17,4,4,8
28,2023-06-05T08:17:00+10:00,2023-06-05,08:17,6,8,14
29,2023-06-05T08:17:00+10:00,2023-06-05,08:17,2,1,3
39,2023-06-05T08:17:00+10:00,2023-06-05,08:17,0,3,3
40,2023-06-05T08:17:00+10:00,2023-06-05,08:17,1,5,6
47,2023-06-05T08:17:00+10:00,2023-06-05,08:17,2,15,17
70,2023-06-05T08:17:00+10:00,2023-06-05,08:17,1,1,2
75,2023-06-05T08:17:00+10:00,2023-06-05,08:17,1,0,1
108,2023-06-05T08:17:00+10:00,2023-06-05,08:17,2,57,59
1,2023-06-05T08:17:00+10:00,2023-06-05,08:17,5,4,9
9,2023-06-05T08:17:00+10:00,2023-06-05,08:17,1,32,33
10,2023-06-05T08:17:00+10:00,2023-06-05,08:17,0,1,1
11,2023-06-05T08:17:00+10:00,2023-06-05,08:17,1,0,1
23,2023-06-05T08:17:00+10:00,2023-06-05,08:17,6,2,8
24,2023-06-05T08:17:00+10:00,2023-06-05,08:17,34,6,40
27,2023-06-05T08:17:00+10:00,2023-06-05,08:17,3,1,4
30,2023-06-05T08:17:00+10:00,2023-06-05,08:17,0,1,1
52,2023-06-05T08:17:00+10:00,2023-06-05,08:17,2,1,3
57,2023-06-05T08:17:00+10:00,2023-06-05,08:17,7,10,17
63,2023-06-05T08:17:00+10:00,2023-06-05,08:17,2,3,5
72,2023-06-05T08:17:00+10:00,2023-06-05,08:17,2,2,4
76,2023-06-05T08:17:00+10:00,2023-06-05,08:17,2,0,2
79,2023-06-05T08:17:00+10:00,2023-06-05,08:17,5,5,10
4,2023-06-05T08:17:00+10:00,2023-06-05,08:17,6,3,9
6,2023-06-05T08:17:00+10:00,2023-06-05,08:17,13,27,40
14,2023-06-05T08:17:00+10:00,2023-06-05,08:17,7,4,11
21,2023-06-05T08:17:00+10:00,2023-06-05,08:17,1,2,3
36,2023-06-05T08:17:00+10:00,2023-06-05,08:17,8,1,9
42,2023-06-05T08:17:00+10:00,2023-06-05,08:17,1,3,4
44,2023-06-05T08:17:00+10:00,2023-06-05,08:17,0,1,1
55,2023-06-05T08:17:00+10:00,2023-06-05,08:17,4,3,7
66,2023-06-05T08:17:00+10:00,2023-06-05,08:17,5,6,11
78,2023-06-05T08:17:00+10:00,2023-06-05,08:17,1,0,1
2,2023-06-05T08:17:00+10:00,2023-06-05,08:17,1,6,7
12,2023-06-05T08:17:00+10:00,2023-06-05,08:17,0,1,1
17,2023-06-05T08:17:00+10:00,2023-06-05,08:17,16,2,18
18,2023-06-05T08:17:00+10:00,2023-06-05,08:17,0,24,24
20,2023-06-05T08:17:00+10:00,2023-06-05,08:17,0,1,1
35,2023-06-05T08:17:00+10:00,2023-06-05,08:17,9,16,25
62,2023-06-05T08:17:00+10:00,2023-06-05,08:17,1,1,2
86,2023-06-05T08:17:00+10:00,2023-06-05,08:17,2,0,2
3,2023-06-05T08:17:00+10:00,2023-06-05,08:17,1,4,5
5,2023-06-05T08:17:00+10:00,2023-06-05,08:17,3,11,14
26,2023-06-05T08:17:00+10:00,2023-06-05,08:17,2,3,5
31,2023-06-05T08:17:00+10:00,2023-06-05,08:17,1,0,1
41,2023-06-05T08:17:00+10:00,2023-06-05,08:17,5,10,15
45,2023-06-05T08:17:00+10:00,2023-06-05,08:17,3,3,6
50,2023-06-05T08:17:00+10:00,2023-06-05,08:17,0,1,1
54,2023-06-05T08:17:00+10:00,2023-06-05,08:17,2,0,2
61,2023-06-05T08:17:00+10:00,2023-06-05,08:17,3,7,10
65,2023-06-05T08:17:00+10:00,2023-06-05,08:17,0,1,1
87,2023-06-05T08:17:00+10:00,2023-06-05,08:17,1,2,3
19,2023-06-05T08:17:00+10:00,2023-06-05,08:17,0,2,2
46,2023-06-05T08:17:00+10:00,2023-06-05,08:17,1,1,2
53,2023-06-05T08:17:00+10:00,2023-06-05,08:17,3,7,10
58,2023-06-05T08:17:00+10:00,2023-06-05,08:17,12,1,13
67,2023-06-05T08:17:00+10:00,2023-06-05,08:17,5,3,8
68,2023-06-05T08:17:00+10:00,2023-06-05,08:17,1,4,5
85,2023-06-05T08:17:00+10:00,2023-06-05,08:17,1,1,2
8,2023-06-05T08:16:00+10:00,2023-06-05,08:16,3,2,5
39,2023-06-05T08:16:00+10:00,2023-06-05,08:16,3,1,4
40,2023-06-05T08:16:00+10:00,2023-06-05,08:16,1,9,10
42,2023-06-05T08:16:00+10:00,2023-06-05,08:16,2,4,6
54,2023-06-05T08:16:00+10:00,2023-06-05,08:16,4,2,6
61,2023-06-05T08:16:00+10:00,2023-06-05,08:16,0,9,9
65,2023-06-05T08:16:00+10:00,2023-06-05,08:16,4,5,9
75,2023-06-05T08:16:00+10:00,2023-06-05,08:16,3,2,5
77,2023-06-05T08:16:00+10:00,2023-06-05,08:16,2,1,3
87,2023-06-05T08:16:00+10:00,2023-06-05,08:16,0,1,1
1,2023-06-05T08:16:00+10:00,2023-06-05,08:16,2,5,7
2,2023-06-05T08:16:00+10:00,2023-06-05,08:16,2,4,6
17,2023-06-05T08:16:00+10:00,2023-06-05,08:16,13,2,15
20,2023-06-05T08:16:00+10:00,2023-06-05,08:16,2,1,3
24,2023-06-05T08:16:00+10:00,2023-06-05,08:16,40,11,51
48,2023-06-05T08:16:00+10:00,2023-06-05,08:16,0,2,2
51,2023-06-05T08:16:00+10:00,2023-06-05,08:16,2,1,3
67,2023-06-05T08:16:00+10:00,2023-06-05,08:16,4,6,10
68,2023-06-05T08:16:00+10:00,2023-06-05,08:16,2,1,3
79,2023-06-05T08:16:00+10:00,2023-06-05,08:16,10,2,12
4,2023-06-05T08:16:00+10:00,2023-06-05,08:16,10,5,15
5,2023-06-05T08:16:00+10:00,2023-06-05,08:16,5,6,11
6,2023-06-05T08:16:00+10:00,2023-06-05,08:16,13,27,40
21,2023-06-05T08:16:00+10:00,2023-06-05,08:16,0,3,3
31,2023-06-05T08:16:00+10:00,2023-06-05,08:16,0,2,2
44,2023-06-05T08:16:00+10:00,2023-06-05,08:16,0,1,1
45,2023-06-05T08:16:00+10:00,2023-06-05,08:16,1,4,5
50,2023-06-05T08:16:00+10:00,2023-06-05,08:16,1,0,1
55,2023-06-05T08:16:00+10:00,2023-06-05,08:16,5,9,14
66,2023-06-05T08:16:00+10:00,2023-06-05,08:16,0,1,1
69,2023-06-05T08:16:00+10:00,2023-06-05,08:16,0,1,1
78,2023-06-05T08:16:00+10:00,2023-06-05,08:16,1,0,1
108,2023-06-05T08:16:00+10:00,2023-06-05,08:16,1,30,31
9,2023-06-05T08:16:00+10:00,2023-06-05,08:16,1,52,53
23,2023-06-05T08:16:00+10:00,2023-06-05,08:16,13,3,16
27,2023-06-05T08:16:00+10:00,2023-06-05,08:16,0,4,4
30,2023-06-05T08:16:00+10:00,2023-06-05,08:16,2,1,3
35,2023-06-05T08:16:00+10:00,2023-06-05,08:16,4,12,16
49,2023-06-05T08:16:00+10:00,2023-06-05,08:16,1,0,1
53,2023-06-05T08:16:00+10:00,2023-06-05,08:16,7,2,9
56,2023-06-05T08:16:00+10:00,2023-06-05,08:16,0,1,1
72,2023-06-05T08:16:00+10:00,2023-06-05,08:16,4,0,4
85,2023-06-05T08:16:00+10:00,2023-06-05,08:16,1,1,2
3,2023-06-05T08:16:00+10:00,2023-06-05,08:16,4,4,8
14,2023-06-05T08:16:00+10:00,2023-06-05,08:16,3,7,10
26,2023-06-05T08:16:00+10:00,2023-06-05,08:16,0,2,2
28,2023-06-05T08:16:00+10:00,2023-06-05,08:16,5,3,8
29,2023-06-05T08:16:00+10:00,2023-06-05,08:16,1,2,3
36,2023-06-05T08:16:00+10:00,2023-06-05,08:16,3,2,5
37,2023-06-05T08:16:00+10:00,2023-06-05,08:16,0,1,1
41,2023-06-05T08:16:00+10:00,2023-06-05,08:16,8,5,13
47,2023-06-05T08:16:00+10:00,2023-06-05,08:16,1,16,17
70,2023-06-05T08:16:00+10:00,2023-06-05,08:16,2,0,2
71,2023-06-05T08:16:00+10:00,2023-06-05,08:16,0,3,3
18,2023-06-05T08:16:00+10:00,2023-06-05,08:16,0,7,7
19,2023-06-05T08:16:00+10:00,2023-06-05,08:16,3,2,5
46,2023-06-05T08:16:00+10:00,2023-06-05,08:16,2,2,4
52,2023-06-05T08:16:00+10:00,2023-06-05,08:16,1,4,5
57,2023-06-05T08:16:00+10:00,2023-06-05,08:16,5,6,11
58,2023-06-05T08:16:00+10:00,2023-06-05,08:16,20,1,21
62,2023-06-05T08:16:00+10:00,2023-06-05,08:16,0,2,2
63,2023-06-05T08:16:00+10:00,2023-06-05,08:16,2,4,6
6,2023-06-05T08:15:00+10:00,2023-06-05,08:15,5,5,10
8,2023-06-05T08:15:00+10:00,2023-06-05,08:15,5,3,8
36,2023-06-05T08:15:00+10:00,2023-06-05,08:15,6,1,7
40,2023-06-05T08:15:00+10:00,2023-06-05,08:15,1,3,4
44,2023-06-05T08:15:00+10:00,2023-06-05,08:15,1,0,1
61,2023-06-05T08:15:00+10:00,2023-06-05,08:15,2,2,4
66,2023-06-05T08:15:00+10:00,2023-06-05,08:15,1,13,14
69,2023-06-05T08:15:00+10:00,2023-06-05,08:15,1,0,1
70,2023-06-05T08:15:00+10:00,2023-06-05,08:15,5,0,5
84,2023-06-05T08:15:00+10:00,2023-06-05,08:15,67,22,89
9,2023-06-05T08:15:00+10:00,2023-06-05,08:15,1,20,21
10,2023-06-05T08:15:00+10:00,2023-06-05,08:15,0,5,5
17,2023-06-05T08:15:00+10:00,2023-06-05,08:15,20,3,23
18,2023-06-05T08:15:00+10:00,2023-06-05,08:15,0,13,13
20,2023-06-05T08:15:00+10:00,2023-06-05,08:15,1,0,1
23,2023-06-05T08:15:00+10:00,2023-06-05,08:15,15,4,19
49,2023-06-05T08:15:00+10:00,2023-06-05,08:15,2,0,2
56,2023-06-05T08:15:00+10:00,2023-06-05,08:15,3,0,3
79,2023-06-05T08:15:00+10:00,2023-06-05,08:15,13,7,20
117,2023-06-05T08:15:00+10:00,2023-06-05,08:15,28,8,36
3,2023-06-05T08:15:00+10:00,2023-06-05,08:15,0,8,8
4,2023-06-05T08:15:00+10:00,2023-06-05,08:15,15,4,19
14,2023-06-05T08:15:00+10:00,2023-06-05,08:15,6,10,16
21,2023-06-05T08:15:00+10:00,2023-06-05,08:15,3,0,3
29,2023-06-05T08:15:00+10:00,2023-06-05,08:15,1,0,1
37,2023-06-05T08:15:00+10:00,2023-06-05,08:15,0,2,2
41,2023-06-05T08:15:00+10:00,2023-06-05,08:15,12,12,24
42,2023-06-05T08:15:00+10:00,2023-06-05,08:15,1,1,2
50,2023-06-05T08:15:00+10:00,2023-06-05,08:15,1,0,1
55,2023-06-05T08:15:00+10:00,2023-06-05,08:15,9,9,18
59,2023-06-05T08:15:00+10:00,2023-06-05,08:15,28,11,39
65,2023-06-05T08:15:00+10:00,2023-06-05,08:15,0,6,6
78,2023-06-05T08:15:00+10:00,2023-06-05,08:15,2,4,6
87,2023-06-05T08:15:00+10:00,2023-06-05,08:15,0,2,2
107,2023-06-05T08:15:00+10:00,2023-06-05,08:15,7,17,24
1,2023-06-05T08:15:00+10:00,2023-06-05,08:15,1,2,3
2,2023-06-05T08:15:00+10:00,2023-06-05,08:15,0,2,2
11,2023-06-05T08:15:00+10:00,2023-06-05,08:15,2,1,3
12,2023-06-05T08:15:00+10:00,2023-06-05,08:15,2,0,2
24,2023-06-05T08:15:00+10:00,2023-06-05,08:15,27,7,34
30,2023-06-05T08:15:00+10:00,2023-06-05,08:15,0,1,1
46,2023-06-05T08:15:00+10:00,2023-06-05,08:15,0,4,4
48,2023-06-05T08:15:00+10:00,2023-06-05,08:15,2,1,3
58,2023-06-05T08:15:00+10:00,2023-06-05,08:15,24,0,24
63,2023-06-05T08:15:00+10:00,2023-06-05,08:15,4,0,4
68,2023-06-05T08:15:00+10:00,2023-06-05,08:15,2,1,3
5,2023-06-05T08:15:00+10:00,2023-06-05,08:15,3,5,8
26,2023-06-05T08:15:00+10:00,2023-06-05,08:15,3,2,5
28,2023-06-05T08:15:00+10:00,2023-06-05,08:15,4,1,5
31,2023-06-05T08:15:00+10:00,2023-06-05,08:15,0,3,3
45,2023-06-05T08:15:00+10:00,2023-06-05,08:15,6,1,7
47,2023-06-05T08:15:00+10:00,2023-06-05,08:15,3,4,7
75,2023-06-05T08:15:00+10:00,2023-06-05,08:15,1,0,1
77,2023-06-05T08:15:00+10:00,2023-06-05,08:15,2,6,8
108,2023-06-05T08:15:00+10:00,2023-06-05,08:15,5,12,17
118,2023-06-05T08:15:00+10:00,2023-06-05,08:15,2,1,3
35,2023-06-05T08:15:00+10:00,2023-06-05,08:15,4,15,19
51,2023-06-05T08:15:00+10:00,2023-06-05,08:15,3,0,3
52,2023-06-05T08:15:00+10:00,2023-06-05,08:15,0,5,5
53,2023-06-05T08:15:00+10:00,2023-06-05,08:15,2,5,7
57,2023-06-05T08:15:00+10:00,2023-06-05,08:15,2,20,22
62,2023-06-05T08:15:00+10:00,2023-06-05,08:15,0,3,3
67,2023-06-05T08:15:00+10:00,2023-06-05,08:15,4,5,9
72,2023-06-05T08:15:00+10:00,2023-06-05,08:15,5,1,6
85,2023-06-05T08:15:00+10:00,2023-06-05,08:15,1,0,1
109,2023-06-05T08:15:00+10:00,2023-06-05,08:15,10,46,56
5,2023-06-05T08:14:00+10:00,2023-06-05,08:14,1,7,8
26,2023-06-05T08:14:00+10:00,2023-06-05,08:14,4,2,6
28,2023-06-05T08:14:00+10:00,2023-06-05,08:14,11,0,11
29,2023-06-05T08:14:00+10:00,2023-06-05,08:14,2,0,2
37,2023-06-05T08:14:00+10:00,2023-06-05,08:14,0,1,1
39,2023-06-05T08:14:00+10:00,2023-06-05,08:14,6,1,7
70,2023-06-05T08:14:00+10:00,2023-06-05,08:14,1,0,1
1,2023-06-05T08:14:00+10:00,2023-06-05,08:14,0,6,6
18,2023-06-05T08:14:00+10:00,2023-06-05,08:14,0,22,22
19,2023-06-05T08:14:00+10:00,2023-06-05,08:14,2,0,2
23,2023-06-05T08:14:00+10:00,2023-06-05,08:14,2,6,8
48,2023-06-05T08:14:00+10:00,2023-06-05,08:14,5,3,8
53,2023-06-05T08:14:00+10:00,2023-06-05,08:14,3,5,8
56,2023-06-05T08:14:00+10:00,2023-06-05,08:14,1,2,3
57,2023-06-05T08:14:00+10:00,2023-06-05,08:14,5,17,22
58,2023-06-05T08:14:00+10:00,2023-06-05,08:14,4,4,8
63,2023-06-05T08:14:00+10:00,2023-06-05,08:14,5,2,7
67,2023-06-05T08:14:00+10:00,2023-06-05,08:14,5,8,13
6,2023-06-05T08:14:00+10:00,2023-06-05,08:14,6,10,16
36,2023-06-05T08:14:00+10:00,2023-06-05,08:14,1,2,3
40,2023-06-05T08:14:00+10:00,2023-06-05,08:14,3,6,9
45,2023-06-05T08:14:00+10:00,2023-06-05,08:14,5,5,10
47,2023-06-05T08:14:00+10:00,2023-06-05,08:14,0,14,14
50,2023-06-05T08:14:00+10:00,2023-06-05,08:14,0,1,1
61,2023-06-05T08:14:00+10:00,2023-06-05,08:14,3,5,8
65,2023-06-05T08:14:00+10:00,2023-06-05,08:14,9,3,12
78,2023-06-05T08:14:00+10:00,2023-06-05,08:14,0,1,1
87,2023-06-05T08:14:00+10:00,2023-06-05,08:14,0,4,4
2,2023-06-05T08:14:00+10:00,2023-06-05,08:14,1,2,3
11,2023-06-05T08:14:00+10:00,2023-06-05,08:14,0,1,1
24,2023-06-05T08:14:00+10:00,2023-06-05,08:14,16,14,30
35,2023-06-05T08:14:00+10:00,2023-06-05,08:14,4,15,19
46,2023-06-05T08:14:00+10:00,2023-06-05,08:14,0,2,2
62,2023-06-05T08:14:00+10:00,2023-06-05,08:14,3,0,3
68,2023-06-05T08:14:00+10:00,2023-06-05,08:14,2,0,2
86,2023-06-05T08:14:00+10:00,2023-06-05,08:14,2,0,2
3,2023-06-05T08:14:00+10:00,2023-06-05,08:14,3,1,4
4,2023-06-05T08:14:00+10:00,2023-06-05,08:14,11,2,13
8,2023-06-05T08:14:00+10:00,2023-06-05,08:14,6,1,7
14,2023-06-05T08:14:00+10:00,2023-06-05,08:14,12,9,21
21,2023-06-05T08:14:00+10:00,2023-06-05,08:14,1,3,4
41,2023-06-05T08:14:00+10:00,2023-06-05,08:14,31,4,35
42,2023-06-05T08:14:00+10:00,2023-06-05,08:14,1,1,2
55,2023-06-05T08:14:00+10:00,2023-06-05,08:14,0,9,9
66,2023-06-05T08:14:00+10:00,2023-06-05,08:14,2,8,10
69,2023-06-05T08:14:00+10:00,2023-06-05,08:14,0,1,1
71,2023-06-05T08:14:00+10:00,2023-06-05,08:14,0,6,6
77,2023-06-05T08:14:00+10:00,2023-06-05,08:14,4,0,4
108,2023-06-05T08:14:00+10:00,2023-06-05,08:14,3,27,30
9,2023-06-05T08:14:00+10:00,2023-06-05,08:14,3,17,20
10,2023-06-05T08:14:00+10:00,2023-06-05,08:14,2,1,3
12,2023-06-05T08:14:00+10:00,2023-06-05,08:14,1,0,1
17,2023-06-05T08:14:00+10:00,2023-06-05,08:14,10,1,11
30,2023-06-05T08:14:00+10:00,2023-06-05,08:14,0,2,2
49,2023-06-05T08:14:00+10:00,2023-06-05,08:14,2,0,2
52,2023-06-05T08:14:00+10:00,2023-06-05,08:14,4,1,5
72,2023-06-05T08:14:00+10:00,2023-06-05,08:14,16,0,16
76,2023-06-05T08:14:00+10:00,2023-06-05,08:14,2,1,3
79,2023-06-05T08:14:00+10:00,2023-06-05,08:14,1,12,13
85,2023-06-05T08:14:00+10:00,2023-06-05,08:14,1,0,1
6,2023-06-05T08:13:00+10:00,2023-06-05,08:13,2,17,19
21,2023-06-05T08:13:00+10:00,2023-06-05,08:13,1,0,1
26,2023-06-05T08:13:00+10:00,2023-06-05,08:13,3,1,4
28,2023-06-05T08:13:00+10:00,2023-06-05,08:13,14,4,18
29,2023-06-05T08:13:00+10:00,2023-06-05,08:13,2,1,3
31,2023-06-05T08:13:00+10:00,2023-06-05,08:13,0,1,1
36,2023-06-05T08:13:00+10:00,2023-06-05,08:13,2,1,3
47,2023-06-05T08:13:00+10:00,2023-06-05,08:13,2,11,13
54,2023-06-05T08:13:00+10:00,2023-06-05,08:13,3,0,3
61,2023-06-05T08:13:00+10:00,2023-06-05,08:13,2,3,5
66,2023-06-05T08:13:00+10:00,2023-06-05,08:13,1,2,3
87,2023-06-05T08:13:00+10:00,2023-06-05,08:13,2,0,2
108,2023-06-05T08:13:00+10:00,2023-06-05,08:13,1,44,45
11,2023-06-05T08:13:00+10:00,2023-06-05,08:13,1,1,2
30,2023-06-05T08:13:00+10:00,2023-06-05,08:13,2,1,3
52,2023-06-05T08:13:00+10:00,2023-06-05,08:13,1,2,3
63,2023-06-05T08:13:00+10:00,2023-06-05,08:13,2,4,6
85,2023-06-05T08:13:00+10:00,2023-06-05,08:13,1,0,1
4,2023-06-05T08:13:00+10:00,2023-06-05,08:13,9,7,16
40,2023-06-05T08:13:00+10:00,2023-06-05,08:13,1,4,5
44,2023-06-05T08:13:00+10:00,2023-06-05,08:13,0,1,1
45,2023-06-05T08:13:00+10:00,2023-06-05,08:13,2,2,4
55,2023-06-05T08:13:00+10:00,2023-06-05,08:13,9,6,15
65,2023-06-05T08:13:00+10:00,2023-06-05,08:13,3,6,9
69,2023-06-05T08:13:00+10:00,2023-06-05,08:13,1,0,1
71,2023-06-05T08:13:00+10:00,2023-06-05,08:13,0,4,4
77,2023-06-05T08:13:00+10:00,2023-06-05,08:13,0,4,4
2,2023-06-05T08:13:00+10:00,2023-06-05,08:13,3,3,6
18,2023-06-05T08:13:00+10:00,2023-06-05,08:13,0,11,11
23,2023-06-05T08:13:00+10:00,2023-06-05,08:13,14,5,19
24,2023-06-05T08:13:00+10:00,2023-06-05,08:13,40,4,44
46,2023-06-05T08:13:00+10:00,2023-06-05,08:13,0,2,2
48,2023-06-05T08:13:00+10:00,2023-06-05,08:13,2,0,2
53,2023-06-05T08:13:00+10:00,2023-06-05,08:13,14,6,20
56,2023-06-05T08:13:00+10:00,2023-06-05,08:13,1,1,2
62,2023-06-05T08:13:00+10:00,2023-06-05,08:13,2,3,5
72,2023-06-05T08:13:00+10:00,2023-06-05,08:13,2,2,4
79,2023-06-05T08:13:00+10:00,2023-06-05,08:13,16,4,20
86,2023-06-05T08:13:00+10:00,2023-06-05,08:13,3,1,4
3,2023-06-05T08:13:00+10:00,2023-06-05,08:13,3,7,10
5,2023-06-05T08:13:00+10:00,2023-06-05,08:13,3,7,10
8,2023-06-05T08:13:00+10:00,2023-06-05,08:13,4,1,5
14,2023-06-05T08:13:00+10:00,2023-06-05,08:13,5,8,13
39,2023-06-05T08:13:00+10:00,2023-06-05,08:13,1,2,3
41,2023-06-05T08:13:00+10:00,2023-06-05,08:13,41,6,47
50,2023-06-05T08:13:00+10:00,2023-06-05,08:13,0,1,1
70,2023-06-05T08:13:00+10:00,2023-06-05,08:13,1,0,1
75,2023-06-05T08:13:00+10:00,2023-06-05,08:13,0,1,1
1,2023-06-05T08:13:00+10:00,2023-06-05,08:13,6,4,10
9,2023-06-05T08:13:00+10:00,2023-06-05,08:13,1,13,14
10,2023-06-05T08:13:00+10:00,2023-06-05,08:13,2,7,9
12,2023-06-05T08:13:00+10:00,2023-06-05,08:13,2,2,4
17,2023-06-05T08:13:00+10:00,2023-06-05,08:13,14,4,18
27,2023-06-05T08:13:00+10:00,2023-06-05,08:13,1,0,1
35,2023-06-05T08:13:00+10:00,2023-06-05,08:13,10,13,23
57,2023-06-05T08:13:00+10:00,2023-06-05,08:13,4,9,13
58,2023-06-05T08:13:00+10:00,2023-06-05,08:13,15,0,15
67,2023-06-05T08:13:00+10:00,2023-06-05,08:13,4,6,10
68,2023-06-05T08:13:00+10:00,2023-06-05,08:13,1,0,1
28,2023-06-05T08:12:00+10:00,2023-06-05,08:12,12,4,16
29,2023-06-05T08:12:00+10:00,2023-06-05,08:12,4,0,4
39,2023-06-05T08:12:00+10:00,2023-06-05,08:12,3,2,5
40,2023-06-05T08:12:00+10:00,2023-06-05,08:12,1,2,3
42,2023-06-05T08:12:00+10:00,2023-06-05,08:12,5,2,7
45,2023-06-05T08:12:00+10:00,2023-06-05,08:12,4,1,5
50,2023-06-05T08:12:00+10:00,2023-06-05,08:12,1,0,1
54,2023-06-05T08:12:00+10:00,2023-06-05,08:12,4,0,4
65,2023-06-05T08:12:00+10:00,2023-06-05,08:12,5,3,8
66,2023-06-05T08:12:00+10:00,2023-06-05,08:12,1,5,6
87,2023-06-05T08:12:00+10:00,2023-06-05,08:12,3,1,4
1,2023-06-05T08:12:00+10:00,2023-06-05,08:12,4,2,6
2,2023-06-05T08:12:00+10:00,2023-06-05,08:12,2,1,3
24,2023-06-05T08:12:00+10:00,2023-06-05,08:12,18,4,22
27,2023-06-05T08:12:00+10:00,2023-06-05,08:12,0,5,5
30,2023-06-05T08:12:00+10:00,2023-06-05,08:12,1,0,1
51,2023-06-05T08:12:00+10:00,2023-06-05,08:12,0,1,1
67,2023-06-05T08:12:00+10:00,2023-06-05,08:12,2,6,8
72,2023-06-05T08:12:00+10:00,2023-06-05,08:12,12,2,14
85,2023-06-05T08:12:00+10:00,2023-06-05,08:12,1,3,4
4,2023-06-05T08:12:00+10:00,2023-06-05,08:12,7,3,10
6,2023-06-05T08:12:00+10:00,2023-06-05,08:12,22,14,36
8,2023-06-05T08:12:00+10:00,2023-06-05,08:12,1,1,2
14,2023-06-05T08:12:00+10:00,2023-06-05,08:12,5,6,11
26,2023-06-05T08:12:00+10:00,2023-06-05,08:12,3,2,5
55,2023-06-05T08:12:00+10:00,2023-06-05,08:12,6,5,11
69,2023-06-05T08:12:00+10:00,2023-06-05,08:12,4,0,4
70,2023-06-05T08:12:00+10:00,2023-06-05,08:12,2,1,3
78,2023-06-05T08:12:00+10:00,2023-06-05,08:12,1,0,1
9,2023-06-05T08:12:00+10:00,2023-06-05,08:12,1,12,13
10,2023-06-05T08:12:00+10:00,2023-06-05,08:12,4,8,12
11,2023-06-05T08:12:00+10:00,2023-06-05,08:12,1,1,2
12,2023-06-05T08:12:00+10:00,2023-06-05,08:12,1,2,3
17,2023-06-05T08:12:00+10:00,2023-06-05,08:12,15,5,20
18,2023-06-05T08:12:00+10:00,2023-06-05,08:12,0,5,5
23,2023-06-05T08:12:00+10:00,2023-06-05,08:12,16,3,19
35,2023-06-05T08:12:00+10:00,2023-06-05,08:12,6,20,26
48,2023-06-05T08:12:00+10:00,2023-06-05,08:12,3,0,3
56,2023-06-05T08:12:00+10:00,2023-06-05,08:12,1,1,2
57,2023-06-05T08:12:00+10:00,2023-06-05,08:12,5,10,15
58,2023-06-05T08:12:00+10:00,2023-06-05,08:12,19,2,21
79,2023-06-05T08:12:00+10:00,2023-06-05,08:12,3,10,13
3,2023-06-05T08:12:00+10:00,2023-06-05,08:12,5,7,12
5,2023-06-05T08:12:00+10:00,2023-06-05,08:12,4,6,10
21,2023-06-05T08:12:00+10:00,2023-06-05,08:12,3,0,3
31,2023-06-05T08:12:00+10:00,2023-06-05,08:12,0,3,3
36,2023-06-05T08:12:00+10:00,2023-06-05,08:12,4,1,5
41,2023-06-05T08:12:00+10:00,2023-06-05,08:12,36,3,39
47,2023-06-05T08:12:00+10:00,2023-06-05,08:12,3,6,9
61,2023-06-05T08:12:00+10:00,2023-06-05,08:12,2,5,7
71,2023-06-05T08:12:00+10:00,2023-06-05,08:12,3,8,11
75,2023-06-05T08:12:00+10:00,2023-06-05,08:12,0,4,4
77,2023-06-05T08:12:00+10:00,2023-06-05,08:12,0,1,1
108,2023-06-05T08:12:00+10:00,2023-06-05,08:12,4,41,45
19,2023-06-05T08:12:00+10:00,2023-06-05,08:12,1,0,1
52,2023-06-05T08:12:00+10:00,2023-06-05,08:12,1,3,4
53,2023-06-05T08:12:00+10:00,2023-06-05,08:12,2,7,9
62,2023-06-05T08:12:00+10:00,2023-06-05,08:12,0,1,1
63,2023-06-05T08:12:00+10:00,2023-06-05,08:12,1,1,2
68,2023-06-05T08:12:00+10:00,2023-06-05,08:12,4,2,6
76,2023-06-05T08:12:00+10:00,2023-06-05,08:12,3,2,5
3,2023-06-05T08:11:00+10:00,2023-06-05,08:11,3,2,5
4,2023-06-05T08:11:00+10:00,2023-06-05,08:11,6,6,12
14,2023-06-05T08:11:00+10:00,2023-06-05,08:11,4,2,6
21,2023-06-05T08:11:00+10:00,2023-06-05,08:11,2,2,4
26,2023-06-05T08:11:00+10:00,2023-06-05,08:11,3,0,3
28,2023-06-05T08:11:00+10:00,2023-06-05,08:11,6,9,15
42,2023-06-05T08:11:00+10:00,2023-06-05,08:11,0,1,1
50,2023-06-05T08:11:00+10:00,2023-06-05,08:11,1,3,4
55,2023-06-05T08:11:00+10:00,2023-06-05,08:11,3,6,9
75,2023-06-05T08:11:00+10:00,2023-06-05,08:11,4,2,6
1,2023-06-05T08:11:00+10:00,2023-06-05,08:11,1,6,7
10,2023-06-05T08:11:00+10:00,2023-06-05,08:11,3,8,11
46,2023-06-05T08:11:00+10:00,2023-06-05,08:11,1,3,4
51,2023-06-05T08:11:00+10:00,2023-06-05,08:11,0,1,1
57,2023-06-05T08:11:00+10:00,2023-06-05,08:11,4,5,9
6,2023-06-05T08:11:00+10:00,2023-06-05,08:11,14,20,34
8,2023-06-05T08:11:00+10:00,2023-06-05,08:11,0,2,2
29,2023-06-05T08:11:00+10:00,2023-06-05,08:11,1,0,1
31,2023-06-05T08:11:00+10:00,2023-06-05,08:11,2,2,4
36,2023-06-05T08:11:00+10:00,2023-06-05,08:11,1,2,3
39,2023-06-05T08:11:00+10:00,2023-06-05,08:11,2,0,2
41,2023-06-05T08:11:00+10:00,2023-06-05,08:11,47,7,54
54,2023-06-05T08:11:00+10:00,2023-06-05,08:11,3,3,6
66,2023-06-05T08:11:00+10:00,2023-06-05,08:11,4,12,16
70,2023-06-05T08:11:00+10:00,2023-06-05,08:11,1,2,3
77,2023-06-05T08:11:00+10:00,2023-06-05,08:11,5,0,5
108,2023-06-05T08:11:00+10:00,2023-06-05,08:11,5,35,40
2,2023-06-05T08:11:00+10:00,2023-06-05,08:11,3,1,4
12,2023-06-05T08:11:00+10:00,2023-06-05,08:11,0,3,3
18,2023-06-05T08:11:00+10:00,2023-06-05,08:11,0,24,24
19,2023-06-05T08:11:00+10:00,2023-06-05,08:11,1,0,1
23,2023-06-05T08:11:00+10:00,2023-06-05,08:11,5,3,8
30,2023-06-05T08:11:00+10:00,2023-06-05,08:11,1,3,4
35,2023-06-05T08:11:00+10:00,2023-06-05,08:11,6,16,22
53,2023-06-05T08:11:00+10:00,2023-06-05,08:11,3,5,8
62,2023-06-05T08:11:00+10:00,2023-06-05,08:11,2,0,2
72,2023-06-05T08:11:00+10:00,2023-06-05,08:11,4,1,5
76,2023-06-05T08:11:00+10:00,2023-06-05,08:11,2,0,2
85,2023-06-05T08:11:00+10:00,2023-06-05,08:11,1,1,2
5,2023-06-05T08:11:00+10:00,2023-06-05,08:11,1,13,14
40,2023-06-05T08:11:00+10:00,2023-06-05,08:11,7,1,8
45,2023-06-05T08:11:00+10:00,2023-06-05,08:11,3,3,6
47,2023-06-05T08:11:00+10:00,2023-06-05,08:11,3,7,10
61,2023-06-05T08:11:00+10:00,2023-06-05,08:11,2,3,5
65,2023-06-05T08:11:00+10:00,2023-06-05,08:11,8,4,12
71,2023-06-05T08:11:00+10:00,2023-06-05,08:11,7,1,8
78,2023-06-05T08:11:00+10:00,2023-06-05,08:11,2,0,2
87,2023-06-05T08:11:00+10:00,2023-06-05,08:11,1,1,2
9,2023-06-05T08:11:00+10:00,2023-06-05,08:11,0,24,24
17,2023-06-05T08:11:00+10:00,2023-06-05,08:11,14,1,15
20,2023-06-05T08:11:00+10:00,2023-06-05,08:11,0,1,1
24,2023-06-05T08:11:00+10:00,2023-06-05,08:11,26,8,34
48,2023-06-05T08:11:00+10:00,2023-06-05,08:11,2,1,3
52,2023-06-05T08:11:00+10:00,2023-06-05,08:11,0,6,6
56,2023-06-05T08:11:00+10:00,2023-06-05,08:11,0,2,2
58,2023-06-05T08:11:00+10:00,2023-06-05,08:11,8,3,11
63,2023-06-05T08:11:00+10:00,2023-06-05,08:11,1,2,3
67,2023-06-05T08:11:00+10:00,2023-06-05,08:11,4,4,8
68,2023-06-05T08:11:00+10:00,2023-06-05,08:11,0,2,2
79,2023-06-05T08:11:00+10:00,2023-06-05,08:11,3,4,7
3,2023-06-05T08:10:00+10:00,2023-06-05,08:10,0,2,2
4,2023-06-05T08:10:00+10:00,2023-06-05,08:10,8,9,17
6,2023-06-05T08:10:00+10:00,2023-06-05,08:10,6,35,41
28,2023-06-05T08:10:00+10:00,2023-06-05,08:10,6,5,11
29,2023-06-05T08:10:00+10:00,2023-06-05,08:10,1,0,1
36,2023-06-05T08:10:00+10:00,2023-06-05,08:10,0,1,1
41,2023-06-05T08:10:00+10:00,2023-06-05,08:10,20,12,32
54,2023-06-05T08:10:00+10:00,2023-06-05,08:10,3,0,3
55,2023-06-05T08:10:00+10:00,2023-06-05,08:10,5,7,12
59,2023-06-05T08:10:00+10:00,2023-06-05,08:10,35,10,45
65,2023-06-05T08:10:00+10:00,2023-06-05,08:10,8,5,13
84,2023-06-05T08:10:00+10:00,2023-06-05,08:10,129,21,150
108,2023-06-05T08:10:00+10:00,2023-06-05,08:10,1,14,15
17,2023-06-05T08:10:00+10:00,2023-06-05,08:10,20,2,22
18,2023-06-05T08:10:00+10:00,2023-06-05,08:10,0,17,17
23,2023-06-05T08:10:00+10:00,2023-06-05,08:10,9,4,13
24,2023-06-05T08:10:00+10:00,2023-06-05,08:10,71,2,73
35,2023-06-05T08:10:00+10:00,2023-06-05,08:10,4,6,10
52,2023-06-05T08:10:00+10:00,2023-06-05,08:10,5,1,6
68,2023-06-05T08:10:00+10:00,2023-06-05,08:10,2,3,5
72,2023-06-05T08:10:00+10:00,2023-06-05,08:10,4,0,4
76,2023-06-05T08:10:00+10:00,2023-06-05,08:10,1,0,1
85,2023-06-05T08:10:00+10:00,2023-06-05,08:10,4,0,4
26,2023-06-05T08:10:00+10:00,2023-06-05,08:10,1,2,3
31,2023-06-05T08:10:00+10:00,2023-06-05,08:10,1,3,4
39,2023-06-05T08:10:00+10:00,2023-06-05,08:10,5,0,5
50,2023-06-05T08:10:00+10:00,2023-06-05,08:10,1,1,2
61,2023-06-05T08:10:00+10:00,2023-06-05,08:10,1,5,6
66,2023-06-05T08:10:00+10:00,2023-06-05,08:10,1,2,3
71,2023-06-05T08:10:00+10:00,2023-06-05,08:10,1,2,3
78,2023-06-05T08:10:00+10:00,2023-06-05,08:10,0,1,1
118,2023-06-05T08:10:00+10:00,2023-06-05,08:10,1,1,2
1,2023-06-05T08:10:00+10:00,2023-06-05,08:10,0,6,6
2,2023-06-05T08:10:00+10:00,2023-06-05,08:10,1,6,7
9,2023-06-05T08:10:00+10:00,2023-06-05,08:10,1,32,33
11,2023-06-05T08:10:00+10:00,2023-06-05,08:10,1,1,2
19,2023-06-05T08:10:00+10:00,2023-06-05,08:10,1,0,1
30,2023-06-05T08:10:00+10:00,2023-06-05,08:10,1,0,1
46,2023-06-05T08:10:00+10:00,2023-06-05,08:10,1,2,3
58,2023-06-05T08:10:00+10:00,2023-06-05,08:10,56,7,63
79,2023-06-05T08:10:00+10:00,2023-06-05,08:10,21,5,26
86,2023-06-05T08:10:00+10:00,2023-06-05,08:10,1,0,1
117,2023-06-05T08:10:00+10:00,2023-06-05,08:10,9,6,15
5,2023-06-05T08:10:00+10:00,2023-06-05,08:10,5,14,19
8,2023-06-05T08:10:00+10:00,2023-06-05,08:10,1,3,4
14,2023-06-05T08:10:00+10:00,2023-06-05,08:10,3,6,9
21,2023-06-05T08:10:00+10:00,2023-06-05,08:10,0,3,3
40,2023-06-05T08:10:00+10:00,2023-06-05,08:10,3,1,4
45,2023-06-05T08:10:00+10:00,2023-06-05,08:10,3,3,6
47,2023-06-05T08:10:00+10:00,2023-06-05,08:10,1,13,14
75,2023-06-05T08:10:00+10:00,2023-06-05,08:10,2,1,3
77,2023-06-05T08:10:00+10:00,2023-06-05,08:10,3,5,8
87,2023-06-05T08:10:00+10:00,2023-06-05,08:10,1,1,2
107,2023-06-05T08:10:00+10:00,2023-06-05,08:10,0,15,15
10,2023-06-05T08:10:00+10:00,2023-06-05,08:10,0,4,4
12,2023-06-05T08:10:00+10:00,2023-06-05,08:10,1,1,2
27,2023-06-05T08:10:00+10:00,2023-06-05,08:10,0,2,2
48,2023-06-05T08:10:00+10:00,2023-06-05,08:10,2,0,2
51,2023-06-05T08:10:00+10:00,2023-06-05,08:10,2,2,4
53,2023-06-05T08:10:00+10:00,2023-06-05,08:10,7,1,8
56,2023-06-05T08:10:00+10:00,2023-06-05,08:10,0,3,3
57,2023-06-05T08:10:00+10:00,2023-06-05,08:10,2,12,14
62,2023-06-05T08:10:00+10:00,2023-06-05,08:10,1,1,2
63,2023-06-05T08:10:00+10:00,2023-06-05,08:10,3,1,4
67,2023-06-05T08:10:00+10:00,2023-06-05,08:10,2,4,6
109,2023-06-05T08:10:00+10:00,2023-06-05,08:10,7,43,50
4,2023-06-05T08:09:00+10:00,2023-06-05,08:09,8,4,12
5,2023-06-05T08:09:00+10:00,2023-06-05,08:09,3,11,14
8,2023-06-05T08:09:00+10:00,2023-06-05,08:09,5,2,7
14,2023-06-05T08:09:00+10:00,2023-06-05,08:09,11,10,21
26,2023-06-05T08:09:00+10:00,2023-06-05,08:09,2,2,4
31,2023-06-05T08:09:00+10:00,2023-06-05,08:09,1,1,2
39,2023-06-05T08:09:00+10:00,2023-06-05,08:09,2,0,2
44,2023-06-05T08:09:00+10:00,2023-06-05,08:09,0,1,1
45,2023-06-05T08:09:00+10:00,2023-06-05,08:09,0,5,5
54,2023-06-05T08:09:00+10:00,2023-06-05,08:09,0,1,1
61,2023-06-05T08:09:00+10:00,2023-06-05,08:09,4,3,7
65,2023-06-05T08:09:00+10:00,2023-06-05,08:09,7,1,8
77,2023-06-05T08:09:00+10:00,2023-06-05,08:09,1,5,6
1,2023-06-05T08:09:00+10:00,2023-06-05,08:09,0,3,3
9,2023-06-05T08:09:00+10:00,2023-06-05,08:09,0,44,44
18,2023-06-05T08:09:00+10:00,2023-06-05,08:09,1,10,11
48,2023-06-05T08:09:00+10:00,2023-06-05,08:09,0,2,2
49,2023-06-05T08:09:00+10:00,2023-06-05,08:09,2,0,2
53,2023-06-05T08:09:00+10:00,2023-06-05,08:09,0,3,3
57,2023-06-05T08:09:00+10:00,2023-06-05,08:09,8,11,19
67,2023-06-05T08:09:00+10:00,2023-06-05,08:09,4,2,6
3,2023-06-05T08:09:00+10:00,2023-06-05,08:09,0,6,6
29,2023-06-05T08:09:00+10:00,2023-06-05,08:09,3,4,7
47,2023-06-05T08:09:00+10:00,2023-06-05,08:09,1,4,5
69,2023-06-05T08:09:00+10:00,2023-06-05,08:09,3,0,3
75,2023-06-05T08:09:00+10:00,2023-06-05,08:09,0,1,1
78,2023-06-05T08:09:00+10:00,2023-06-05,08:09,1,0,1
10,2023-06-05T08:09:00+10:00,2023-06-05,08:09,0,3,3
19,2023-06-05T08:09:00+10:00,2023-06-05,08:09,1,0,1
24,2023-06-05T08:09:00+10:00,2023-06-05,08:09,7,11,18
35,2023-06-05T08:09:00+10:00,2023-06-05,08:09,9,20,29
46,2023-06-05T08:09:00+10:00,2023-06-05,08:09,1,0,1
52,2023-06-05T08:09:00+10:00,2023-06-05,08:09,3,2,5
56,2023-06-05T08:09:00+10:00,2023-06-05,08:09,0,1,1
58,2023-06-05T08:09:00+10:00,2023-06-05,08:09,3,1,4
63,2023-06-05T08:09:00+10:00,2023-06-05,08:09,2,0,2
72,2023-06-05T08:09:00+10:00,2023-06-05,08:09,11,2,13
76,2023-06-05T08:09:00+10:00,2023-06-05,08:09,1,0,1
86,2023-06-05T08:09:00+10:00,2023-06-05,08:09,0,1,1
6,2023-06-05T08:09:00+10:00,2023-06-05,08:09,3,26,29
21,2023-06-05T08:09:00+10:00,2023-06-05,08:09,1,4,5
28,2023-06-05T08:09:00+10:00,2023-06-05,08:09,3,3,6
36,2023-06-05T08:09:00+10:00,2023-06-05,08:09,1,8,9
40,2023-06-05T08:09:00+10:00,2023-06-05,08:09,2,2,4
41,2023-06-05T08:09:00+10:00,2023-06-05,08:09,30,1,31
42,2023-06-05T08:09:00+10:00,2023-06-05,08:09,2,0,2
50,2023-06-05T08:09:00+10:00,2023-06-05,08:09,0,2,2
55,2023-06-05T08:09:00+10:00,2023-06-05,08:09,5,3,8
66,2023-06-05T08:09:00+10:00,2023-06-05,08:09,2,5,7
70,2023-06-05T08:09:00+10:00,2023-06-05,08:09,1,2,3
87,2023-06-05T08:09:00+10:00,2023-06-05,08:09,4,1,5
108,2023-06-05T08:09:00+10:00,2023-06-05,08:09,4,34,38
2,2023-06-05T08:09:00+10:00,2023-06-05,08:09,0,3,3
17,2023-06-05T08:09:00+10:00,2023-06-05,08:09,7,2,9
23,2023-06-05T08:09:00+10:00,2023-06-05,08:09,4,2,6
27,2023-06-05T08:09:00+10:00,2023-06-05,08:09,2,2,4
30,2023-06-05T08:09:00+10:00,2023-06-05,08:09,2,1,3
51,2023-06-05T08:09:00+10:00,2023-06-05,08:09,1,4,5
62,2023-06-05T08:09:00+10:00,2023-06-05,08:09,0,1,1
68,2023-06-05T08:09:00+10:00,2023-06-05,08:09,0,2,2
79,2023-06-05T08:09:00+10:00,2023-06-05,08:09,3,10,13
85,2023-06-05T08:09:00+10:00,2023-06-05,08:09,1,0,1
5,2023-06-05T08:08:00+10:00,2023-06-05,08:08,7,8,15
21,2023-06-05T08:08:00+10:00,2023-06-05,08:08,2,0,2
26,2023-06-05T08:08:00+10:00,2023-06-05,08:08,1,2,3
29,2023-06-05T08:08:00+10:00,2023-06-05,08:08,1,1,2
45,2023-06-05T08:08:00+10:00,2023-06-05,08:08,3,7,10
50,2023-06-05T08:08:00+10:00,2023-06-05,08:08,0,3,3
66,2023-06-05T08:08:00+10:00,2023-06-05,08:08,4,4,8
69,2023-06-05T08:08:00+10:00,2023-06-05,08:08,1,0,1
70,2023-06-05T08:08:00+10:00,2023-06-05,08:08,4,1,5
75,2023-06-05T08:08:00+10:00,2023-06-05,08:08,2,0,2
87,2023-06-05T08:08:00+10:00,2023-06-05,08:08,4,0,4
108,2023-06-05T08:08:00+10:00,2023-06-05,08:08,1,33,34
9,2023-06-05T08:08:00+10:00,2023-06-05,08:08,2,35,37
30,2023-06-05T08:08:00+10:00,2023-06-05,08:08,1,0,1
35,2023-06-05T08:08:00+10:00,2023-06-05,08:08,6,9,15
46,2023-06-05T08:08:00+10:00,2023-06-05,08:08,1,3,4
53,2023-06-05T08:08:00+10:00,2023-06-05,08:08,5,6,11
68,2023-06-05T08:08:00+10:00,2023-06-05,08:08,1,1,2
79,2023-06-05T08:08:00+10:00,2023-06-05,08:08,0,14,14
85,2023-06-05T08:08:00+10:00,2023-06-05,08:08,3,1,4
6,2023-06-05T08:08:00+10:00,2023-06-05,08:08,4,10,14
14,2023-06-05T08:08:00+10:00,2023-06-05,08:08,8,3,11
36,2023-06-05T08:08:00+10:00,2023-06-05,08:08,6,2,8
37,2023-06-05T08:08:00+10:00,2023-06-05,08:08,2,0,2
39,2023-06-05T08:08:00+10:00,2023-06-05,08:08,1,0,1
40,2023-06-05T08:08:00+10:00,2023-06-05,08:08,4,3,7
47,2023-06-05T08:08:00+10:00,2023-06-05,08:08,4,8,12
55,2023-06-05T08:08:00+10:00,2023-06-05,08:08,2,3,5
61,2023-06-05T08:08:00+10:00,2023-06-05,08:08,1,6,7
78,2023-06-05T08:08:00+10:00,2023-06-05,08:08,0,1,1
10,2023-06-05T08:08:00+10:00,2023-06-05,08:08,1,1,2
17,2023-06-05T08:08:00+10:00,2023-06-05,08:08,12,2,14
27,2023-06-05T08:08:00+10:00,2023-06-05,08:08,0,3,3
57,2023-06-05T08:08:00+10:00,2023-06-05,08:08,3,8,11
58,2023-06-05T08:08:00+10:00,2023-06-05,08:08,21,0,21
67,2023-06-05T08:08:00+10:00,2023-06-05,08:08,4,2,6
72,2023-06-05T08:08:00+10:00,2023-06-05,08:08,4,0,4
76,2023-06-05T08:08:00+10:00,2023-06-05,08:08,0,2,2
3,2023-06-05T08:08:00+10:00,2023-06-05,08:08,2,7,9
4,2023-06-05T08:08:00+10:00,2023-06-05,08:08,8,4,12
8,2023-06-05T08:08:00+10:00,2023-06-05,08:08,2,2,4
28,2023-06-05T08:08:00+10:00,2023-06-05,08:08,6,5,11
31,2023-06-05T08:08:00+10:00,2023-06-05,08:08,0,1,1
41,2023-06-05T08:08:00+10:00,2023-06-05,08:08,22,3,25
42,2023-06-05T08:08:00+10:00,2023-06-05,08:08,0,1,1
65,2023-06-05T08:08:00+10:00,2023-06-05,08:08,12,1,13
77,2023-06-05T08:08:00+10:00,2023-06-05,08:08,2,4,6
1,2023-06-05T08:08:00+10:00,2023-06-05,08:08,6,2,8
2,2023-06-05T08:08:00+10:00,2023-06-05,08:08,1,4,5
12,2023-06-05T08:08:00+10:00,2023-06-05,08:08,3,0,3
18,2023-06-05T08:08:00+10:00,2023-06-05,08:08,2,19,21
23,2023-06-05T08:08:00+10:00,2023-06-05,08:08,8,3,11
24,2023-06-05T08:08:00+10:00,2023-06-05,08:08,59,1,60
51,2023-06-05T08:08:00+10:00,2023-06-05,08:08,1,0,1
52,2023-06-05T08:08:00+10:00,2023-06-05,08:08,3,2,5
56,2023-06-05T08:08:00+10:00,2023-06-05,08:08,0,1,1
62,2023-06-05T08:08:00+10:00,2023-06-05,08:08,3,0,3
63,2023-06-05T08:08:00+10:00,2023-06-05,08:08,1,2,3
86,2023-06-05T08:08:00+10:00,2023-06-05,08:08,1,1,2
3,2023-06-05T08:07:00+10:00,2023-06-05,08:07,5,4,9
5,2023-06-05T08:07:00+10:00,2023-06-05,08:07,6,4,10
6,2023-06-05T08:07:00+10:00,2023-06-05,08:07,15,18,33
8,2023-06-05T08:07:00+10:00,2023-06-05,08:07,1,3,4
14,2023-06-05T08:07:00+10:00,2023-06-05,08:07,6,3,9
26,2023-06-05T08:07:00+10:00,2023-06-05,08:07,2,1,3
28,2023-06-05T08:07:00+10:00,2023-06-05,08:07,4,6,10
39,2023-06-05T08:07:00+10:00,2023-06-05,08:07,1,1,2
65,2023-06-05T08:07:00+10:00,2023-06-05,08:07,0,1,1
66,2023-06-05T08:07:00+10:00,2023-06-05,08:07,1,6,7
75,2023-06-05T08:07:00+10:00,2023-06-05,08:07,0,3,3
10,2023-06-05T08:07:00+10:00,2023-06-05,08:07,0,4,4
12,2023-06-05T08:07:00+10:00,2023-06-05,08:07,3,0,3
20,2023-06-05T08:07:00+10:00,2023-06-05,08:07,1,0,1
35,2023-06-05T08:07:00+10:00,2023-06-05,08:07,5,9,14
53,2023-06-05T08:07:00+10:00,2023-06-05,08:07,7,4,11
57,2023-06-05T08:07:00+10:00,2023-06-05,08:07,4,12,16
76,2023-06-05T08:07:00+10:00,2023-06-05,08:07,2,0,2
36,2023-06-05T08:07:00+10:00,2023-06-05,08:07,1,2,3
41,2023-06-05T08:07:00+10:00,2023-06-05,08:07,14,3,17
47,2023-06-05T08:07:00+10:00,2023-06-05,08:07,1,12,13
55,2023-06-05T08:07:00+10:00,2023-06-05,08:07,10,8,18
70,2023-06-05T08:07:00+10:00,2023-06-05,08:07,3,0,3
77,2023-06-05T08:07:00+10:00,2023-06-05,08:07,1,3,4
108,2023-06-05T08:07:00+10:00,2023-06-05,08:07,2,14,16
2,2023-06-05T08:07:00+10:00,2023-06-05,08:07,1,3,4
18,2023-06-05T08:07:00+10:00,2023-06-05,08:07,1,7,8
24,2023-06-05T08:07:00+10:00,2023-06-05,08:07,16,7,23
27,2023-06-05T08:07:00+10:00,2023-06-05,08:07,0,2,2
46,2023-06-05T08:07:00+10:00,2023-06-05,08:07,0,1,1
51,2023-06-05T08:07:00+10:00,2023-06-05,08:07,1,1,2
52,2023-06-05T08:07:00+10:00,2023-06-05,08:07,0,5,5
56,2023-06-05T08:07:00+10:00,2023-06-05,08:07,1,2,3
58,2023-06-05T08:07:00+10:00,2023-06-05,08:07,16,0,16
62,2023-06-05T08:07:00+10:00,2023-06-05,08:07,2,1,3
79,2023-06-05T08:07:00+10:00,2023-06-05,08:07,2,4,6
85,2023-06-05T08:07:00+10:00,2023-06-05,08:07,2,0,2
4,2023-06-05T08:07:00+10:00,2023-06-05,08:07,11,4,15
21,2023-06-05T08:07:00+10:00,2023-06-05,08:07,1,2,3
29,2023-06-05T08:07:00+10:00,2023-06-05,08:07,0,2,2
37,2023-06-05T08:07:00+10:00,2023-06-05,08:07,1,1,2
40,2023-06-05T08:07:00+10:00,2023-06-05,08:07,4,2,6
42,2023-06-05T08:07:00+10:00,2023-06-05,08:07,1,3,4
44,2023-06-05T08:07:00+10:00,2023-06-05,08:07,0,3,3
45,2023-06-05T08:07:00+10:00,2023-06-05,08:07,4,6,10
54,2023-06-05T08:07:00+10:00,2023-06-05,08:07,1,0,1
61,2023-06-05T08:07:00+10:00,2023-06-05,08:07,1,6,7
69,2023-06-05T08:07:00+10:00,2023-06-05,08:07,1,0,1
78,2023-06-05T08:07:00+10:00,2023-06-05,08:07,2,0,2
87,2023-06-05T08:07:00+10:00,2023-06-05,08:07,0,1,1
1,2023-06-05T08:07:00+10:00,2023-06-05,08:07,3,11,14
9,2023-06-05T08:07:00+10:00,2023-06-05,08:07,0,36,36
17,2023-06-05T08:07:00+10:00,2023-06-05,08:07,14,2,16
19,2023-06-05T08:07:00+10:00,2023-06-05,08:07,1,0,1
23,2023-06-05T08:07:00+10:00,2023-06-05,08:07,7,5,12
30,2023-06-05T08:07:00+10:00,2023-06-05,08:07,1,0,1
48,2023-06-05T08:07:00+10:00,2023-06-05,08:07,1,1,2
63,2023-06-05T08:07:00+10:00,2023-06-05,08:07,2,2,4
67,2023-06-05T08:07:00+10:00,2023-06-05,08:07,3,1,4
68,2023-06-05T08:07:00+10:00,2023-06-05,08:07,3,1,4
72,2023-06-05T08:07:00+10:00,2023-06-05,08:07,4,0,4
8,2023-06-05T08:06:00+10:00,2023-06-05,08:06,2,0,2
29,2023-06-05T08:06:00+10:00,2023-06-05,08:06,0,3,3
31,2023-06-05T08:06:00+10:00,2023-06-05,08:06,1,0,1
36,2023-06-05T08:06:00+10:00,2023-06-05,08:06,7,0,7
39,2023-06-05T08:06:00+10:00,2023-06-05,08:06,2,2,4
54,2023-06-05T08:06:00+10:00,2023-06-05,08:06,0,4,4
70,2023-06-05T08:06:00+10:00,2023-06-05,08:06,0,1,1
75,2023-06-05T08:06:00+10:00,2023-06-05,08:06,2,1,3
77,2023-06-05T08:06:00+10:00,2023-06-05,08:06,2,6,8
87,2023-06-05T08:06:00+10:00,2023-06-05,08:06,6,0,6
18,2023-06-05T08:06:00+10:00,2023-06-05,08:06,0,13,13
23,2023-06-05T08:06:00+10:00,2023-06-05,08:06,5,5,10
35,2023-06-05T08:06:00+10:00,2023-06-05,08:06,3,15,18
46,2023-06-05T08:06:00+10:00,2023-06-05,08:06,1,2,3
52,2023-06-05T08:06:00+10:00,2023-06-05,08:06,2,4,6
53,2023-06-05T08:06:00+10:00,2023-06-05,08:06,3,3,6
58,2023-06-05T08:06:00+10:00,2023-06-05,08:06,21,1,22
63,2023-06-05T08:06:00+10:00,2023-06-05,08:06,2,3,5
72,2023-06-05T08:06:00+10:00,2023-06-05,08:06,5,0,5
76,2023-06-05T08:06:00+10:00,2023-06-05,08:06,2,0,2
85,2023-06-05T08:06:00+10:00,2023-06-05,08:06,5,2,7
3,2023-06-05T08:06:00+10:00,2023-06-05,08:06,7,4,11
4,2023-06-05T08:06:00+10:00,2023-06-05,08:06,12,1,13
14,2023-06-05T08:06:00+10:00,2023-06-05,08:06,4,5,9
21,2023-06-05T08:06:00+10:00,2023-06-05,08:06,0,4,4
28,2023-06-05T08:06:00+10:00,2023-06-05,08:06,6,6,12
45,2023-06-05T08:06:00+10:00,2023-06-05,08:06,8,4,12
47,2023-06-05T08:06:00+10:00,2023-06-05,08:06,1,2,3
61,2023-06-05T08:06:00+10:00,2023-06-05,08:06,2,2,4
65,2023-06-05T08:06:00+10:00,2023-06-05,08:06,4,2,6
66,2023-06-05T08:06:00+10:00,2023-06-05,08:06,1,1,2
69,2023-06-05T08:06:00+10:00,2023-06-05,08:06,1,0,1
2,2023-06-05T08:06:00+10:00,2023-06-05,08:06,1,2,3
9,2023-06-05T08:06:00+10:00,2023-06-05,08:06,1,21,22
10,2023-06-05T08:06:00+10:00,2023-06-05,08:06,0,6,6
19,2023-06-05T08:06:00+10:00,2023-06-05,08:06,2,1,3
30,2023-06-05T08:06:00+10:00,2023-06-05,08:06,1,0,1
48,2023-06-05T08:06:00+10:00,2023-06-05,08:06,2,2,4
51,2023-06-05T08:06:00+10:00,2023-06-05,08:06,2,3,5
67,2023-06-05T08:06:00+10:00,2023-06-05,08:06,5,3,8
5,2023-06-05T08:06:00+10:00,2023-06-05,08:06,3,6,9
6,2023-06-05T08:06:00+10:00,2023-06-05,08:06,2,11,13
26,2023-06-05T08:06:00+10:00,2023-06-05,08:06,3,1,4
37,2023-06-05T08:06:00+10:00,2023-06-05,08:06,1,0,1
40,2023-06-05T08:06:00+10:00,2023-06-05,08:06,2,7,9
41,2023-06-05T08:06:00+10:00,2023-06-05,08:06,15,5,20
42,2023-06-05T08:06:00+10:00,2023-06-05,08:06,4,3,7
50,2023-06-05T08:06:00+10:00,2023-06-05,08:06,0,1,1
55,2023-06-05T08:06:00+10:00,2023-06-05,08:06,4,5,9
108,2023-06-05T08:06:00+10:00,2023-06-05,08:06,3,21,24
1,2023-06-05T08:06:00+10:00,2023-06-05,08:06,4,2,6
12,2023-06-05T08:06:00+10:00,2023-06-05,08:06,5,0,5
17,2023-06-05T08:06:00+10:00,2023-06-05,08:06,17,2,19
20,2023-06-05T08:06:00+10:00,2023-06-05,08:06,1,2,3
24,2023-06-05T08:06:00+10:00,2023-06-05,08:06,21,1,22
49,2023-06-05T08:06:00+10:00,2023-06-05,08:06,0,2,2
57,2023-06-05T08:06:00+10:00,2023-06-05,08:06,4,16,20
68,2023-06-05T08:06:00+10:00,2023-06-05,08:06,0,2,2
79,2023-06-05T08:06:00+10:00,2023-06-05,08:06,7,3,10
4,2023-06-05T08:05:00+10:00,2023-06-05,08:05,7,5,12
5,2023-06-05T08:05:00+10:00,2023-06-05,08:05,2,6,8
8,2023-06-05T08:05:00+10:00,2023-06-05,08:05,2,2,4
40,2023-06-05T08:05:00+10:00,2023-06-05,08:05,7,5,12
55,2023-06-05T08:05:00+10:00,2023-06-05,08:05,0,2,2
59,2023-06-05T08:05:00+10:00,2023-06-05,08:05,32,16,48
66,2023-06-05T08:05:00+10:00,2023-06-05,08:05,0,13,13
75,2023-06-05T08:05:00+10:00,2023-06-05,08:05,2,1,3
12,2023-06-05T08:05:00+10:00,2023-06-05,08:05,0,1,1
17,2023-06-05T08:05:00+10:00,2023-06-05,08:05,19,3,22
19,2023-06-05T08:05:00+10:00,2023-06-05,08:05,2,0,2
35,2023-06-05T08:05:00+10:00,2023-06-05,08:05,7,18,25
57,2023-06-05T08:05:00+10:00,2023-06-05,08:05,8,16,24
58,2023-06-05T08:05:00+10:00,2023-06-05,08:05,39,4,43
62,2023-06-05T08:05:00+10:00,2023-06-05,08:05,2,0,2
67,2023-06-05T08:05:00+10:00,2023-06-05,08:05,4,8,12
68,2023-06-05T08:05:00+10:00,2023-06-05,08:05,0,2,2
72,2023-06-05T08:05:00+10:00,2023-06-05,08:05,1,1,2
76,2023-06-05T08:05:00+10:00,2023-06-05,08:05,3,0,3
79,2023-06-05T08:05:00+10:00,2023-06-05,08:05,2,11,13
85,2023-06-05T08:05:00+10:00,2023-06-05,08:05,4,0,4
6,2023-06-05T08:05:00+10:00,2023-06-05,08:05,3,10,13
26,2023-06-05T08:05:00+10:00,2023-06-05,08:05,4,0,4
29,2023-06-05T08:05:00+10:00,2023-06-05,08:05,6,3,9
41,2023-06-05T08:05:00+10:00,2023-06-05,08:05,33,7,40
44,2023-06-05T08:05:00+10:00,2023-06-05,08:05,1,1,2
61,2023-06-05T08:05:00+10:00,2023-06-05,08:05,0,3,3
65,2023-06-05T08:05:00+10:00,2023-06-05,08:05,10,4,14
87,2023-06-05T08:05:00+10:00,2023-06-05,08:05,2,0,2
107,2023-06-05T08:05:00+10:00,2023-06-05,08:05,2,9,11
2,2023-06-05T08:05:00+10:00,2023-06-05,08:05,7,3,10
18,2023-06-05T08:05:00+10:00,2023-06-05,08:05,2,11,13
24,2023-06-05T08:05:00+10:00,2023-06-05,08:05,51,13,64
27,2023-06-05T08:05:00+10:00,2023-06-05,08:05,2,1,3
30,2023-06-05T08:05:00+10:00,2023-06-05,08:05,4,1,5
46,2023-06-05T08:05:00+10:00,2023-06-05,08:05,1,3,4
48,2023-06-05T08:05:00+10:00,2023-06-05,08:05,0,3,3
49,2023-06-05T08:05:00+10:00,2023-06-05,08:05,1,0,1
53,2023-06-05T08:05:00+10:00,2023-06-05,08:05,3,3,6
63,2023-06-05T08:05:00+10:00,2023-06-05,08:05,1,2,3
3,2023-06-05T08:05:00+10:00,2023-06-05,08:05,2,6,8
14,2023-06-05T08:05:00+10:00,2023-06-05,08:05,4,4,8
21,2023-06-05T08:05:00+10:00,2023-06-05,08:05,3,2,5
28,2023-06-05T08:05:00+10:00,2023-06-05,08:05,13,2,15
36,2023-06-05T08:05:00+10:00,2023-06-05,08:05,5,3,8
39,2023-06-05T08:05:00+10:00,2023-06-05,08:05,3,2,5
42,2023-06-05T08:05:00+10:00,2023-06-05,08:05,0,1,1
45,2023-06-05T08:05:00+10:00,2023-06-05,08:05,3,0,3
47,2023-06-05T08:05:00+10:00,2023-06-05,08:05,2,12,14
54,2023-06-05T08:05:00+10:00,2023-06-05,08:05,5,0,5
69,2023-06-05T08:05:00+10:00,2023-06-05,08:05,1,0,1
70,2023-06-05T08:05:00+10:00,2023-06-05,08:05,2,0,2
78,2023-06-05T08:05:00+10:00,2023-06-05,08:05,2,0,2
84,2023-06-05T08:05:00+10:00,2023-06-05,08:05,76,25,101
108,2023-06-05T08:05:00+10:00,2023-06-05,08:05,5,32,37
118,2023-06-05T08:05:00+10:00,2023-06-05,08:05,0,1,1
9,2023-06-05T08:05:00+10:00,2023-06-05,08:05,4,19,23
10,2023-06-05T08:05:00+10:00,2023-06-05,08:05,0,1,1
11,2023-06-05T08:05:00+10:00,2023-06-05,08:05,1,0,1
23,2023-06-05T08:05:00+10:00,2023-06-05,08:05,14,4,18
52,2023-06-05T08:05:00+10:00,2023-06-05,08:05,2,9,11
56,2023-06-05T08:05:00+10:00,2023-06-05,08:05,1,1,2
109,2023-06-05T08:05:00+10:00,2023-06-05,08:05,7,55,62
117,2023-06-05T08:05:00+10:00,2023-06-05,08:05,17,8,25
3,2023-06-05T08:04:00+10:00,2023-06-05,08:04,4,1,5
5,2023-06-05T08:04:00+10:00,2023-06-05,08:04,6,8,14
6,2023-06-05T08:04:00+10:00,2023-06-05,08:04,5,25,30
21,2023-06-05T08:04:00+10:00,2023-06-05,08:04,0,1,1
26,2023-06-05T08:04:00+10:00,2023-06-05,08:04,2,2,4
37,2023-06-05T08:04:00+10:00,2023-06-05,08:04,2,1,3
40,2023-06-05T08:04:00+10:00,2023-06-05,08:04,4,3,7
44,2023-06-05T08:04:00+10:00,2023-06-05,08:04,0,2,2
45,2023-06-05T08:04:00+10:00,2023-06-05,08:04,2,2,4
47,2023-06-05T08:04:00+10:00,2023-06-05,08:04,0,4,4
55,2023-06-05T08:04:00+10:00,2023-06-05,08:04,7,4,11
61,2023-06-05T08:04:00+10:00,2023-06-05,08:04,1,1,2
69,2023-06-05T08:04:00+10:00,2023-06-05,08:04,4,0,4
75,2023-06-05T08:04:00+10:00,2023-06-05,08:04,1,0,1
77,2023-06-05T08:04:00+10:00,2023-06-05,08:04,0,3,3
108,2023-06-05T08:04:00+10:00,2023-06-05,08:04,3,18,21
1,2023-06-05T08:04:00+10:00,2023-06-05,08:04,2,1,3
30,2023-06-05T08:04:00+10:00,2023-06-05,08:04,1,3,4
63,2023-06-05T08:04:00+10:00,2023-06-05,08:04,1,2,3
67,2023-06-05T08:04:00+10:00,2023-06-05,08:04,5,3,8
8,2023-06-05T08:04:00+10:00,2023-06-05,08:04,2,1,3
14,2023-06-05T08:04:00+10:00,2023-06-05,08:04,4,2,6
28,2023-06-05T08:04:00+10:00,2023-06-05,08:04,7,4,11
31,2023-06-05T08:04:00+10:00,2023-06-05,08:04,1,1,2
36,2023-06-05T08:04:00+10:00,2023-06-05,08:04,0,3,3
39,2023-06-05T08:04:00+10:00,2023-06-05,08:04,2,2,4
41,2023-06-05T08:04:00+10:00,2023-06-05,08:04,37,3,40
42,2023-06-05T08:04:00+10:00,2023-06-05,08:04,1,2,3
50,2023-06-05T08:04:00+10:00,2023-06-05,08:04,2,0,2
54,2023-06-05T08:04:00+10:00,2023-06-05,08:04,2,2,4
65,2023-06-05T08:04:00+10:00,2023-06-05,08:04,5,7,12
9,2023-06-05T08:04:00+10:00,2023-06-05,08:04,2,30,32
10,2023-06-05T08:04:00+10:00,2023-06-05,08:04,0,6,6
17,2023-06-05T08:04:00+10:00,2023-06-05,08:04,12,0,12
23,2023-06-05T08:04:00+10:00,2023-06-05,08:04,1,6,7
24,2023-06-05T08:04:00+10:00,2023-06-05,08:04,14,7,21
46,2023-06-05T08:04:00+10:00,2023-06-05,08:04,2,0,2
48,2023-06-05T08:04:00+10:00,2023-06-05,08:04,1,0,1
52,2023-06-05T08:04:00+10:00,2023-06-05,08:04,2,1,3
57,2023-06-05T08:04:00+10:00,2023-06-05,08:04,4,9,13
58,2023-06-05T08:04:00+10:00,2023-06-05,08:04,4,2,6
62,2023-06-05T08:04:00+10:00,2023-06-05,08:04,1,0,1
68,2023-06-05T08:04:00+10:00,2023-06-05,08:04,2,2,4
79,2023-06-05T08:04:00+10:00,2023-06-05,08:04,2,6,8
4,2023-06-05T08:04:00+10:00,2023-06-05,08:04,7,2,9
29,2023-06-05T08:04:00+10:00,2023-06-05,08:04,6,0,6
66,2023-06-05T08:04:00+10:00,2023-06-05,08:04,1,5,6
70,2023-06-05T08:04:00+10:00,2023-06-05,08:04,0,1,1
12,2023-06-05T08:04:00+10:00,2023-06-05,08:04,2,0,2
18,2023-06-05T08:04:00+10:00,2023-06-05,08:04,0,12,12
19,2023-06-05T08:04:00+10:00,2023-06-05,08:04,1,0,1
20,2023-06-05T08:04:00+10:00,2023-06-05,08:04,0,1,1
35,2023-06-05T08:04:00+10:00,2023-06-05,08:04,7,7,14
51,2023-06-05T08:04:00+10:00,2023-06-05,08:04,3,1,4
53,2023-06-05T08:04:00+10:00,2023-06-05,08:04,4,2,6
72,2023-06-05T08:04:00+10:00,2023-06-05,08:04,6,0,6
85,2023-06-05T08:04:00+10:00,2023-06-05,08:04,1,4,5
3,2023-06-05T08:03:00+10:00,2023-06-05,08:03,1,2,3
5,2023-06-05T08:03:00+10:00,2023-06-05,08:03,6,3,9
28,2023-06-05T08:03:00+10:00,2023-06-05,08:03,8,1,9
39,2023-06-05T08:03:00+10:00,2023-06-05,08:03,4,2,6
41,2023-06-05T08:03:00+10:00,2023-06-05,08:03,30,1,31
45,2023-06-05T08:03:00+10:00,2023-06-05,08:03,4,2,6
47,2023-06-05T08:03:00+10:00,2023-06-05,08:03,0,3,3
66,2023-06-05T08:03:00+10:00,2023-06-05,08:03,0,6,6
87,2023-06-05T08:03:00+10:00,2023-06-05,08:03,1,1,2
108,2023-06-05T08:03:00+10:00,2023-06-05,08:03,2,11,13
10,2023-06-05T08:03:00+10:00,2023-06-05,08:03,0,2,2
19,2023-06-05T08:03:00+10:00,2023-06-05,08:03,1,2,3
30,2023-06-05T08:03:00+10:00,2023-06-05,08:03,1,1,2
35,2023-06-05T08:03:00+10:00,2023-06-05,08:03,6,14,20
46,2023-06-05T08:03:00+10:00,2023-06-05,08:03,2,0,2
57,2023-06-05T08:03:00+10:00,2023-06-05,08:03,0,15,15
63,2023-06-05T08:03:00+10:00,2023-06-05,08:03,0,2,2
79,2023-06-05T08:03:00+10:00,2023-06-05,08:03,14,13,27
85,2023-06-05T08:03:00+10:00,2023-06-05,08:03,1,2,3
4,2023-06-05T08:03:00+10:00,2023-06-05,08:03,10,2,12
6,2023-06-05T08:03:00+10:00,2023-06-05,08:03,8,18,26
8,2023-06-05T08:03:00+10:00,2023-06-05,08:03,3,4,7
14,2023-06-05T08:03:00+10:00,2023-06-05,08:03,3,5,8
21,2023-06-05T08:03:00+10:00,2023-06-05,08:03,0,1,1
26,2023-06-05T08:03:00+10:00,2023-06-05,08:03,1,2,3
36,2023-06-05T08:03:00+10:00,2023-06-05,08:03,4,0,4
54,2023-06-05T08:03:00+10:00,2023-06-05,08:03,6,5,11
55,2023-06-05T08:03:00+10:00,2023-06-05,08:03,6,9,15
65,2023-06-05T08:03:00+10:00,2023-06-05,08:03,3,4,7
77,2023-06-05T08:03:00+10:00,2023-06-05,08:03,2,2,4
1,2023-06-05T08:03:00+10:00,2023-06-05,08:03,2,2,4
2,2023-06-05T08:03:00+10:00,2023-06-05,08:03,1,1,2
9,2023-06-05T08:03:00+10:00,2023-06-05,08:03,1,19,20
11,2023-06-05T08:03:00+10:00,2023-06-05,08:03,1,0,1
23,2023-06-05T08:03:00+10:00,2023-06-05,08:03,2,7,9
62,2023-06-05T08:03:00+10:00,2023-06-05,08:03,3,3,6
67,2023-06-05T08:03:00+10:00,2023-06-05,08:03,6,10,16
68,2023-06-05T08:03:00+10:00,2023-06-05,08:03,3,3,6
72,2023-06-05T08:03:00+10:00,2023-06-05,08:03,24,6,30
86,2023-06-05T08:03:00+10:00,2023-06-05,08:03,1,2,3
31,2023-06-05T08:03:00+10:00,2023-06-05,08:03,1,1,2
37,2023-06-05T08:03:00+10:00,2023-06-05,08:03,1,0,1
40,2023-06-05T08:03:00+10:00,2023-06-05,08:03,3,0,3
42,2023-06-05T08:03:00+10:00,2023-06-05,08:03,0,1,1
61,2023-06-05T08:03:00+10:00,2023-06-05,08:03,7,5,12
69,2023-06-05T08:03:00+10:00,2023-06-05,08:03,4,1,5
75,2023-06-05T08:03:00+10:00,2023-06-05,08:03,0,2,2
17,2023-06-05T08:03:00+10:00,2023-06-05,08:03,18,4,22
18,2023-06-05T08:03:00+10:00,2023-06-05,08:03,2,14,16
24,2023-06-05T08:03:00+10:00,2023-06-05,08:03,41,6,47
27,2023-06-05T08:03:00+10:00,2023-06-05,08:03,3,1,4
48,2023-06-05T08:03:00+10:00,2023-06-05,08:03,2,1,3
51,2023-06-05T08:03:00+10:00,2023-06-05,08:03,2,0,2
52,2023-06-05T08:03:00+10:00,2023-06-05,08:03,3,6,9
53,2023-06-05T08:03:00+10:00,2023-06-05,08:03,5,3,8
58,2023-06-05T08:03:00+10:00,2023-06-05,08:03,24,6,30
3,2023-06-05T08:02:00+10:00,2023-06-05,08:02,2,4,6
14,2023-06-05T08:02:00+10:00,2023-06-05,08:02,2,5,7
28,2023-06-05T08:02:00+10:00,2023-06-05,08:02,8,1,9
29,2023-06-05T08:02:00+10:00,2023-06-05,08:02,0,1,1
40,2023-06-05T08:02:00+10:00,2023-06-05,08:02,1,2,3
41,2023-06-05T08:02:00+10:00,2023-06-05,08:02,27,1,28
44,2023-06-05T08:02:00+10:00,2023-06-05,08:02,0,2,2
87,2023-06-05T08:02:00+10:00,2023-06-05,08:02,1,1,2
1,2023-06-05T08:02:00+10:00,2023-06-05,08:02,2,1,3
18,2023-06-05T08:02:00+10:00,2023-06-05,08:02,1,17,18
19,2023-06-05T08:02:00+10:00,2023-06-05,08:02,0,1,1
24,2023-06-05T08:02:00+10:00,2023-06-05,08:02,12,11,23
46,2023-06-05T08:02:00+10:00,2023-06-05,08:02,1,1,2
48,2023-06-05T08:02:00+10:00,2023-06-05,08:02,2,0,2
53,2023-06-05T08:02:00+10:00,2023-06-05,08:02,5,2,7
58,2023-06-05T08:02:00+10:00,2023-06-05,08:02,18,4,22
72,2023-06-05T08:02:00+10:00,2023-06-05,08:02,1,2,3
85,2023-06-05T08:02:00+10:00,2023-06-05,08:02,1,0,1
6,2023-06-05T08:02:00+10:00,2023-06-05,08:02,15,9,24
36,2023-06-05T08:02:00+10:00,2023-06-05,08:02,10,1,11
37,2023-06-05T08:02:00+10:00,2023-06-05,08:02,0,1,1
45,2023-06-05T08:02:00+10:00,2023-06-05,08:02,1,0,1
50,2023-06-05T08:02:00+10:00,2023-06-05,08:02,2,2,4
55,2023-06-05T08:02:00+10:00,2023-06-05,08:02,1,4,5
65,2023-06-05T08:02:00+10:00,2023-06-05,08:02,2,0,2
69,2023-06-05T08:02:00+10:00,2023-06-05,08:02,3,2,5
70,2023-06-05T08:02:00+10:00,2023-06-05,08:02,1,1,2
9,2023-06-05T08:02:00+10:00,2023-06-05,08:02,0,4,4
10,2023-06-05T08:02:00+10:00,2023-06-05,08:02,1,4,5
23,2023-06-05T08:02:00+10:00,2023-06-05,08:02,4,1,5
35,2023-06-05T08:02:00+10:00,2023-06-05,08:02,9,12,21
56,2023-06-05T08:02:00+10:00,2023-06-05,08:02,2,2,4
62,2023-06-05T08:02:00+10:00,2023-06-05,08:02,2,1,3
63,2023-06-05T08:02:00+10:00,2023-06-05,08:02,0,2,2
76,2023-06-05T08:02:00+10:00,2023-06-05,08:02,1,0,1
79,2023-06-05T08:02:00+10:00,2023-06-05,08:02,13,8,21
4,2023-06-05T08:02:00+10:00,2023-06-05,08:02,6,5,11
5,2023-06-05T08:02:00+10:00,2023-06-05,08:02,5,14,19
8,2023-06-05T08:02:00+10:00,2023-06-05,08:02,1,1,2
21,2023-06-05T08:02:00+10:00,2023-06-05,08:02,0,1,1
31,2023-06-05T08:02:00+10:00,2023-06-05,08:02,1,0,1
39,2023-06-05T08:02:00+10:00,2023-06-05,08:02,3,0,3
42,2023-06-05T08:02:00+10:00,2023-06-05,08:02,1,1,2
47,2023-06-05T08:02:00+10:00,2023-06-05,08:02,1,6,7
61,2023-06-05T08:02:00+10:00,2023-06-05,08:02,3,3,6
66,2023-06-05T08:02:00+10:00,2023-06-05,08:02,3,2,5
71,2023-06-05T08:02:00+10:00,2023-06-05,08:02,0,1,1
75,2023-06-05T08:02:00+10:00,2023-06-05,08:02,2,0,2
77,2023-06-05T08:02:00+10:00,2023-06-05,08:02,1,0,1
108,2023-06-05T08:02:00+10:00,2023-06-05,08:02,0,13,13
2,2023-06-05T08:02:00+10:00,2023-06-05,08:02,2,1,3
12,2023-06-05T08:02:00+10:00,2023-06-05,08:02,4,1,5
17,2023-06-05T08:02:00+10:00,2023-06-05,08:02,8,2,10
27,2023-06-05T08:02:00+10:00,2023-06-05,08:02,1,0,1
52,2023-06-05T08:02:00+10:00,2023-06-05,08:02,3,2,5
57,2023-06-05T08:02:00+10:00,2023-06-05,08:02,5,8,13
67,2023-06-05T08:02:00+10:00,2023-06-05,08:02,3,3,6
68,2023-06-05T08:02:00+10:00,2023-06-05,08:02,2,2,4
4,2023-06-05T08:01:00+10:00,2023-06-05,08:01,7,8,15
5,2023-06-05T08:01:00+10:00,2023-06-05,08:01,6,18,24
6,2023-06-05T08:01:00+10:00,2023-06-05,08:01,2,14,16
8,2023-06-05T08:01:00+10:00,2023-06-05,08:01,4,2,6
14,2023-06-05T08:01:00+10:00,2023-06-05,08:01,3,1,4
40,2023-06-05T08:01:00+10:00,2023-06-05,08:01,3,4,7
41,2023-06-05T08:01:00+10:00,2023-06-05,08:01,15,1,16
45,2023-06-05T08:01:00+10:00,2023-06-05,08:01,0,6,6
65,2023-06-05T08:01:00+10:00,2023-06-05,08:01,8,3,11
66,2023-06-05T08:01:00+10:00,2023-06-05,08:01,0,2,2
2,2023-06-05T08:01:00+10:00,2023-06-05,08:01,0,1,1
10,2023-06-05T08:01:00+10:00,2023-06-05,08:01,0,4,4
11,2023-06-05T08:01:00+10:00,2023-06-05,08:01,1,0,1
24,2023-06-05T08:01:00+10:00,2023-06-05,08:01,13,8,21
30,2023-06-05T08:01:00+10:00,2023-06-05,08:01,3,0,3
35,2023-06-05T08:01:00+10:00,2023-06-05,08:01,8,9,17
46,2023-06-05T08:01:00+10:00,2023-06-05,08:01,1,0,1
51,2023-06-05T08:01:00+10:00,2023-06-05,08:01,1,0,1
62,2023-06-05T08:01:00+10:00,2023-06-05,08:01,1,1,2
68,2023-06-05T08:01:00+10:00,2023-06-05,08:01,5,0,5
72,2023-06-05T08:01:00+10:00,2023-06-05,08:01,3,4,7
3,2023-06-05T08:01:00+10:00,2023-06-05,08:01,1,1,2
28,2023-06-05T08:01:00+10:00,2023-06-05,08:01,7,2,9
29,2023-06-05T08:01:00+10:00,2023-06-05,08:01,0,1,1
36,2023-06-05T08:01:00+10:00,2023-06-05,08:01,1,1,2
42,2023-06-05T08:01:00+10:00,2023-06-05,08:01,1,3,4
47,2023-06-05T08:01:00+10:00,2023-06-05,08:01,0,4,4
54,2023-06-05T08:01:00+10:00,2023-06-05,08:01,4,7,11
55,2023-06-05T08:01:00+10:00,2023-06-05,08:01,5,4,9
61,2023-06-05T08:01:00+10:00,2023-06-05,08:01,7,6,13
78,2023-06-05T08:01:00+10:00,2023-06-05,08:01,2,0,2
87,2023-06-05T08:01:00+10:00,2023-06-05,08:01,2,1,3
9,2023-06-05T08:01:00+10:00,2023-06-05,08:01,4,12,16
17,2023-06-05T08:01:00+10:00,2023-06-05,08:01,11,9,20
52,2023-06-05T08:01:00+10:00,2023-06-05,08:01,0,4,4
56,2023-06-05T08:01:00+10:00,2023-06-05,08:01,0,2,2
63,2023-06-05T08:01:00+10:00,2023-06-05,08:01,4,2,6
67,2023-06-05T08:01:00+10:00,2023-06-05,08:01,4,3,7
85,2023-06-05T08:01:00+10:00,2023-06-05,08:01,3,0,3
86,2023-06-05T08:01:00+10:00,2023-06-05,08:01,2,0,2
26,2023-06-05T08:01:00+10:00,2023-06-05,08:01,4,4,8
39,2023-06-05T08:01:00+10:00,2023-06-05,08:01,1,1,2
50,2023-06-05T08:01:00+10:00,2023-06-05,08:01,0,1,1
71,2023-06-05T08:01:00+10:00,2023-06-05,08:01,1,1,2
77,2023-06-05T08:01:00+10:00,2023-06-05,08:01,4,2,6
108,2023-06-05T08:01:00+10:00,2023-06-05,08:01,1,13,14
1,2023-06-05T08:01:00+10:00,2023-06-05,08:01,1,2,3
12,2023-06-05T08:01:00+10:00,2023-06-05,08:01,3,1,4
18,2023-06-05T08:01:00+10:00,2023-06-05,08:01,1,6,7
23,2023-06-05T08:01:00+10:00,2023-06-05,08:01,1,4,5
48,2023-06-05T08:01:00+10:00,2023-06-05,08:01,0,1,1
53,2023-06-05T08:01:00+10:00,2023-06-05,08:01,0,5,5
57,2023-06-05T08:01:00+10:00,2023-06-05,08:01,2,4,6
58,2023-06-05T08:01:00+10:00,2023-06-05,08:01,1,2,3
79,2023-06-05T08:01:00+10:00,2023-06-05,08:01,4,2,6
3,2023-06-05T08:00:00+10:00,2023-06-05,08:00,3,2,5
5,2023-06-05T08:00:00+10:00,2023-06-05,08:00,5,6,11
21,2023-06-05T08:00:00+10:00,2023-06-05,08:00,1,1,2
36,2023-06-05T08:00:00+10:00,2023-06-05,08:00,3,1,4
39,2023-06-05T08:00:00+10:00,2023-06-05,08:00,2,3,5
41,2023-06-05T08:00:00+10:00,2023-06-05,08:00,12,7,19
54,2023-06-05T08:00:00+10:00,2023-06-05,08:00,0,2,2
61,2023-06-05T08:00:00+10:00,2023-06-05,08:00,2,1,3
70,2023-06-05T08:00:00+10:00,2023-06-05,08:00,3,1,4
75,2023-06-05T08:00:00+10:00,2023-06-05,08:00,1,0,1
118,2023-06-05T08:00:00+10:00,2023-06-05,08:00,1,0,1
9,2023-06-05T08:00:00+10:00,2023-06-05,08:00,0,16,16
11,2023-06-05T08:00:00+10:00,2023-06-05,08:00,4,1,5
35,2023-06-05T08:00:00+10:00,2023-06-05,08:00,4,9,13
46,2023-06-05T08:00:00+10:00,2023-06-05,08:00,1,1,2
48,2023-06-05T08:00:00+10:00,2023-06-05,08:00,1,3,4
51,2023-06-05T08:00:00+10:00,2023-06-05,08:00,3,0,3
62,2023-06-05T08:00:00+10:00,2023-06-05,08:00,1,0,1
67,2023-06-05T08:00:00+10:00,2023-06-05,08:00,3,5,8
68,2023-06-05T08:00:00+10:00,2023-06-05,08:00,2,2,4
76,2023-06-05T08:00:00+10:00,2023-06-05,08:00,0,1,1
86,2023-06-05T08:00:00+10:00,2023-06-05,08:00,1,0,1
117,2023-06-05T08:00:00+10:00,2023-06-05,08:00,19,4,23
6,2023-06-05T08:00:00+10:00,2023-06-05,08:00,11,18,29
8,2023-06-05T08:00:00+10:00,2023-06-05,08:00,1,2,3
14,2023-06-05T08:00:00+10:00,2023-06-05,08:00,5,4,9
26,2023-06-05T08:00:00+10:00,2023-06-05,08:00,1,2,3
31,2023-06-05T08:00:00+10:00,2023-06-05,08:00,1,2,3
40,2023-06-05T08:00:00+10:00,2023-06-05,08:00,8,3,11
55,2023-06-05T08:00:00+10:00,2023-06-05,08:00,5,2,7
65,2023-06-05T08:00:00+10:00,2023-06-05,08:00,5,2,7
66,2023-06-05T08:00:00+10:00,2023-06-05,08:00,1,2,3
69,2023-06-05T08:00:00+10:00,2023-06-05,08:00,1,0,1
78,2023-06-05T08:00:00+10:00,2023-06-05,08:00,2,0,2
87,2023-06-05T08:00:00+10:00,2023-06-05,08:00,0,2,2
108,2023-06-05T08:00:00+10:00,2023-06-05,08:00,6,25,31
1,2023-06-05T08:00:00+10:00,2023-06-05,08:00,2,1,3
2,2023-06-05T08:00:00+10:00,2023-06-05,08:00,0,1,1
10,2023-06-05T08:00:00+10:00,2023-06-05,08:00,3,6,9
17,2023-06-05T08:00:00+10:00,2023-06-05,08:00,12,1,13
18,2023-06-05T08:00:00+10:00,2023-06-05,08:00,0,6,6
23,2023-06-05T08:00:00+10:00,2023-06-05,08:00,16,3,19
52,2023-06-05T08:00:00+10:00,2023-06-05,08:00,3,3,6
58,2023-06-05T08:00:00+10:00,2023-06-05,08:00,36,2,38
63,2023-06-05T08:00:00+10:00,2023-06-05,08:00,2,1,3
72,2023-06-05T08:00:00+10:00,2023-06-05,08:00,6,0,6
79,2023-06-05T08:00:00+10:00,2023-06-05,08:00,9,3,12
85,2023-06-05T08:00:00+10:00,2023-06-05,08:00,4,0,4
4,2023-06-05T08:00:00+10:00,2023-06-05,08:00,11,4,15
28,2023-06-05T08:00:00+10:00,2023-06-05,08:00,15,4,19
29,2023-06-05T08:00:00+10:00,2023-06-05,08:00,1,0,1
45,2023-06-05T08:00:00+10:00,2023-06-05,08:00,3,2,5
59,2023-06-05T08:00:00+10:00,2023-06-05,08:00,24,11,35
77,2023-06-05T08:00:00+10:00,2023-06-05,08:00,3,5,8
84,2023-06-05T08:00:00+10:00,2023-06-05,08:00,72,20,92
107,2023-06-05T08:00:00+10:00,2023-06-05,08:00,4,13,17
12,2023-06-05T08:00:00+10:00,2023-06-05,08:00,3,2,5
20,2023-06-05T08:00:00+10:00,2023-06-05,08:00,1,0,1
24,2023-06-05T08:00:00+10:00,2023-06-05,08:00,25,1,26
27,2023-06-05T08:00:00+10:00,2023-06-05,08:00,0,3,3
53,2023-06-05T08:00:00+10:00,2023-06-05,08:00,8,1,9
56,2023-06-05T08:00:00+10:00,2023-06-05,08:00,4,1,5
57,2023-06-05T08:00:00+10:00,2023-06-05,08:00,3,6,9
109,2023-06-05T08:00:00+10:00,2023-06-05,08:00,5,45,50
6,2023-06-05T07:59:00+10:00,2023-06-05,07:59,5,3,8
14,2023-06-05T07:59:00+10:00,2023-06-05,07:59,2,2,4
21,2023-06-05T07:59:00+10:00,2023-06-05,07:59,0,2,2
26,2023-06-05T07:59:00+10:00,2023-06-05,07:59,0,1,1
29,2023-06-05T07:59:00+10:00,2023-06-05,07:59,2,4,6
36,2023-06-05T07:59:00+10:00,2023-06-05,07:59,1,1,2
39,2023-06-05T07:59:00+10:00,2023-06-05,07:59,0,2,2
41,2023-06-05T07:59:00+10:00,2023-06-05,07:59,15,8,23
42,2023-06-05T07:59:00+10:00,2023-06-05,07:59,1,0,1
45,2023-06-05T07:59:00+10:00,2023-06-05,07:59,4,2,6
54,2023-06-05T07:59:00+10:00,2023-06-05,07:59,0,1,1
55,2023-06-05T07:59:00+10:00,2023-06-05,07:59,1,3,4
70,2023-06-05T07:59:00+10:00,2023-06-05,07:59,0,1,1
87,2023-06-05T07:59:00+10:00,2023-06-05,07:59,1,1,2
108,2023-06-05T07:59:00+10:00,2023-06-05,07:59,1,11,12
2,2023-06-05T07:59:00+10:00,2023-06-05,07:59,2,3,5
17,2023-06-05T07:59:00+10:00,2023-06-05,07:59,7,1,8
24,2023-06-05T07:59:00+10:00,2023-06-05,07:59,4,15,19
52,2023-06-05T07:59:00+10:00,2023-06-05,07:59,2,3,5
57,2023-06-05T07:59:00+10:00,2023-06-05,07:59,0,4,4
58,2023-06-05T07:59:00+10:00,2023-06-05,07:59,7,0,7
62,2023-06-05T07:59:00+10:00,2023-06-05,07:59,2,2,4
72,2023-06-05T07:59:00+10:00,2023-06-05,07:59,6,1,7
4,2023-06-05T07:59:00+10:00,2023-06-05,07:59,10,10,20
5,2023-06-05T07:59:00+10:00,2023-06-05,07:59,3,10,13
8,2023-06-05T07:59:00+10:00,2023-06-05,07:59,1,1,2
28,2023-06-05T07:59:00+10:00,2023-06-05,07:59,12,1,13
47,2023-06-05T07:59:00+10:00,2023-06-05,07:59,3,13,16
69,2023-06-05T07:59:00+10:00,2023-06-05,07:59,1,0,1
77,2023-06-05T07:59:00+10:00,2023-06-05,07:59,3,2,5
18,2023-06-05T07:59:00+10:00,2023-06-05,07:59,0,4,4
30,2023-06-05T07:59:00+10:00,2023-06-05,07:59,1,0,1
53,2023-06-05T07:59:00+10:00,2023-06-05,07:59,6,4,10
63,2023-06-05T07:59:00+10:00,2023-06-05,07:59,2,2,4
67,2023-06-05T07:59:00+10:00,2023-06-05,07:59,5,2,7
68,2023-06-05T07:59:00+10:00,2023-06-05,07:59,1,2,3
79,2023-06-05T07:59:00+10:00,2023-06-05,07:59,6,5,11
3,2023-06-05T07:59:00+10:00,2023-06-05,07:59,4,1,5
31,2023-06-05T07:59:00+10:00,2023-06-05,07:59,1,0,1
40,2023-06-05T07:59:00+10:00,2023-06-05,07:59,4,3,7
44,2023-06-05T07:59:00+10:00,2023-06-05,07:59,0,3,3
50,2023-06-05T07:59:00+10:00,2023-06-05,07:59,0,4,4
61,2023-06-05T07:59:00+10:00,2023-06-05,07:59,1,7,8
65,2023-06-05T07:59:00+10:00,2023-06-05,07:59,2,2,4
66,2023-06-05T07:59:00+10:00,2023-06-05,07:59,2,5,7
78,2023-06-05T07:59:00+10:00,2023-06-05,07:59,2,1,3
1,2023-06-05T07:59:00+10:00,2023-06-05,07:59,0,3,3
9,2023-06-05T07:59:00+10:00,2023-06-05,07:59,0,22,22
10,2023-06-05T07:59:00+10:00,2023-06-05,07:59,0,3,3
23,2023-06-05T07:59:00+10:00,2023-06-05,07:59,2,4,6
35,2023-06-05T07:59:00+10:00,2023-06-05,07:59,2,9,11
48,2023-06-05T07:59:00+10:00,2023-06-05,07:59,3,3,6
56,2023-06-05T07:59:00+10:00,2023-06-05,07:59,1,5,6
76,2023-06-05T07:59:00+10:00,2023-06-05,07:59,6,0,6
85,2023-06-05T07:59:00+10:00,2023-06-05,07:59,4,0,4
6,2023-06-05T07:58:00+10:00,2023-06-05,07:58,3,10,13
8,2023-06-05T07:58:00+10:00,2023-06-05,07:58,2,0,2
29,2023-06-05T07:58:00+10:00,2023-06-05,07:58,0,1,1
37,2023-06-05T07:58:00+10:00,2023-06-05,07:58,0,2,2
39,2023-06-05T07:58:00+10:00,2023-06-05,07:58,1,0,1
40,2023-06-05T07:58:00+10:00,2023-06-05,07:58,9,3,12
42,2023-06-05T07:58:00+10:00,2023-06-05,07:58,0,2,2
47,2023-06-05T07:58:00+10:00,2023-06-05,07:58,2,8,10
54,2023-06-05T07:58:00+10:00,2023-06-05,07:58,1,2,3
55,2023-06-05T07:58:00+10:00,2023-06-05,07:58,1,8,9
65,2023-06-05T07:58:00+10:00,2023-06-05,07:58,1,3,4
66,2023-06-05T07:58:00+10:00,2023-06-05,07:58,2,3,5
69,2023-06-05T07:58:00+10:00,2023-06-05,07:58,4,0,4
70,2023-06-05T07:58:00+10:00,2023-06-05,07:58,1,1,2
108,2023-06-05T07:58:00+10:00,2023-06-05,07:58,1,21,22
10,2023-06-05T07:58:00+10:00,2023-06-05,07:58,0,6,6
17,2023-06-05T07:58:00+10:00,2023-06-05,07:58,9,0,9
18,2023-06-05T07:58:00+10:00,2023-06-05,07:58,0,3,3
20,2023-06-05T07:58:00+10:00,2023-06-05,07:58,1,0,1
35,2023-06-05T07:58:00+10:00,2023-06-05,07:58,5,18,23
52,2023-06-05T07:58:00+10:00,2023-06-05,07:58,2,2,4
58,2023-06-05T07:58:00+10:00,2023-06-05,07:58,24,5,29
62,2023-06-05T07:58:00+10:00,2023-06-05,07:58,3,2,5
86,2023-06-05T07:58:00+10:00,2023-06-05,07:58,1,0,1
14,2023-06-05T07:58:00+10:00,2023-06-05,07:58,2,9,11
26,2023-06-05T07:58:00+10:00,2023-06-05,07:58,2,3,5
28,2023-06-05T07:58:00+10:00,2023-06-05,07:58,11,10,21
36,2023-06-05T07:58:00+10:00,2023-06-05,07:58,2,1,3
45,2023-06-05T07:58:00+10:00,2023-06-05,07:58,6,3,9
61,2023-06-05T07:58:00+10:00,2023-06-05,07:58,4,2,6
77,2023-06-05T07:58:00+10:00,2023-06-05,07:58,1,2,3
78,2023-06-05T07:58:00+10:00,2023-06-05,07:58,2,0,2
1,2023-06-05T07:58:00+10:00,2023-06-05,07:58,1,5,6
2,2023-06-05T07:58:00+10:00,2023-06-05,07:58,2,4,6
23,2023-06-05T07:58:00+10:00,2023-06-05,07:58,8,4,12
24,2023-06-05T07:58:00+10:00,2023-06-05,07:58,30,2,32
30,2023-06-05T07:58:00+10:00,2023-06-05,07:58,2,2,4
48,2023-06-05T07:58:00+10:00,2023-06-05,07:58,1,1,2
49,2023-06-05T07:58:00+10:00,2023-06-05,07:58,0,1,1
53,2023-06-05T07:58:00+10:00,2023-06-05,07:58,4,1,5
67,2023-06-05T07:58:00+10:00,2023-06-05,07:58,5,1,6
68,2023-06-05T07:58:00+10:00,2023-06-05,07:58,1,0,1
72,2023-06-05T07:58:00+10:00,2023-06-05,07:58,3,1,4
79,2023-06-05T07:58:00+10:00,2023-06-05,07:58,2,4,6
85,2023-06-05T07:58:00+10:00,2023-06-05,07:58,1,3,4
3,2023-06-05T07:58:00+10:00,2023-06-05,07:58,8,2,10
4,2023-06-05T07:58:00+10:00,2023-06-05,07:58,6,0,6
5,2023-06-05T07:58:00+10:00,2023-06-05,07:58,2,10,12
21,2023-06-05T07:58:00+10:00,2023-06-05,07:58,3,5,8
41,2023-06-05T07:58:00+10:00,2023-06-05,07:58,12,15,27
44,2023-06-05T07:58:00+10:00,2023-06-05,07:58,0,3,3
9,2023-06-05T07:58:00+10:00,2023-06-05,07:58,1,30,31
46,2023-06-05T07:58:00+10:00,2023-06-05,07:58,1,2,3
57,2023-06-05T07:58:00+10:00,2023-06-05,07:58,3,5,8
63,2023-06-05T07:58:00+10:00,2023-06-05,07:58,1,1,2
6,2023-06-05T07:57:00+10:00,2023-06-05,07:57,4,16,20
8,2023-06-05T07:57:00+10:00,2023-06-05,07:57,5,1,6
14,2023-06-05T07:57:00+10:00,2023-06-05,07:57,8,1,9
28,2023-06-05T07:57:00+10:00,2023-06-05,07:57,3,1,4
39,2023-06-05T07:57:00+10:00,2023-06-05,07:57,3,3,6
47,2023-06-05T07:57:00+10:00,2023-06-05,07:57,2,9,11
65,2023-06-05T07:57:00+10:00,2023-06-05,07:57,2,6,8
77,2023-06-05T07:57:00+10:00,2023-06-05,07:57,1,1,2
78,2023-06-05T07:57:00+10:00,2023-06-05,07:57,0,1,1
87,2023-06-05T07:57:00+10:00,2023-06-05,07:57,0,2,2
1,2023-06-05T07:57:00+10:00,2023-06-05,07:57,4,2,6
9,2023-06-05T07:57:00+10:00,2023-06-05,07:57,3,14,17
18,2023-06-05T07:57:00+10:00,2023-06-05,07:57,1,10,11
30,2023-06-05T07:57:00+10:00,2023-06-05,07:57,4,0,4
49,2023-06-05T07:57:00+10:00,2023-06-05,07:57,2,2,4
51,2023-06-05T07:57:00+10:00,2023-06-05,07:57,0,1,1
52,2023-06-05T07:57:00+10:00,2023-06-05,07:57,1,1,2
56,2023-06-05T07:57:00+10:00,2023-06-05,07:57,2,1,3
57,2023-06-05T07:57:00+10:00,2023-06-05,07:57,9,11,20
58,2023-06-05T07:57:00+10:00,2023-06-05,07:57,7,0,7
68,2023-06-05T07:57:00+10:00,2023-06-05,07:57,1,2,3
76,2023-06-05T07:57:00+10:00,2023-06-05,07:57,0,2,2
3,2023-06-05T07:57:00+10:00,2023-06-05,07:57,11,2,13
4,2023-06-05T07:57:00+10:00,2023-06-05,07:57,16,5,21
26,2023-06-05T07:57:00+10:00,2023-06-05,07:57,6,1,7
29,2023-06-05T07:57:00+10:00,2023-06-05,07:57,2,1,3
41,2023-06-05T07:57:00+10:00,2023-06-05,07:57,22,2,24
42,2023-06-05T07:57:00+10:00,2023-06-05,07:57,1,4,5
44,2023-06-05T07:57:00+10:00,2023-06-05,07:57,0,1,1
50,2023-06-05T07:57:00+10:00,2023-06-05,07:57,0,4,4
55,2023-06-05T07:57:00+10:00,2023-06-05,07:57,1,4,5
66,2023-06-05T07:57:00+10:00,2023-06-05,07:57,1,4,5
69,2023-06-05T07:57:00+10:00,2023-06-05,07:57,1,0,1
11,2023-06-05T07:57:00+10:00,2023-06-05,07:57,1,0,1
12,2023-06-05T07:57:00+10:00,2023-06-05,07:57,2,2,4
17,2023-06-05T07:57:00+10:00,2023-06-05,07:57,10,0,10
48,2023-06-05T07:57:00+10:00,2023-06-05,07:57,1,0,1
62,2023-06-05T07:57:00+10:00,2023-06-05,07:57,4,0,4
63,2023-06-05T07:57:00+10:00,2023-06-05,07:57,3,2,5
85,2023-06-05T07:57:00+10:00,2023-06-05,07:57,4,0,4
5,2023-06-05T07:57:00+10:00,2023-06-05,07:57,4,23,27
21,2023-06-05T07:57:00+10:00,2023-06-05,07:57,0,1,1
36,2023-06-05T07:57:00+10:00,2023-06-05,07:57,3,1,4
37,2023-06-05T07:57:00+10:00,2023-06-05,07:57,1,0,1
40,2023-06-05T07:57:00+10:00,2023-06-05,07:57,2,4,6
45,2023-06-05T07:57:00+10:00,2023-06-05,07:57,2,3,5
54,2023-06-05T07:57:00+10:00,2023-06-05,07:57,1,0,1
61,2023-06-05T07:57:00+10:00,2023-06-05,07:57,1,1,2
70,2023-06-05T07:57:00+10:00,2023-06-05,07:57,1,0,1
75,2023-06-05T07:57:00+10:00,2023-06-05,07:57,1,1,2
108,2023-06-05T07:57:00+10:00,2023-06-05,07:57,1,15,16
2,2023-06-05T07:57:00+10:00,2023-06-05,07:57,0,2,2
10,2023-06-05T07:57:00+10:00,2023-06-05,07:57,0,3,3
23,2023-06-05T07:57:00+10:00,2023-06-05,07:57,9,1,10
24,2023-06-05T07:57:00+10:00,2023-06-05,07:57,21,8,29
27,2023-06-05T07:57:00+10:00,2023-06-05,07:57,2,0,2
35,2023-06-05T07:57:00+10:00,2023-06-05,07:57,5,15,20
46,2023-06-05T07:57:00+10:00,2023-06-05,07:57,0,1,1
53,2023-06-05T07:57:00+10:00,2023-06-05,07:57,4,3,7
67,2023-06-05T07:57:00+10:00,2023-06-05,07:57,1,2,3
72,2023-06-05T07:57:00+10:00,2023-06-05,07:57,9,1,10
79,2023-06-05T07:57:00+10:00,2023-06-05,07:57,9,3,12
4,2023-06-05T07:56:00+10:00,2023-06-05,07:56,20,4,24
5,2023-06-05T07:56:00+10:00,2023-06-05,07:56,5,23,28
14,2023-06-05T07:56:00+10:00,2023-06-05,07:56,6,2,8
26,2023-06-05T07:56:00+10:00,2023-06-05,07:56,2,1,3
41,2023-06-05T07:56:00+10:00,2023-06-05,07:56,22,8,30
42,2023-06-05T07:56:00+10:00,2023-06-05,07:56,0,1,1
70,2023-06-05T07:56:00+10:00,2023-06-05,07:56,3,1,4
78,2023-06-05T07:56:00+10:00,2023-06-05,07:56,1,0,1
87,2023-06-05T07:56:00+10:00,2023-06-05,07:56,2,0,2
2,2023-06-05T07:56:00+10:00,2023-06-05,07:56,0,4,4
10,2023-06-05T07:56:00+10:00,2023-06-05,07:56,0,5,5
23,2023-06-05T07:56:00+10:00,2023-06-05,07:56,1,2,3
53,2023-06-05T07:56:00+10:00,2023-06-05,07:56,1,1,2
58,2023-06-05T07:56:00+10:00,2023-06-05,07:56,16,1,17
67,2023-06-05T07:56:00+10:00,2023-06-05,07:56,1,2,3
72,2023-06-05T07:56:00+10:00,2023-06-05,07:56,8,1,9
79,2023-06-05T07:56:00+10:00,2023-06-05,07:56,0,4,4
3,2023-06-05T07:56:00+10:00,2023-06-05,07:56,6,4,10
6,2023-06-05T07:56:00+10:00,2023-06-05,07:56,9,14,23
8,2023-06-05T07:56:00+10:00,2023-06-05,07:56,2,0,2
36,2023-06-05T07:56:00+10:00,2023-06-05,07:56,6,1,7
40,2023-06-05T07:56:00+10:00,2023-06-05,07:56,5,3,8
45,2023-06-05T07:56:00+10:00,2023-06-05,07:56,3,4,7
47,2023-06-05T07:56:00+10:00,2023-06-05,07:56,2,12,14
54,2023-06-05T07:56:00+10:00,2023-06-05,07:56,2,1,3
65,2023-06-05T07:56:00+10:00,2023-06-05,07:56,5,1,6
66,2023-06-05T07:56:00+10:00,2023-06-05,07:56,1,9,10
77,2023-06-05T07:56:00+10:00,2023-06-05,07:56,0,1,1
108,2023-06-05T07:56:00+10:00,2023-06-05,07:56,1,21,22
12,2023-06-05T07:56:00+10:00,2023-06-05,07:56,1,0,1
17,2023-06-05T07:56:00+10:00,2023-06-05,07:56,12,4,16
18,2023-06-05T07:56:00+10:00,2023-06-05,07:56,0,6,6
30,2023-06-05T07:56:00+10:00,2023-06-05,07:56,2,2,4
46,2023-06-05T07:56:00+10:00,2023-06-05,07:56,2,1,3
52,2023-06-05T07:56:00+10:00,2023-06-05,07:56,1,6,7
56,2023-06-05T07:56:00+10:00,2023-06-05,07:56,0,2,2
62,2023-06-05T07:56:00+10:00,2023-06-05,07:56,2,1,3
63,2023-06-05T07:56:00+10:00,2023-06-05,07:56,3,1,4
68,2023-06-05T07:56:00+10:00,2023-06-05,07:56,1,2,3
76,2023-06-05T07:56:00+10:00,2023-06-05,07:56,3,2,5
85,2023-06-05T07:56:00+10:00,2023-06-05,07:56,2,0,2
28,2023-06-05T07:56:00+10:00,2023-06-05,07:56,8,2,10
29,2023-06-05T07:56:00+10:00,2023-06-05,07:56,2,1,3
31,2023-06-05T07:56:00+10:00,2023-06-05,07:56,3,1,4
39,2023-06-05T07:56:00+10:00,2023-06-05,07:56,2,1,3
55,2023-06-05T07:56:00+10:00,2023-06-05,07:56,4,9,13
61,2023-06-05T07:56:00+10:00,2023-06-05,07:56,2,1,3
69,2023-06-05T07:56:00+10:00,2023-06-05,07:56,3,2,5
75,2023-06-05T07:56:00+10:00,2023-06-05,07:56,2,0,2
1,2023-06-05T07:56:00+10:00,2023-06-05,07:56,3,4,7
9,2023-06-05T07:56:00+10:00,2023-06-05,07:56,0,13,13
24,2023-06-05T07:56:00+10:00,2023-06-05,07:56,35,1,36
27,2023-06-05T07:56:00+10:00,2023-06-05,07:56,0,2,2
35,2023-06-05T07:56:00+10:00,2023-06-05,07:56,2,11,13
48,2023-06-05T07:56:00+10:00,2023-06-05,07:56,0,1,1
51,2023-06-05T07:56:00+10:00,2023-06-05,07:56,0,1,1
57,2023-06-05T07:56:00+10:00,2023-06-05,07:56,4,16,20
3,2023-06-05T07:55:00+10:00,2023-06-05,07:55,1,4,5
4,2023-06-05T07:55:00+10:00,2023-06-05,07:55,34,6,40
5,2023-06-05T07:55:00+10:00,2023-06-05,07:55,10,10,20
6,2023-06-05T07:55:00+10:00,2023-06-05,07:55,3,20,23
26,2023-06-05T07:55:00+10:00,2023-06-05,07:55,1,1,2
28,2023-06-05T07:55:00+10:00,2023-06-05,07:55,3,2,5
29,2023-06-05T07:55:00+10:00,2023-06-05,07:55,1,1,2
36,2023-06-05T07:55:00+10:00,2023-06-05,07:55,3,6,9
40,2023-06-05T07:55:00+10:00,2023-06-05,07:55,0,2,2
44,2023-06-05T07:55:00+10:00,2023-06-05,07:55,0,1,1
47,2023-06-05T07:55:00+10:00,2023-06-05,07:55,4,10,14
65,2023-06-05T07:55:00+10:00,2023-06-05,07:55,0,2,2
78,2023-06-05T07:55:00+10:00,2023-06-05,07:55,1,2,3
9,2023-06-05T07:55:00+10:00,2023-06-05,07:55,0,28,28
24,2023-06-05T07:55:00+10:00,2023-06-05,07:55,48,12,60
51,2023-06-05T07:55:00+10:00,2023-06-05,07:55,1,0,1
57,2023-06-05T07:55:00+10:00,2023-06-05,07:55,0,12,12
58,2023-06-05T07:55:00+10:00,2023-06-05,07:55,32,7,39
72,2023-06-05T07:55:00+10:00,2023-06-05,07:55,7,1,8
76,2023-06-05T07:55:00+10:00,2023-06-05,07:55,1,3,4
86,2023-06-05T07:55:00+10:00,2023-06-05,07:55,2,1,3
117,2023-06-05T07:55:00+10:00,2023-06-05,07:55,14,7,21
14,2023-06-05T07:55:00+10:00,2023-06-05,07:55,3,6,9
41,2023-06-05T07:55:00+10:00,2023-06-05,07:55,20,5,25
42,2023-06-05T07:55:00+10:00,2023-06-05,07:55,1,0,1
45,2023-06-05T07:55:00+10:00,2023-06-05,07:55,4,7,11
61,2023-06-05T07:55:00+10:00,2023-06-05,07:55,2,5,7
77,2023-06-05T07:55:00+10:00,2023-06-05,07:55,4,0,4
87,2023-06-05T07:55:00+10:00,2023-06-05,07:55,4,0,4
107,2023-06-05T07:55:00+10:00,2023-06-05,07:55,2,8,10
108,2023-06-05T07:55:00+10:00,2023-06-05,07:55,2,14,16
2,2023-06-05T07:55:00+10:00,2023-06-05,07:55,1,5,6
10,2023-06-05T07:55:00+10:00,2023-06-05,07:55,2,4,6
11,2023-06-05T07:55:00+10:00,2023-06-05,07:55,1,2,3
17,2023-06-05T07:55:00+10:00,2023-06-05,07:55,6,1,7
23,2023-06-05T07:55:00+10:00,2023-06-05,07:55,7,7,14
30,2023-06-05T07:55:00+10:00,2023-06-05,07:55,1,3,4
48,2023-06-05T07:55:00+10:00,2023-06-05,07:55,0,1,1
52,2023-06-05T07:55:00+10:00,2023-06-05,07:55,4,1,5
53,2023-06-05T07:55:00+10:00,2023-06-05,07:55,2,1,3
62,2023-06-05T07:55:00+10:00,2023-06-05,07:55,0,1,1
63,2023-06-05T07:55:00+10:00,2023-06-05,07:55,2,1,3
67,2023-06-05T07:55:00+10:00,2023-06-05,07:55,2,5,7
85,2023-06-05T07:55:00+10:00,2023-06-05,07:55,3,0,3
8,2023-06-05T07:55:00+10:00,2023-06-05,07:55,2,7,9
21,2023-06-05T07:55:00+10:00,2023-06-05,07:55,5,0,5
37,2023-06-05T07:55:00+10:00,2023-06-05,07:55,0,2,2
50,2023-06-05T07:55:00+10:00,2023-06-05,07:55,0,1,1
54,2023-06-05T07:55:00+10:00,2023-06-05,07:55,0,2,2
55,2023-06-05T07:55:00+10:00,2023-06-05,07:55,6,10,16
59,2023-06-05T07:55:00+10:00,2023-06-05,07:55,26,5,31
66,2023-06-05T07:55:00+10:00,2023-06-05,07:55,4,1,5
69,2023-06-05T07:55:00+10:00,2023-06-05,07:55,2,2,4
70,2023-06-05T07:55:00+10:00,2023-06-05,07:55,0,2,2
84,2023-06-05T07:55:00+10:00,2023-06-05,07:55,74,21,95
118,2023-06-05T07:55:00+10:00,2023-06-05,07:55,1,2,3
1,2023-06-05T07:55:00+10:00,2023-06-05,07:55,3,1,4
18,2023-06-05T07:55:00+10:00,2023-06-05,07:55,1,6,7
27,2023-06-05T07:55:00+10:00,2023-06-05,07:55,0,1,1
35,2023-06-05T07:55:00+10:00,2023-06-05,07:55,5,7,12
56,2023-06-05T07:55:00+10:00,2023-06-05,07:55,1,0,1
68,2023-06-05T07:55:00+10:00,2023-06-05,07:55,1,1,2
79,2023-06-05T07:55:00+10:00,2023-06-05,07:55,0,4,4
109,2023-06-05T07:55:00+10:00,2023-06-05,07:55,9,32,41
3,2023-06-05T07:54:00+10:00,2023-06-05,07:54,4,6,10
28,2023-06-05T07:54:00+10:00,2023-06-05,07:54,2,4,6
36,2023-06-05T07:54:00+10:00,2023-06-05,07:54,1,2,3
45,2023-06-05T07:54:00+10:00,2023-06-05,07:54,0,6,6
47,2023-06-05T07:54:00+10:00,2023-06-05,07:54,0,1,1
55,2023-06-05T07:54:00+10:00,2023-06-05,07:54,0,9,9
61,2023-06-05T07:54:00+10:00,2023-06-05,07:54,3,1,4
70,2023-06-05T07:54:00+10:00,2023-06-05,07:54,3,1,4
12,2023-06-05T07:54:00+10:00,2023-06-05,07:54,1,0,1
17,2023-06-05T07:54:00+10:00,2023-06-05,07:54,7,3,10
24,2023-06-05T07:54:00+10:00,2023-06-05,07:54,6,7,13
35,2023-06-05T07:54:00+10:00,2023-06-05,07:54,2,15,17
46,2023-06-05T07:54:00+10:00,2023-06-05,07:54,0,2,2
63,2023-06-05T07:54:00+10:00,2023-06-05,07:54,2,1,3
67,2023-06-05T07:54:00+10:00,2023-06-05,07:54,5,1,6
86,2023-06-05T07:54:00+10:00,2023-06-05,07:54,1,1,2
5,2023-06-05T07:54:00+10:00,2023-06-05,07:54,7,7,14
8,2023-06-05T07:54:00+10:00,2023-06-05,07:54,2,2,4
14,2023-06-05T07:54:00+10:00,2023-06-05,07:54,3,5,8
29,2023-06-05T07:54:00+10:00,2023-06-05,07:54,2,1,3
37,2023-06-05T07:54:00+10:00,2023-06-05,07:54,0,1,1
39,2023-06-05T07:54:00+10:00,2023-06-05,07:54,1,3,4
42,2023-06-05T07:54:00+10:00,2023-06-05,07:54,0,7,7
65,2023-06-05T07:54:00+10:00,2023-06-05,07:54,2,5,7
69,2023-06-05T07:54:00+10:00,2023-06-05,07:54,3,1,4
71,2023-06-05T07:54:00+10:00,2023-06-05,07:54,0,1,1
78,2023-06-05T07:54:00+10:00,2023-06-05,07:54,1,1,2
108,2023-06-05T07:54:00+10:00,2023-06-05,07:54,7,20,27
1,2023-06-05T07:54:00+10:00,2023-06-05,07:54,1,4,5
9,2023-06-05T07:54:00+10:00,2023-06-05,07:54,0,43,43
10,2023-06-05T07:54:00+10:00,2023-06-05,07:54,0,5,5
23,2023-06-05T07:54:00+10:00,2023-06-05,07:54,3,7,10
52,2023-06-05T07:54:00+10:00,2023-06-05,07:54,1,3,4
53,2023-06-05T07:54:00+10:00,2023-06-05,07:54,6,4,10
62,2023-06-05T07:54:00+10:00,2023-06-05,07:54,2,0,2
68,2023-06-05T07:54:00+10:00,2023-06-05,07:54,1,3,4
4,2023-06-05T07:54:00+10:00,2023-06-05,07:54,15,2,17
6,2023-06-05T07:54:00+10:00,2023-06-05,07:54,7,11,18
26,2023-06-05T07:54:00+10:00,2023-06-05,07:54,4,0,4
41,2023-06-05T07:54:00+10:00,2023-06-05,07:54,13,4,17
50,2023-06-05T07:54:00+10:00,2023-06-05,07:54,0,5,5
54,2023-06-05T07:54:00+10:00,2023-06-05,07:54,0,2,2
66,2023-06-05T07:54:00+10:00,2023-06-05,07:54,0,2,2
77,2023-06-05T07:54:00+10:00,2023-06-05,07:54,0,2,2
87,2023-06-05T07:54:00+10:00,2023-06-05,07:54,3,0,3
2,2023-06-05T07:54:00+10:00,2023-06-05,07:54,2,3,5
11,2023-06-05T07:54:00+10:00,2023-06-05,07:54,0,2,2
18,2023-06-05T07:54:00+10:00,2023-06-05,07:54,1,7,8
57,2023-06-05T07:54:00+10:00,2023-06-05,07:54,2,5,7
58,2023-06-05T07:54:00+10:00,2023-06-05,07:54,1,3,4
72,2023-06-05T07:54:00+10:00,2023-06-05,07:54,2,1,3
79,2023-06-05T07:54:00+10:00,2023-06-05,07:54,10,11,21
85,2023-06-05T07:54:00+10:00,2023-06-05,07:54,3,0,3
4,2023-06-05T07:53:00+10:00,2023-06-05,07:53,4,0,4
26,2023-06-05T07:53:00+10:00,2023-06-05,07:53,5,1,6
29,2023-06-05T07:53:00+10:00,2023-06-05,07:53,3,0,3
36,2023-06-05T07:53:00+10:00,2023-06-05,07:53,6,0,6
40,2023-06-05T07:53:00+10:00,2023-06-05,07:53,6,4,10
41,2023-06-05T07:53:00+10:00,2023-06-05,07:53,11,4,15
55,2023-06-05T07:53:00+10:00,2023-06-05,07:53,4,6,10
65,2023-06-05T07:53:00+10:00,2023-06-05,07:53,8,1,9
66,2023-06-05T07:53:00+10:00,2023-06-05,07:53,2,4,6
9,2023-06-05T07:53:00+10:00,2023-06-05,07:53,2,19,21
11,2023-06-05T07:53:00+10:00,2023-06-05,07:53,1,0,1
12,2023-06-05T07:53:00+10:00,2023-06-05,07:53,0,1,1
19,2023-06-05T07:53:00+10:00,2023-06-05,07:53,2,0,2
27,2023-06-05T07:53:00+10:00,2023-06-05,07:53,1,0,1
49,2023-06-05T07:53:00+10:00,2023-06-05,07:53,1,2,3
51,2023-06-05T07:53:00+10:00,2023-06-05,07:53,0,2,2
56,2023-06-05T07:53:00+10:00,2023-06-05,07:53,0,4,4
58,2023-06-05T07:53:00+10:00,2023-06-05,07:53,17,0,17
5,2023-06-05T07:53:00+10:00,2023-06-05,07:53,7,12,19
6,2023-06-05T07:53:00+10:00,2023-06-05,07:53,6,10,16
14,2023-06-05T07:53:00+10:00,2023-06-05,07:53,5,2,7
42,2023-06-05T07:53:00+10:00,2023-06-05,07:53,3,0,3
69,2023-06-05T07:53:00+10:00,2023-06-05,07:53,5,0,5
70,2023-06-05T07:53:00+10:00,2023-06-05,07:53,2,1,3
75,2023-06-05T07:53:00+10:00,2023-06-05,07:53,1,0,1
77,2023-06-05T07:53:00+10:00,2023-06-05,07:53,1,5,6
108,2023-06-05T07:53:00+10:00,2023-06-05,07:53,2,14,16
10,2023-06-05T07:53:00+10:00,2023-06-05,07:53,0,3,3
17,2023-06-05T07:53:00+10:00,2023-06-05,07:53,8,1,9
20,2023-06-05T07:53:00+10:00,2023-06-05,07:53,0,4,4
24,2023-06-05T07:53:00+10:00,2023-06-05,07:53,41,11,52
30,2023-06-05T07:53:00+10:00,2023-06-05,07:53,1,3,4
35,2023-06-05T07:53:00+10:00,2023-06-05,07:53,9,16,25
46,2023-06-05T07:53:00+10:00,2023-06-05,07:53,2,0,2
52,2023-06-05T07:53:00+10:00,2023-06-05,07:53,0,1,1
62,2023-06-05T07:53:00+10:00,2023-06-05,07:53,2,0,2
63,2023-06-05T07:53:00+10:00,2023-06-05,07:53,1,3,4
72,2023-06-05T07:53:00+10:00,2023-06-05,07:53,1,1,2
3,2023-06-05T07:53:00+10:00,2023-06-05,07:53,3,3,6
8,2023-06-05T07:53:00+10:00,2023-06-05,07:53,4,3,7
21,2023-06-05T07:53:00+10:00,2023-06-05,07:53,1,2,3
28,2023-06-05T07:53:00+10:00,2023-06-05,07:53,2,0,2
31,2023-06-05T07:53:00+10:00,2023-06-05,07:53,2,1,3
39,2023-06-05T07:53:00+10:00,2023-06-05,07:53,0,1,1
44,2023-06-05T07:53:00+10:00,2023-06-05,07:53,0,5,5
45,2023-06-05T07:53:00+10:00,2023-06-05,07:53,3,2,5
47,2023-06-05T07:53:00+10:00,2023-06-05,07:53,0,4,4
50,2023-06-05T07:53:00+10:00,2023-06-05,07:53,0,1,1
54,2023-06-05T07:53:00+10:00,2023-06-05,07:53,0,2,2
61,2023-06-05T07:53:00+10:00,2023-06-05,07:53,2,1,3
71,2023-06-05T07:53:00+10:00,2023-06-05,07:53,2,0,2
87,2023-06-05T07:53:00+10:00,2023-06-05,07:53,2,0,2
1,2023-06-05T07:53:00+10:00,2023-06-05,07:53,5,2,7
2,2023-06-05T07:53:00+10:00,2023-06-05,07:53,2,2,4
18,2023-06-05T07:53:00+10:00,2023-06-05,07:53,0,2,2
23,2023-06-05T07:53:00+10:00,2023-06-05,07:53,5,4,9
48,2023-06-05T07:53:00+10:00,2023-06-05,07:53,0,1,1
53,2023-06-05T07:53:00+10:00,2023-06-05,07:53,6,3,9
57,2023-06-05T07:53:00+10:00,2023-06-05,07:53,2,18,20
67,2023-06-05T07:53:00+10:00,2023-06-05,07:53,4,3,7
68,2023-06-05T07:53:00+10:00,2023-06-05,07:53,2,1,3
76,2023-06-05T07:53:00+10:00,2023-06-05,07:53,1,0,1
79,2023-06-05T07:53:00+10:00,2023-06-05,07:53,2,1,3
85,2023-06-05T07:53:00+10:00,2023-06-05,07:53,3,0,3
86,2023-06-05T07:53:00+10:00,2023-06-05,07:53,1,0,1
6,2023-06-05T07:52:00+10:00,2023-06-05,07:52,7,14,21
14,2023-06-05T07:52:00+10:00,2023-06-05,07:52,0,4,4
21,2023-06-05T07:52:00+10:00,2023-06-05,07:52,0,2,2
31,2023-06-05T07:52:00+10:00,2023-06-05,07:52,1,0,1
41,2023-06-05T07:52:00+10:00,2023-06-05,07:52,9,2,11
42,2023-06-05T07:52:00+10:00,2023-06-05,07:52,0,2,2
45,2023-06-05T07:52:00+10:00,2023-06-05,07:52,3,3,6
61,2023-06-05T07:52:00+10:00,2023-06-05,07:52,3,4,7
69,2023-06-05T07:52:00+10:00,2023-06-05,07:52,2,1,3
108,2023-06-05T07:52:00+10:00,2023-06-05,07:52,0,28,28
1,2023-06-05T07:52:00+10:00,2023-06-05,07:52,2,3,5
10,2023-06-05T07:52:00+10:00,2023-06-05,07:52,0,7,7
20,2023-06-05T07:52:00+10:00,2023-06-05,07:52,1,1,2
23,2023-06-05T07:52:00+10:00,2023-06-05,07:52,10,10,20
27,2023-06-05T07:52:00+10:00,2023-06-05,07:52,1,0,1
30,2023-06-05T07:52:00+10:00,2023-06-05,07:52,2,2,4
35,2023-06-05T07:52:00+10:00,2023-06-05,07:52,4,8,12
58,2023-06-05T07:52:00+10:00,2023-06-05,07:52,13,0,13
67,2023-06-05T07:52:00+10:00,2023-06-05,07:52,2,0,2
72,2023-06-05T07:52:00+10:00,2023-06-05,07:52,0,2,2
26,2023-06-05T07:52:00+10:00,2023-06-05,07:52,6,3,9
36,2023-06-05T07:52:00+10:00,2023-06-05,07:52,3,3,6
39,2023-06-05T07:52:00+10:00,2023-06-05,07:52,0,2,2
40,2023-06-05T07:52:00+10:00,2023-06-05,07:52,8,6,14
44,2023-06-05T07:52:00+10:00,2023-06-05,07:52,2,1,3
47,2023-06-05T07:52:00+10:00,2023-06-05,07:52,1,24,25
54,2023-06-05T07:52:00+10:00,2023-06-05,07:52,0,2,2
65,2023-06-05T07:52:00+10:00,2023-06-05,07:52,6,5,11
70,2023-06-05T07:52:00+10:00,2023-06-05,07:52,1,0,1
77,2023-06-05T07:52:00+10:00,2023-06-05,07:52,2,1,3
9,2023-06-05T07:52:00+10:00,2023-06-05,07:52,1,15,16
12,2023-06-05T07:52:00+10:00,2023-06-05,07:52,3,2,5
19,2023-06-05T07:52:00+10:00,2023-06-05,07:52,0,1,1
24,2023-06-05T07:52:00+10:00,2023-06-05,07:52,12,14,26
51,2023-06-05T07:52:00+10:00,2023-06-05,07:52,1,1,2
53,2023-06-05T07:52:00+10:00,2023-06-05,07:52,1,7,8
57,2023-06-05T07:52:00+10:00,2023-06-05,07:52,8,10,18
79,2023-06-05T07:52:00+10:00,2023-06-05,07:52,7,1,8
3,2023-06-05T07:52:00+10:00,2023-06-05,07:52,1,0,1
4,2023-06-05T07:52:00+10:00,2023-06-05,07:52,9,4,13
5,2023-06-05T07:52:00+10:00,2023-06-05,07:52,7,6,13
8,2023-06-05T07:52:00+10:00,2023-06-05,07:52,2,1,3
28,2023-06-05T07:52:00+10:00,2023-06-05,07:52,6,5,11
29,2023-06-05T07:52:00+10:00,2023-06-05,07:52,3,1,4
37,2023-06-05T07:52:00+10:00,2023-06-05,07:52,2,1,3
55,2023-06-05T07:52:00+10:00,2023-06-05,07:52,3,4,7
66,2023-06-05T07:52:00+10:00,2023-06-05,07:52,1,3,4
87,2023-06-05T07:52:00+10:00,2023-06-05,07:52,1,1,2
2,2023-06-05T07:52:00+10:00,2023-06-05,07:52,0,1,1
17,2023-06-05T07:52:00+10:00,2023-06-05,07:52,15,3,18
18,2023-06-05T07:52:00+10:00,2023-06-05,07:52,0,12,12
52,2023-06-05T07:52:00+10:00,2023-06-05,07:52,2,2,4
56,2023-06-05T07:52:00+10:00,2023-06-05,07:52,0,2,2
62,2023-06-05T07:52:00+10:00,2023-06-05,07:52,1,0,1
63,2023-06-05T07:52:00+10:00,2023-06-05,07:52,0,2,2
68,2023-06-05T07:52:00+10:00,2023-06-05,07:52,0,3,3
76,2023-06-05T07:52:00+10:00,2023-06-05,07:52,3,1,4
85,2023-06-05T07:52:00+10:00,2023-06-05,07:52,1,0,1
4,2023-06-05T07:51:00+10:00,2023-06-05,07:51,7,5,12
5,2023-06-05T07:51:00+10:00,2023-06-05,07:51,5,3,8
8,2023-06-05T07:51:00+10:00,2023-06-05,07:51,2,2,4
29,2023-06-05T07:51:00+10:00,2023-06-05,07:51,3,0,3
36,2023-06-05T07:51:00+10:00,2023-06-05,07:51,3,1,4
37,2023-06-05T07:51:00+10:00,2023-06-05,07:51,0,2,2
39,2023-06-05T07:51:00+10:00,2023-06-05,07:51,2,0,2
40,2023-06-05T07:51:00+10:00,2023-06-05,07:51,1,6,7
41,2023-06-05T07:51:00+10:00,2023-06-05,07:51,21,0,21
42,2023-06-05T07:51:00+10:00,2023-06-05,07:51,3,2,5
45,2023-06-05T07:51:00+10:00,2023-06-05,07:51,5,1,6
55,2023-06-05T07:51:00+10:00,2023-06-05,07:51,5,9,14
65,2023-06-05T07:51:00+10:00,2023-06-05,07:51,7,0,7
70,2023-06-05T07:51:00+10:00,2023-06-05,07:51,1,1,2
77,2023-06-05T07:51:00+10:00,2023-06-05,07:51,1,0,1
78,2023-06-05T07:51:00+10:00,2023-06-05,07:51,3,0,3
1,2023-06-05T07:51:00+10:00,2023-06-05,07:51,1,0,1
2,2023-06-05T07:51:00+10:00,2023-06-05,07:51,0,4,4
9,2023-06-05T07:51:00+10:00,2023-06-05,07:51,1,16,17
17,2023-06-05T07:51:00+10:00,2023-06-05,07:51,8,2,10
23,2023-06-05T07:51:00+10:00,2023-06-05,07:51,1,0,1
24,2023-06-05T07:51:00+10:00,2023-06-05,07:51,10,3,13
35,2023-06-05T07:51:00+10:00,2023-06-05,07:51,3,5,8
57,2023-06-05T07:51:00+10:00,2023-06-05,07:51,2,6,8
63,2023-06-05T07:51:00+10:00,2023-06-05,07:51,1,1,2
79,2023-06-05T07:51:00+10:00,2023-06-05,07:51,15,0,15
6,2023-06-05T07:51:00+10:00,2023-06-05,07:51,6,11,17
28,2023-06-05T07:51:00+10:00,2023-06-05,07:51,9,2,11
54,2023-06-05T07:51:00+10:00,2023-06-05,07:51,0,1,1
61,2023-06-05T07:51:00+10:00,2023-06-05,07:51,1,3,4
66,2023-06-05T07:51:00+10:00,2023-06-05,07:51,3,2,5
69,2023-06-05T07:51:00+10:00,2023-06-05,07:51,3,0,3
87,2023-06-05T07:51:00+10:00,2023-06-05,07:51,1,1,2
108,2023-06-05T07:51:00+10:00,2023-06-05,07:51,2,23,25
18,2023-06-05T07:51:00+10:00,2023-06-05,07:51,0,9,9
19,2023-06-05T07:51:00+10:00,2023-06-05,07:51,1,0,1
30,2023-06-05T07:51:00+10:00,2023-06-05,07:51,4,1,5
52,2023-06-05T07:51:00+10:00,2023-06-05,07:51,0,5,5
58,2023-06-05T07:51:00+10:00,2023-06-05,07:51,10,3,13
67,2023-06-05T07:51:00+10:00,2023-06-05,07:51,5,4,9
72,2023-06-05T07:51:00+10:00,2023-06-05,07:51,4,1,5
76,2023-06-05T07:51:00+10:00,2023-06-05,07:51,3,2,5
85,2023-06-05T07:51:00+10:00,2023-06-05,07:51,2,0,2
3,2023-06-05T07:51:00+10:00,2023-06-05,07:51,6,4,10
14,2023-06-05T07:51:00+10:00,2023-06-05,07:51,3,5,8
21,2023-06-05T07:51:00+10:00,2023-06-05,07:51,0,2,2
26,2023-06-05T07:51:00+10:00,2023-06-05,07:51,2,0,2
47,2023-06-05T07:51:00+10:00,2023-06-05,07:51,2,3,5
10,2023-06-05T07:51:00+10:00,2023-06-05,07:51,0,3,3
11,2023-06-05T07:51:00+10:00,2023-06-05,07:51,0,1,1
27,2023-06-05T07:51:00+10:00,2023-06-05,07:51,1,0,1
46,2023-06-05T07:51:00+10:00,2023-06-05,07:51,1,3,4
51,2023-06-05T07:51:00+10:00,2023-06-05,07:51,1,0,1
53,2023-06-05T07:51:00+10:00,2023-06-05,07:51,2,2,4
68,2023-06-05T07:51:00+10:00,2023-06-05,07:51,1,1,2
4,2023-06-05T07:50:00+10:00,2023-06-05,07:50,8,4,12
5,2023-06-05T07:50:00+10:00,2023-06-05,07:50,1,4,5
6,2023-06-05T07:50:00+10:00,2023-06-05,07:50,3,7,10
14,2023-06-05T07:50:00+10:00,2023-06-05,07:50,3,7,10
28,2023-06-05T07:50:00+10:00,2023-06-05,07:50,8,6,14
29,2023-06-05T07:50:00+10:00,2023-06-05,07:50,2,0,2
47,2023-06-05T07:50:00+10:00,2023-06-05,07:50,1,5,6
50,2023-06-05T07:50:00+10:00,2023-06-05,07:50,0,2,2
75,2023-06-05T07:50:00+10:00,2023-06-05,07:50,0,2,2
77,2023-06-05T07:50:00+10:00,2023-06-05,07:50,1,2,3
78,2023-06-05T07:50:00+10:00,2023-06-05,07:50,0,1,1
84,2023-06-05T07:50:00+10:00,2023-06-05,07:50,64,28,92
107,2023-06-05T07:50:00+10:00,2023-06-05,07:50,7,9,16
108,2023-06-05T07:50:00+10:00,2023-06-05,07:50,3,5,8
1,2023-06-05T07:50:00+10:00,2023-06-05,07:50,2,2,4
2,2023-06-05T07:50:00+10:00,2023-06-05,07:50,0,3,3
10,2023-06-05T07:50:00+10:00,2023-06-05,07:50,3,2,5
18,2023-06-05T07:50:00+10:00,2023-06-05,07:50,0,5,5
24,2023-06-05T07:50:00+10:00,2023-06-05,07:50,42,4,46
35,2023-06-05T07:50:00+10:00,2023-06-05,07:50,3,15,18
51,2023-06-05T07:50:00+10:00,2023-06-05,07:50,2,0,2
57,2023-06-05T07:50:00+10:00,2023-06-05,07:50,4,7,11
63,2023-06-05T07:50:00+10:00,2023-06-05,07:50,3,1,4
68,2023-06-05T07:50:00+10:00,2023-06-05,07:50,0,1,1
72,2023-06-05T07:50:00+10:00,2023-06-05,07:50,8,0,8
79,2023-06-05T07:50:00+10:00,2023-06-05,07:50,3,2,5
109,2023-06-05T07:50:00+10:00,2023-06-05,07:50,4,35,39
3,2023-06-05T07:50:00+10:00,2023-06-05,07:50,6,5,11
21,2023-06-05T07:50:00+10:00,2023-06-05,07:50,2,3,5
26,2023-06-05T07:50:00+10:00,2023-06-05,07:50,1,1,2
31,2023-06-05T07:50:00+10:00,2023-06-05,07:50,0,1,1
39,2023-06-05T07:50:00+10:00,2023-06-05,07:50,2,3,5
41,2023-06-05T07:50:00+10:00,2023-06-05,07:50,12,6,18
45,2023-06-05T07:50:00+10:00,2023-06-05,07:50,3,1,4
66,2023-06-05T07:50:00+10:00,2023-06-05,07:50,0,7,7
69,2023-06-05T07:50:00+10:00,2023-06-05,07:50,1,0,1
70,2023-06-05T07:50:00+10:00,2023-06-05,07:50,0,1,1
9,2023-06-05T07:50:00+10:00,2023-06-05,07:50,0,26,26
12,2023-06-05T07:50:00+10:00,2023-06-05,07:50,2,1,3
17,2023-06-05T07:50:00+10:00,2023-06-05,07:50,5,3,8
19,2023-06-05T07:50:00+10:00,2023-06-05,07:50,0,1,1
23,2023-06-05T07:50:00+10:00,2023-06-05,07:50,9,2,11
52,2023-06-05T07:50:00+10:00,2023-06-05,07:50,5,1,6
56,2023-06-05T07:50:00+10:00,2023-06-05,07:50,0,1,1
58,2023-06-05T07:50:00+10:00,2023-06-05,07:50,40,2,42
67,2023-06-05T07:50:00+10:00,2023-06-05,07:50,4,5,9
85,2023-06-05T07:50:00+10:00,2023-06-05,07:50,1,0,1
86,2023-06-05T07:50:00+10:00,2023-06-05,07:50,2,1,3
117,2023-06-05T07:50:00+10:00,2023-06-05,07:50,10,3,13
8,2023-06-05T07:50:00+10:00,2023-06-05,07:50,1,0,1
36,2023-06-05T07:50:00+10:00,2023-06-05,07:50,2,0,2
40,2023-06-05T07:50:00+10:00,2023-06-05,07:50,1,3,4
42,2023-06-05T07:50:00+10:00,2023-06-05,07:50,0,1,1
44,2023-06-05T07:50:00+10:00,2023-06-05,07:50,0,1,1
54,2023-06-05T07:50:00+10:00,2023-06-05,07:50,1,3,4
55,2023-06-05T07:50:00+10:00,2023-06-05,07:50,2,4,6
59,2023-06-05T07:50:00+10:00,2023-06-05,07:50,27,7,34
61,2023-06-05T07:50:00+10:00,2023-06-05,07:50,1,1,2
65,2023-06-05T07:50:00+10:00,2023-06-05,07:50,3,1,4
118,2023-06-05T07:50:00+10:00,2023-06-05,07:50,1,1,2
11,2023-06-05T07:50:00+10:00,2023-06-05,07:50,1,1,2
27,2023-06-05T07:50:00+10:00,2023-06-05,07:50,2,0,2
46,2023-06-05T07:50:00+10:00,2023-06-05,07:50,0,2,2
53,2023-06-05T07:50:00+10:00,2023-06-05,07:50,4,2,6
5,2023-06-05T07:49:00+10:00,2023-06-05,07:49,4,6,10
14,2023-06-05T07:49:00+10:00,2023-06-05,07:49,4,3,7
40,2023-06-05T07:49:00+10:00,2023-06-05,07:49,3,6,9
42,2023-06-05T07:49:00+10:00,2023-06-05,07:49,1,1,2
47,2023-06-05T07:49:00+10:00,2023-06-05,07:49,1,7,8
17,2023-06-05T07:49:00+10:00,2023-06-05,07:49,16,1,17
23,2023-06-05T07:49:00+10:00,2023-06-05,07:49,1,2,3
27,2023-06-05T07:49:00+10:00,2023-06-05,07:49,1,0,1
48,2023-06-05T07:49:00+10:00,2023-06-05,07:49,0,2,2
51,2023-06-05T07:49:00+10:00,2023-06-05,07:49,1,0,1
68,2023-06-05T07:49:00+10:00,2023-06-05,07:49,1,2,3
72,2023-06-05T07:49:00+10:00,2023-06-05,07:49,3,0,3
3,2023-06-05T07:49:00+10:00,2023-06-05,07:49,7,3,10
6,2023-06-05T07:49:00+10:00,2023-06-05,07:49,5,5,10
28,2023-06-05T07:49:00+10:00,2023-06-05,07:49,6,5,11
29,2023-06-05T07:49:00+10:00,2023-06-05,07:49,1,0,1
37,2023-06-05T07:49:00+10:00,2023-06-05,07:49,0,1,1
39,2023-06-05T07:49:00+10:00,2023-06-05,07:49,1,2,3
54,2023-06-05T07:49:00+10:00,2023-06-05,07:49,2,0,2
55,2023-06-05T07:49:00+10:00,2023-06-05,07:49,5,7,12
69,2023-06-05T07:49:00+10:00,2023-06-05,07:49,2,0,2
70,2023-06-05T07:49:00+10:00,2023-06-05,07:49,3,0,3
78,2023-06-05T07:49:00+10:00,2023-06-05,07:49,1,1,2
108,2023-06-05T07:49:00+10:00,2023-06-05,07:49,0,12,12
18,2023-06-05T07:49:00+10:00,2023-06-05,07:49,1,11,12
56,2023-06-05T07:49:00+10:00,2023-06-05,07:49,0,1,1
57,2023-06-05T07:49:00+10:00,2023-06-05,07:49,3,16,19
58,2023-06-05T07:49:00+10:00,2023-06-05,07:49,6,0,6
63,2023-06-05T07:49:00+10:00,2023-06-05,07:49,3,2,5
67,2023-06-05T07:49:00+10:00,2023-06-05,07:49,2,1,3
86,2023-06-05T07:49:00+10:00,2023-06-05,07:49,1,0,1
4,2023-06-05T07:49:00+10:00,2023-06-05,07:49,5,0,5
8,2023-06-05T07:49:00+10:00,2023-06-05,07:49,3,1,4
21,2023-06-05T07:49:00+10:00,2023-06-05,07:49,2,0,2
26,2023-06-05T07:49:00+10:00,2023-06-05,07:49,2,1,3
31,2023-06-05T07:49:00+10:00,2023-06-05,07:49,2,0,2
36,2023-06-05T07:49:00+10:00,2023-06-05,07:49,1,3,4
41,2023-06-05T07:49:00+10:00,2023-06-05,07:49,40,2,42
45,2023-06-05T07:49:00+10:00,2023-06-05,07:49,2,4,6
65,2023-06-05T07:49:00+10:00,2023-06-05,07:49,8,1,9
66,2023-06-05T07:49:00+10:00,2023-06-05,07:49,3,2,5
71,2023-06-05T07:49:00+10:00,2023-06-05,07:49,1,1,2
77,2023-06-05T07:49:00+10:00,2023-06-05,07:49,0,2,2
1,2023-06-05T07:49:00+10:00,2023-06-05,07:49,1,3,4
9,2023-06-05T07:49:00+10:00,2023-06-05,07:49,0,26,26
10,2023-06-05T07:49:00+10:00,2023-06-05,07:49,1,6,7
20,2023-06-05T07:49:00+10:00,2023-06-05,07:49,3,1,4
24,2023-06-05T07:49:00+10:00,2023-06-05,07:49,11,2,13
30,2023-06-05T07:49:00+10:00,2023-06-05,07:49,4,3,7
35,2023-06-05T07:49:00+10:00,2023-06-05,07:49,4,3,7
52,2023-06-05T07:49:00+10:00,2023-06-05,07:49,6,2,8
53,2023-06-05T07:49:00+10:00,2023-06-05,07:49,3,6,9
62,2023-06-05T07:49:00+10:00,2023-06-05,07:49,0,3,3
79,2023-06-05T07:49:00+10:00,2023-06-05,07:49,11,8,19
85,2023-06-05T07:49:00+10:00,2023-06-05,07:49,2,0,2
6,2023-06-05T07:48:00+10:00,2023-06-05,07:48,8,13,21
26,2023-06-05T07:48:00+10:00,2023-06-05,07:48,1,2,3
36,2023-06-05T07:48:00+10:00,2023-06-05,07:48,2,0,2
37,2023-06-05T07:48:00+10:00,2023-06-05,07:48,2,1,3
39,2023-06-05T07:48:00+10:00,2023-06-05,07:48,2,1,3
41,2023-06-05T07:48:00+10:00,2023-06-05,07:48,13,5,18
45,2023-06-05T07:48:00+10:00,2023-06-05,07:48,6,7,13
1,2023-06-05T07:48:00+10:00,2023-06-05,07:48,6,1,7
27,2023-06-05T07:48:00+10:00,2023-06-05,07:48,1,0,1
30,2023-06-05T07:48:00+10:00,2023-06-05,07:48,1,0,1
58,2023-06-05T07:48:00+10:00,2023-06-05,07:48,22,2,24
67,2023-06-05T07:48:00+10:00,2023-06-05,07:48,4,2,6
79,2023-06-05T07:48:00+10:00,2023-06-05,07:48,4,10,14
8,2023-06-05T07:48:00+10:00,2023-06-05,07:48,1,2,3
40,2023-06-05T07:48:00+10:00,2023-06-05,07:48,2,3,5
47,2023-06-05T07:48:00+10:00,2023-06-05,07:48,4,1,5
61,2023-06-05T07:48:00+10:00,2023-06-05,07:48,0,4,4
69,2023-06-05T07:48:00+10:00,2023-06-05,07:48,7,1,8
108,2023-06-05T07:48:00+10:00,2023-06-05,07:48,1,7,8
9,2023-06-05T07:48:00+10:00,2023-06-05,07:48,0,23,23
11,2023-06-05T07:48:00+10:00,2023-06-05,07:48,1,1,2
12,2023-06-05T07:48:00+10:00,2023-06-05,07:48,1,2,3
23,2023-06-05T07:48:00+10:00,2023-06-05,07:48,7,4,11
24,2023-06-05T07:48:00+10:00,2023-06-05,07:48,26,9,35
46,2023-06-05T07:48:00+10:00,2023-06-05,07:48,1,1,2
51,2023-06-05T07:48:00+10:00,2023-06-05,07:48,1,0,1
52,2023-06-05T07:48:00+10:00,2023-06-05,07:48,1,6,7
62,2023-06-05T07:48:00+10:00,2023-06-05,07:48,0,4,4
63,2023-06-05T07:48:00+10:00,2023-06-05,07:48,1,0,1
76,2023-06-05T07:48:00+10:00,2023-06-05,07:48,1,0,1
85,2023-06-05T07:48:00+10:00,2023-06-05,07:48,1,0,1
3,2023-06-05T07:48:00+10:00,2023-06-05,07:48,2,3,5
4,2023-06-05T07:48:00+10:00,2023-06-05,07:48,5,3,8
5,2023-06-05T07:48:00+10:00,2023-06-05,07:48,3,5,8
14,2023-06-05T07:48:00+10:00,2023-06-05,07:48,7,3,10
28,2023-06-05T07:48:00+10:00,2023-06-05,07:48,5,8,13
29,2023-06-05T07:48:00+10:00,2023-06-05,07:48,0,3,3
31,2023-06-05T07:48:00+10:00,2023-06-05,07:48,0,1,1
42,2023-06-05T07:48:00+10:00,2023-06-05,07:48,1,0,1
54,2023-06-05T07:48:00+10:00,2023-06-05,07:48,1,0,1
55,2023-06-05T07:48:00+10:00,2023-06-05,07:48,6,4,10
65,2023-06-05T07:48:00+10:00,2023-06-05,07:48,1,3,4
66,2023-06-05T07:48:00+10:00,2023-06-05,07:48,0,5,5
75,2023-06-05T07:48:00+10:00,2023-06-05,07:48,0,2,2
77,2023-06-05T07:48:00+10:00,2023-06-05,07:48,1,3,4
78,2023-06-05T07:48:00+10:00,2023-06-05,07:48,0,1,1
2,2023-06-05T07:48:00+10:00,2023-06-05,07:48,2,3,5
10,2023-06-05T07:48:00+10:00,2023-06-05,07:48,2,6,8
17,2023-06-05T07:48:00+10:00,2023-06-05,07:48,12,1,13
18,2023-06-05T07:48:00+10:00,2023-06-05,07:48,0,15,15
19,2023-06-05T07:48:00+10:00,2023-06-05,07:48,2,2,4
35,2023-06-05T07:48:00+10:00,2023-06-05,07:48,9,6,15
53,2023-06-05T07:48:00+10:00,2023-06-05,07:48,6,0,6
57,2023-06-05T07:48:00+10:00,2023-06-05,07:48,6,14,20
72,2023-06-05T07:48:00+10:00,2023-06-05,07:48,17,5,22
6,2023-06-05T07:47:00+10:00,2023-06-05,07:47,8,6,14
14,2023-06-05T07:47:00+10:00,2023-06-05,07:47,3,3,6
21,2023-06-05T07:47:00+10:00,2023-06-05,07:47,3,1,4
29,2023-06-05T07:47:00+10:00,2023-06-05,07:47,1,0,1
41,2023-06-05T07:47:00+10:00,2023-06-05,07:47,22,1,23
50,2023-06-05T07:47:00+10:00,2023-06-05,07:47,1,0,1
61,2023-06-05T07:47:00+10:00,2023-06-05,07:47,8,1,9
66,2023-06-05T07:47:00+10:00,2023-06-05,07:47,4,6,10
75,2023-06-05T07:47:00+10:00,2023-06-05,07:47,1,0,1
87,2023-06-05T07:47:00+10:00,2023-06-05,07:47,2,2,4
2,2023-06-05T07:47:00+10:00,2023-06-05,07:47,4,0,4
10,2023-06-05T07:47:00+10:00,2023-06-05,07:47,0,3,3
12,2023-06-05T07:47:00+10:00,2023-06-05,07:47,1,0,1
19,2023-06-05T07:47:00+10:00,2023-06-05,07:47,1,0,1
23,2023-06-05T07:47:00+10:00,2023-06-05,07:47,4,5,9
30,2023-06-05T07:47:00+10:00,2023-06-05,07:47,1,1,2
35,2023-06-05T07:47:00+10:00,2023-06-05,07:47,6,11,17
48,2023-06-05T07:47:00+10:00,2023-06-05,07:47,4,2,6
56,2023-06-05T07:47:00+10:00,2023-06-05,07:47,0,1,1
62,2023-06-05T07:47:00+10:00,2023-06-05,07:47,9,1,10
3,2023-06-05T07:47:00+10:00,2023-06-05,07:47,1,3,4
5,2023-06-05T07:47:00+10:00,2023-06-05,07:47,2,10,12
28,2023-06-05T07:47:00+10:00,2023-06-05,07:47,7,5,12
36,2023-06-05T07:47:00+10:00,2023-06-05,07:47,1,0,1
42,2023-06-05T07:47:00+10:00,2023-06-05,07:47,0,1,1
47,2023-06-05T07:47:00+10:00,2023-06-05,07:47,2,4,6
54,2023-06-05T07:47:00+10:00,2023-06-05,07:47,3,0,3
70,2023-06-05T07:47:00+10:00,2023-06-05,07:47,1,0,1
77,2023-06-05T07:47:00+10:00,2023-06-05,07:47,1,0,1
78,2023-06-05T07:47:00+10:00,2023-06-05,07:47,1,0,1
1,2023-06-05T07:47:00+10:00,2023-06-05,07:47,6,3,9
17,2023-06-05T07:47:00+10:00,2023-06-05,07:47,4,2,6
24,2023-06-05T07:47:00+10:00,2023-06-05,07:47,22,8,30
63,2023-06-05T07:47:00+10:00,2023-06-05,07:47,1,2,3
67,2023-06-05T07:47:00+10:00,2023-06-05,07:47,7,0,7
68,2023-06-05T07:47:00+10:00,2023-06-05,07:47,1,0,1
79,2023-06-05T07:47:00+10:00,2023-06-05,07:47,3,1,4
85,2023-06-05T07:47:00+10:00,2023-06-05,07:47,1,1,2
4,2023-06-05T07:47:00+10:00,2023-06-05,07:47,6,4,10
8,2023-06-05T07:47:00+10:00,2023-06-05,07:47,2,5,7
26,2023-06-05T07:47:00+10:00,2023-06-05,07:47,2,3,5
40,2023-06-05T07:47:00+10:00,2023-06-05,07:47,0,3,3
44,2023-06-05T07:47:00+10:00,2023-06-05,07:47,0,1,1
45,2023-06-05T07:47:00+10:00,2023-06-05,07:47,1,3,4
55,2023-06-05T07:47:00+10:00,2023-06-05,07:47,0,3,3
65,2023-06-05T07:47:00+10:00,2023-06-05,07:47,4,5,9
69,2023-06-05T07:47:00+10:00,2023-06-05,07:47,2,0,2
108,2023-06-05T07:47:00+10:00,2023-06-05,07:47,2,15,17
9,2023-06-05T07:47:00+10:00,2023-06-05,07:47,0,20,20
11,2023-06-05T07:47:00+10:00,2023-06-05,07:47,1,0,1
18,2023-06-05T07:47:00+10:00,2023-06-05,07:47,0,5,5
46,2023-06-05T07:47:00+10:00,2023-06-05,07:47,1,2,3
49,2023-06-05T07:47:00+10:00,2023-06-05,07:47,1,2,3
52,2023-06-05T07:47:00+10:00,2023-06-05,07:47,1,0,1
57,2023-06-05T07:47:00+10:00,2023-06-05,07:47,8,6,14
58,2023-06-05T07:47:00+10:00,2023-06-05,07:47,7,1,8
8,2023-06-05T07:46:00+10:00,2023-06-05,07:46,2,1,3
29,2023-06-05T07:46:00+10:00,2023-06-05,07:46,1,2,3
37,2023-06-05T07:46:00+10:00,2023-06-05,07:46,2,1,3
39,2023-06-05T07:46:00+10:00,2023-06-05,07:46,2,2,4
41,2023-06-05T07:46:00+10:00,2023-06-05,07:46,7,6,13
44,2023-06-05T07:46:00+10:00,2023-06-05,07:46,0,2,2
61,2023-06-05T07:46:00+10:00,2023-06-05,07:46,5,5,10
78,2023-06-05T07:46:00+10:00,2023-06-05,07:46,1,0,1
12,2023-06-05T07:46:00+10:00,2023-06-05,07:46,5,1,6
17,2023-06-05T07:46:00+10:00,2023-06-05,07:46,3,1,4
46,2023-06-05T07:46:00+10:00,2023-06-05,07:46,1,0,1
57,2023-06-05T07:46:00+10:00,2023-06-05,07:46,5,3,8
63,2023-06-05T07:46:00+10:00,2023-06-05,07:46,2,1,3
3,2023-06-05T07:46:00+10:00,2023-06-05,07:46,1,2,3
5,2023-06-05T07:46:00+10:00,2023-06-05,07:46,4,5,9
6,2023-06-05T07:46:00+10:00,2023-06-05,07:46,0,8,8
26,2023-06-05T07:46:00+10:00,2023-06-05,07:46,1,2,3
28,2023-06-05T07:46:00+10:00,2023-06-05,07:46,6,3,9
40,2023-06-05T07:46:00+10:00,2023-06-05,07:46,5,0,5
45,2023-06-05T07:46:00+10:00,2023-06-05,07:46,0,6,6
47,2023-06-05T07:46:00+10:00,2023-06-05,07:46,4,2,6
50,2023-06-05T07:46:00+10:00,2023-06-05,07:46,0,2,2
55,2023-06-05T07:46:00+10:00,2023-06-05,07:46,6,5,11
65,2023-06-05T07:46:00+10:00,2023-06-05,07:46,4,4,8
66,2023-06-05T07:46:00+10:00,2023-06-05,07:46,0,5,5
69,2023-06-05T07:46:00+10:00,2023-06-05,07:46,1,1,2
75,2023-06-05T07:46:00+10:00,2023-06-05,07:46,1,0,1
9,2023-06-05T07:46:00+10:00,2023-06-05,07:46,0,18,18
10,2023-06-05T07:46:00+10:00,2023-06-05,07:46,1,4,5
23,2023-06-05T07:46:00+10:00,2023-06-05,07:46,7,1,8
24,2023-06-05T07:46:00+10:00,2023-06-05,07:46,34,7,41
51,2023-06-05T07:46:00+10:00,2023-06-05,07:46,0,1,1
52,2023-06-05T07:46:00+10:00,2023-06-05,07:46,3,4,7
53,2023-06-05T07:46:00+10:00,2023-06-05,07:46,5,2,7
56,2023-06-05T07:46:00+10:00,2023-06-05,07:46,2,0,2
67,2023-06-05T07:46:00+10:00,2023-06-05,07:46,2,2,4
79,2023-06-05T07:46:00+10:00,2023-06-05,07:46,9,2,11
85,2023-06-05T07:46:00+10:00,2023-06-05,07:46,1,0,1
4,2023-06-05T07:46:00+10:00,2023-06-05,07:46,5,3,8
14,2023-06-05T07:46:00+10:00,2023-06-05,07:46,0,2,2
21,2023-06-05T07:46:00+10:00,2023-06-05,07:46,1,2,3
36,2023-06-05T07:46:00+10:00,2023-06-05,07:46,1,0,1
54,2023-06-05T07:46:00+10:00,2023-06-05,07:46,1,2,3
71,2023-06-05T07:46:00+10:00,2023-06-05,07:46,1,0,1
77,2023-06-05T07:46:00+10:00,2023-06-05,07:46,1,3,4
108,2023-06-05T07:46:00+10:00,2023-06-05,07:46,0,15,15
1,2023-06-05T07:46:00+10:00,2023-06-05,07:46,0,2,2
2,2023-06-05T07:46:00+10:00,2023-06-05,07:46,2,1,3
18,2023-06-05T07:46:00+10:00,2023-06-05,07:46,0,3,3
19,2023-06-05T07:46:00+10:00,2023-06-05,07:46,0,1,1
20,2023-06-05T07:46:00+10:00,2023-06-05,07:46,2,0,2
30,2023-06-05T07:46:00+10:00,2023-06-05,07:46,0,1,1
35,2023-06-05T07:46:00+10:00,2023-06-05,07:46,5,8,13
48,2023-06-05T07:46:00+10:00,2023-06-05,07:46,0,1,1
49,2023-06-05T07:46:00+10:00,2023-06-05,07:46,3,0,3
58,2023-06-05T07:46:00+10:00,2023-06-05,07:46,9,3,12
62,2023-06-05T07:46:00+10:00,2023-06-05,07:46,5,1,6
72,2023-06-05T07:46:00+10:00,2023-06-05,07:46,2,1,3
4,2023-06-05T07:45:00+10:00,2023-06-05,07:45,10,2,12
29,2023-06-05T07:45:00+10:00,2023-06-05,07:45,0,2,2
36,2023-06-05T07:45:00+10:00,2023-06-05,07:45,1,3,4
39,2023-06-05T07:45:00+10:00,2023-06-05,07:45,2,0,2
40,2023-06-05T07:45:00+10:00,2023-06-05,07:45,4,1,5
41,2023-06-05T07:45:00+10:00,2023-06-05,07:45,3,3,6
55,2023-06-05T07:45:00+10:00,2023-06-05,07:45,9,6,15
71,2023-06-05T07:45:00+10:00,2023-06-05,07:45,0,1,1
84,2023-06-05T07:45:00+10:00,2023-06-05,07:45,54,21,75
87,2023-06-05T07:45:00+10:00,2023-06-05,07:45,1,0,1
107,2023-06-05T07:45:00+10:00,2023-06-05,07:45,5,9,14
108,2023-06-05T07:45:00+10:00,2023-06-05,07:45,5,14,19
1,2023-06-05T07:45:00+10:00,2023-06-05,07:45,3,1,4
10,2023-06-05T07:45:00+10:00,2023-06-05,07:45,1,4,5
12,2023-06-05T07:45:00+10:00,2023-06-05,07:45,0,2,2
18,2023-06-05T07:45:00+10:00,2023-06-05,07:45,1,3,4
19,2023-06-05T07:45:00+10:00,2023-06-05,07:45,3,1,4
23,2023-06-05T07:45:00+10:00,2023-06-05,07:45,2,4,6
24,2023-06-05T07:45:00+10:00,2023-06-05,07:45,24,5,29
30,2023-06-05T07:45:00+10:00,2023-06-05,07:45,1,1,2
46,2023-06-05T07:45:00+10:00,2023-06-05,07:45,1,0,1
53,2023-06-05T07:45:00+10:00,2023-06-05,07:45,1,0,1
58,2023-06-05T07:45:00+10:00,2023-06-05,07:45,25,3,28
62,2023-06-05T07:45:00+10:00,2023-06-05,07:45,1,0,1
63,2023-06-05T07:45:00+10:00,2023-06-05,07:45,3,0,3
68,2023-06-05T07:45:00+10:00,2023-06-05,07:45,1,0,1
109,2023-06-05T07:45:00+10:00,2023-06-05,07:45,3,30,33
3,2023-06-05T07:45:00+10:00,2023-06-05,07:45,2,0,2
6,2023-06-05T07:45:00+10:00,2023-06-05,07:45,6,18,24
8,2023-06-05T07:45:00+10:00,2023-06-05,07:45,1,2,3
14,2023-06-05T07:45:00+10:00,2023-06-05,07:45,8,2,10
26,2023-06-05T07:45:00+10:00,2023-06-05,07:45,2,0,2
45,2023-06-05T07:45:00+10:00,2023-06-05,07:45,3,3,6
47,2023-06-05T07:45:00+10:00,2023-06-05,07:45,1,4,5
66,2023-06-05T07:45:00+10:00,2023-06-05,07:45,0,3,3
77,2023-06-05T07:45:00+10:00,2023-06-05,07:45,2,2,4
118,2023-06-05T07:45:00+10:00,2023-06-05,07:45,0,2,2
9,2023-06-05T07:45:00+10:00,2023-06-05,07:45,0,10,10
11,2023-06-05T07:45:00+10:00,2023-06-05,07:45,1,1,2
17,2023-06-05T07:45:00+10:00,2023-06-05,07:45,5,1,6
20,2023-06-05T07:45:00+10:00,2023-06-05,07:45,0,2,2
48,2023-06-05T07:45:00+10:00,2023-06-05,07:45,4,1,5
56,2023-06-05T07:45:00+10:00,2023-06-05,07:45,3,0,3
57,2023-06-05T07:45:00+10:00,2023-06-05,07:45,2,4,6
67,2023-06-05T07:45:00+10:00,2023-06-05,07:45,5,3,8
72,2023-06-05T07:45:00+10:00,2023-06-05,07:45,2,1,3
85,2023-06-05T07:45:00+10:00,2023-06-05,07:45,3,1,4
117,2023-06-05T07:45:00+10:00,2023-06-05,07:45,4,2,6
5,2023-06-05T07:45:00+10:00,2023-06-05,07:45,2,9,11
21,2023-06-05T07:45:00+10:00,2023-06-05,07:45,0,1,1
28,2023-06-05T07:45:00+10:00,2023-06-05,07:45,4,2,6
31,2023-06-05T07:45:00+10:00,2023-06-05,07:45,0,2,2
42,2023-06-05T07:45:00+10:00,2023-06-05,07:45,0,2,2
61,2023-06-05T07:45:00+10:00,2023-06-05,07:45,3,2,5
70,2023-06-05T07:45:00+10:00,2023-06-05,07:45,1,2,3
75,2023-06-05T07:45:00+10:00,2023-06-05,07:45,1,1,2
78,2023-06-05T07:45:00+10:00,2023-06-05,07:45,2,0,2
2,2023-06-05T07:45:00+10:00,2023-06-05,07:45,2,2,4
27,2023-06-05T07:45:00+10:00,2023-06-05,07:45,1,0,1
35,2023-06-05T07:45:00+10:00,2023-06-05,07:45,5,5,10
52,2023-06-05T07:45:00+10:00,2023-06-05,07:45,0,7,7
79,2023-06-05T07:45:00+10:00,2023-06-05,07:45,3,4,7
4,2023-06-05T07:44:00+10:00,2023-06-05,07:44,2,3,5
6,2023-06-05T07:44:00+10:00,2023-06-05,07:44,5,8,13
26,2023-06-05T07:44:00+10:00,2023-06-05,07:44,3,0,3
31,2023-06-05T07:44:00+10:00,2023-06-05,07:44,1,0,1
36,2023-06-05T07:44:00+10:00,2023-06-05,07:44,3,0,3
45,2023-06-05T07:44:00+10:00,2023-06-05,07:44,1,3,4
55,2023-06-05T07:44:00+10:00,2023-06-05,07:44,1,4,5
66,2023-06-05T07:44:00+10:00,2023-06-05,07:44,2,5,7
87,2023-06-05T07:44:00+10:00,2023-06-05,07:44,1,1,2
1,2023-06-05T07:44:00+10:00,2023-06-05,07:44,1,1,2
2,2023-06-05T07:44:00+10:00,2023-06-05,07:44,4,2,6
9,2023-06-05T07:44:00+10:00,2023-06-05,07:44,1,12,13
10,2023-06-05T07:44:00+10:00,2023-06-05,07:44,1,4,5
11,2023-06-05T07:44:00+10:00,2023-06-05,07:44,0,1,1
18,2023-06-05T07:44:00+10:00,2023-06-05,07:44,0,2,2
19,2023-06-05T07:44:00+10:00,2023-06-05,07:44,1,0,1
48,2023-06-05T07:44:00+10:00,2023-06-05,07:44,0,1,1
49,2023-06-05T07:44:00+10:00,2023-06-05,07:44,2,0,2
63,2023-06-05T07:44:00+10:00,2023-06-05,07:44,0,1,1
67,2023-06-05T07:44:00+10:00,2023-06-05,07:44,3,0,3
72,2023-06-05T07:44:00+10:00,2023-06-05,07:44,1,0,1
76,2023-06-05T07:44:00+10:00,2023-06-05,07:44,0,1,1
3,2023-06-05T07:44:00+10:00,2023-06-05,07:44,5,2,7
5,2023-06-05T07:44:00+10:00,2023-06-05,07:44,3,4,7
8,2023-06-05T07:44:00+10:00,2023-06-05,07:44,2,2,4
28,2023-06-05T07:44:00+10:00,2023-06-05,07:44,11,5,16
39,2023-06-05T07:44:00+10:00,2023-06-05,07:44,2,1,3
40,2023-06-05T07:44:00+10:00,2023-06-05,07:44,3,1,4
42,2023-06-05T07:44:00+10:00,2023-06-05,07:44,0,1,1
54,2023-06-05T07:44:00+10:00,2023-06-05,07:44,2,2,4
61,2023-06-05T07:44:00+10:00,2023-06-05,07:44,2,4,6
108,2023-06-05T07:44:00+10:00,2023-06-05,07:44,1,23,24
20,2023-06-05T07:44:00+10:00,2023-06-05,07:44,0,1,1
24,2023-06-05T07:44:00+10:00,2023-06-05,07:44,1,11,12
30,2023-06-05T07:44:00+10:00,2023-06-05,07:44,0,1,1
35,2023-06-05T07:44:00+10:00,2023-06-05,07:44,2,6,8
46,2023-06-05T07:44:00+10:00,2023-06-05,07:44,2,1,3
53,2023-06-05T07:44:00+10:00,2023-06-05,07:44,2,1,3
57,2023-06-05T07:44:00+10:00,2023-06-05,07:44,5,14,19
58,2023-06-05T07:44:00+10:00,2023-06-05,07:44,5,0,5
14,2023-06-05T07:44:00+10:00,2023-06-05,07:44,2,4,6
21,2023-06-05T07:44:00+10:00,2023-06-05,07:44,2,0,2
41,2023-06-05T07:44:00+10:00,2023-06-05,07:44,24,3,27
47,2023-06-05T07:44:00+10:00,2023-06-05,07:44,2,10,12
70,2023-06-05T07:44:00+10:00,2023-06-05,07:44,1,0,1
12,2023-06-05T07:44:00+10:00,2023-06-05,07:44,3,0,3
17,2023-06-05T07:44:00+10:00,2023-06-05,07:44,12,2,14
23,2023-06-05T07:44:00+10:00,2023-06-05,07:44,0,5,5
56,2023-06-05T07:44:00+10:00,2023-06-05,07:44,2,2,4
68,2023-06-05T07:44:00+10:00,2023-06-05,07:44,1,0,1
79,2023-06-05T07:44:00+10:00,2023-06-05,07:44,2,2,4
85,2023-06-05T07:44:00+10:00,2023-06-05,07:44,0,1,1
86,2023-06-05T07:44:00+10:00,2023-06-05,07:44,0,1,1
5,2023-06-05T07:43:00+10:00,2023-06-05,07:43,3,3,6
6,2023-06-05T07:43:00+10:00,2023-06-05,07:43,4,8,12
8,2023-06-05T07:43:00+10:00,2023-06-05,07:43,3,4,7
21,2023-06-05T07:43:00+10:00,2023-06-05,07:43,0,5,5
26,2023-06-05T07:43:00+10:00,2023-06-05,07:43,3,2,5
29,2023-06-05T07:43:00+10:00,2023-06-05,07:43,0,2,2
31,2023-06-05T07:43:00+10:00,2023-06-05,07:43,1,0,1
40,2023-06-05T07:43:00+10:00,2023-06-05,07:43,1,4,5
45,2023-06-05T07:43:00+10:00,2023-06-05,07:43,2,5,7
55,2023-06-05T07:43:00+10:00,2023-06-05,07:43,0,5,5
65,2023-06-05T07:43:00+10:00,2023-06-05,07:43,7,1,8
69,2023-06-05T07:43:00+10:00,2023-06-05,07:43,2,0,2
87,2023-06-05T07:43:00+10:00,2023-06-05,07:43,0,2,2
108,2023-06-05T07:43:00+10:00,2023-06-05,07:43,0,18,18
1,2023-06-05T07:43:00+10:00,2023-06-05,07:43,6,0,6
11,2023-06-05T07:43:00+10:00,2023-06-05,07:43,0,3,3
18,2023-06-05T07:43:00+10:00,2023-06-05,07:43,0,9,9
20,2023-06-05T07:43:00+10:00,2023-06-05,07:43,0,1,1
27,2023-06-05T07:43:00+10:00,2023-06-05,07:43,1,2,3
30,2023-06-05T07:43:00+10:00,2023-06-05,07:43,1,1,2
35,2023-06-05T07:43:00+10:00,2023-06-05,07:43,7,5,12
48,2023-06-05T07:43:00+10:00,2023-06-05,07:43,2,0,2
52,2023-06-05T07:43:00+10:00,2023-06-05,07:43,3,2,5
53,2023-06-05T07:43:00+10:00,2023-06-05,07:43,2,0,2
56,2023-06-05T07:43:00+10:00,2023-06-05,07:43,0,1,1
58,2023-06-05T07:43:00+10:00,2023-06-05,07:43,19,2,21
63,2023-06-05T07:43:00+10:00,2023-06-05,07:43,0,1,1
72,2023-06-05T07:43:00+10:00,2023-06-05,07:43,5,1,6
79,2023-06-05T07:43:00+10:00,2023-06-05,07:43,2,2,4
14,2023-06-05T07:43:00+10:00,2023-06-05,07:43,2,5,7
28,2023-06-05T07:43:00+10:00,2023-06-05,07:43,7,3,10
42,2023-06-05T07:43:00+10:00,2023-06-05,07:43,1,2,3
54,2023-06-05T07:43:00+10:00,2023-06-05,07:43,4,0,4
75,2023-06-05T07:43:00+10:00,2023-06-05,07:43,1,1,2
2,2023-06-05T07:43:00+10:00,2023-06-05,07:43,1,2,3
17,2023-06-05T07:43:00+10:00,2023-06-05,07:43,8,3,11
23,2023-06-05T07:43:00+10:00,2023-06-05,07:43,1,3,4
24,2023-06-05T07:43:00+10:00,2023-06-05,07:43,20,4,24
46,2023-06-05T07:43:00+10:00,2023-06-05,07:43,1,2,3
51,2023-06-05T07:43:00+10:00,2023-06-05,07:43,1,0,1
57,2023-06-05T07:43:00+10:00,2023-06-05,07:43,11,3,14
76,2023-06-05T07:43:00+10:00,2023-06-05,07:43,0,2,2
3,2023-06-05T07:43:00+10:00,2023-06-05,07:43,2,3,5
4,2023-06-05T07:43:00+10:00,2023-06-05,07:43,6,0,6
36,2023-06-05T07:43:00+10:00,2023-06-05,07:43,2,1,3
41,2023-06-05T07:43:00+10:00,2023-06-05,07:43,12,0,12
47,2023-06-05T07:43:00+10:00,2023-06-05,07:43,3,6,9
66,2023-06-05T07:43:00+10:00,2023-06-05,07:43,3,6,9
77,2023-06-05T07:43:00+10:00,2023-06-05,07:43,2,2,4
78,2023-06-05T07:43:00+10:00,2023-06-05,07:43,0,1,1
9,2023-06-05T07:43:00+10:00,2023-06-05,07:43,0,11,11
10,2023-06-05T07:43:00+10:00,2023-06-05,07:43,0,1,1
12,2023-06-05T07:43:00+10:00,2023-06-05,07:43,1,1,2
49,2023-06-05T07:43:00+10:00,2023-06-05,07:43,0,1,1
62,2023-06-05T07:43:00+10:00,2023-06-05,07:43,1,0,1
67,2023-06-05T07:43:00+10:00,2023-06-05,07:43,1,1,2
68,2023-06-05T07:43:00+10:00,2023-06-05,07:43,1,0,1
85,2023-06-05T07:43:00+10:00,2023-06-05,07:43,3,0,3
5,2023-06-05T07:42:00+10:00,2023-06-05,07:42,1,5,6
6,2023-06-05T07:42:00+10:00,2023-06-05,07:42,4,3,7
14,2023-06-05T07:42:00+10:00,2023-06-05,07:42,3,2,5
26,2023-06-05T07:42:00+10:00,2023-06-05,07:42,4,0,4
44,2023-06-05T07:42:00+10:00,2023-06-05,07:42,0,2,2
54,2023-06-05T07:42:00+10:00,2023-06-05,07:42,0,2,2
55,2023-06-05T07:42:00+10:00,2023-06-05,07:42,3,9,12
65,2023-06-05T07:42:00+10:00,2023-06-05,07:42,1,1,2
77,2023-06-05T07:42:00+10:00,2023-06-05,07:42,1,3,4
9,2023-06-05T07:42:00+10:00,2023-06-05,07:42,1,22,23
11,2023-06-05T07:42:00+10:00,2023-06-05,07:42,2,0,2
12,2023-06-05T07:42:00+10:00,2023-06-05,07:42,0,2,2
17,2023-06-05T07:42:00+10:00,2023-06-05,07:42,9,0,9
20,2023-06-05T07:42:00+10:00,2023-06-05,07:42,2,0,2
35,2023-06-05T07:42:00+10:00,2023-06-05,07:42,7,5,12
52,2023-06-05T07:42:00+10:00,2023-06-05,07:42,2,3,5
56,2023-06-05T07:42:00+10:00,2023-06-05,07:42,1,0,1
62,2023-06-05T07:42:00+10:00,2023-06-05,07:42,4,0,4
68,2023-06-05T07:42:00+10:00,2023-06-05,07:42,1,0,1
72,2023-06-05T07:42:00+10:00,2023-06-05,07:42,5,3,8
3,2023-06-05T07:42:00+10:00,2023-06-05,07:42,1,5,6
8,2023-06-05T07:42:00+10:00,2023-06-05,07:42,1,0,1
28,2023-06-05T07:42:00+10:00,2023-06-05,07:42,12,5,17
29,2023-06-05T07:42:00+10:00,2023-06-05,07:42,1,2,3
39,2023-06-05T07:42:00+10:00,2023-06-05,07:42,1,0,1
41,2023-06-05T07:42:00+10:00,2023-06-05,07:42,14,5,19
61,2023-06-05T07:42:00+10:00,2023-06-05,07:42,1,5,6
66,2023-06-05T07:42:00+10:00,2023-06-05,07:42,0,7,7
69,2023-06-05T07:42:00+10:00,2023-06-05,07:42,3,1,4
70,2023-06-05T07:42:00+10:00,2023-06-05,07:42,0,2,2
78,2023-06-05T07:42:00+10:00,2023-06-05,07:42,1,1,2
108,2023-06-05T07:42:00+10:00,2023-06-05,07:42,0,8,8
18,2023-06-05T07:42:00+10:00,2023-06-05,07:42,1,8,9
23,2023-06-05T07:42:00+10:00,2023-06-05,07:42,0,1,1
53,2023-06-05T07:42:00+10:00,2023-06-05,07:42,2,10,12
63,2023-06-05T07:42:00+10:00,2023-06-05,07:42,0,2,2
79,2023-06-05T07:42:00+10:00,2023-06-05,07:42,10,8,18
4,2023-06-05T07:42:00+10:00,2023-06-05,07:42,6,4,10
21,2023-06-05T07:42:00+10:00,2023-06-05,07:42,0,1,1
36,2023-06-05T07:42:00+10:00,2023-06-05,07:42,0,1,1
40,2023-06-05T07:42:00+10:00,2023-06-05,07:42,4,3,7
45,2023-06-05T07:42:00+10:00,2023-06-05,07:42,1,0,1
47,2023-06-05T07:42:00+10:00,2023-06-05,07:42,0,8,8
87,2023-06-05T07:42:00+10:00,2023-06-05,07:42,0,2,2
1,2023-06-05T07:42:00+10:00,2023-06-05,07:42,0,2,2
10,2023-06-05T07:42:00+10:00,2023-06-05,07:42,0,2,2
24,2023-06-05T07:42:00+10:00,2023-06-05,07:42,19,1,20
48,2023-06-05T07:42:00+10:00,2023-06-05,07:42,1,0,1
49,2023-06-05T07:42:00+10:00,2023-06-05,07:42,2,0,2
57,2023-06-05T07:42:00+10:00,2023-06-05,07:42,6,9,15
58,2023-06-05T07:42:00+10:00,2023-06-05,07:42,19,2,21
67,2023-06-05T07:42:00+10:00,2023-06-05,07:42,2,1,3
85,2023-06-05T07:42:00+10:00,2023-06-05,07:42,3,0,3
5,2023-06-05T07:41:00+10:00,2023-06-05,07:41,6,6,12
6,2023-06-05T07:41:00+10:00,2023-06-05,07:41,5,4,9
14,2023-06-05T07:41:00+10:00,2023-06-05,07:41,3,7,10
26,2023-06-05T07:41:00+10:00,2023-06-05,07:41,2,5,7
29,2023-06-05T07:41:00+10:00,2023-06-05,07:41,3,0,3
47,2023-06-05T07:41:00+10:00,2023-06-05,07:41,1,9,10
55,2023-06-05T07:41:00+10:00,2023-06-05,07:41,1,5,6
61,2023-06-05T07:41:00+10:00,2023-06-05,07:41,2,1,3
9,2023-06-05T07:41:00+10:00,2023-06-05,07:41,0,15,15
12,2023-06-05T07:41:00+10:00,2023-06-05,07:41,1,0,1
17,2023-06-05T07:41:00+10:00,2023-06-05,07:41,4,1,5
23,2023-06-05T07:41:00+10:00,2023-06-05,07:41,6,1,7
30,2023-06-05T07:41:00+10:00,2023-06-05,07:41,1,5,6
35,2023-06-05T07:41:00+10:00,2023-06-05,07:41,5,8,13
46,2023-06-05T07:41:00+10:00,2023-06-05,07:41,1,3,4
49,2023-06-05T07:41:00+10:00,2023-06-05,07:41,2,0,2
56,2023-06-05T07:41:00+10:00,2023-06-05,07:41,2,0,2
72,2023-06-05T07:41:00+10:00,2023-06-05,07:41,4,2,6
85,2023-06-05T07:41:00+10:00,2023-06-05,07:41,0,1,1
8,2023-06-05T07:41:00+10:00,2023-06-05,07:41,1,4,5
28,2023-06-05T07:41:00+10:00,2023-06-05,07:41,18,2,20
39,2023-06-05T07:41:00+10:00,2023-06-05,07:41,3,1,4
40,2023-06-05T07:41:00+10:00,2023-06-05,07:41,4,1,5
41,2023-06-05T07:41:00+10:00,2023-06-05,07:41,17,6,23
44,2023-06-05T07:41:00+10:00,2023-06-05,07:41,0,1,1
54,2023-06-05T07:41:00+10:00,2023-06-05,07:41,1,0,1
69,2023-06-05T07:41:00+10:00,2023-06-05,07:41,2,0,2
108,2023-06-05T07:41:00+10:00,2023-06-05,07:41,0,3,3
10,2023-06-05T07:41:00+10:00,2023-06-05,07:41,0,4,4
20,2023-06-05T07:41:00+10:00,2023-06-05,07:41,0,1,1
24,2023-06-05T07:41:00+10:00,2023-06-05,07:41,23,5,28
52,2023-06-05T07:41:00+10:00,2023-06-05,07:41,0,2,2
53,2023-06-05T07:41:00+10:00,2023-06-05,07:41,3,0,3
57,2023-06-05T07:41:00+10:00,2023-06-05,07:41,3,11,14
76,2023-06-05T07:41:00+10:00,2023-06-05,07:41,1,1,2
79,2023-06-05T07:41:00+10:00,2023-06-05,07:41,3,0,3
3,2023-06-05T07:41:00+10:00,2023-06-05,07:41,1,2,3
4,2023-06-05T07:41:00+10:00,2023-06-05,07:41,5,3,8
21,2023-06-05T07:41:00+10:00,2023-06-05,07:41,2,0,2
42,2023-06-05T07:41:00+10:00,2023-06-05,07:41,0,3,3
45,2023-06-05T07:41:00+10:00,2023-06-05,07:41,3,1,4
66,2023-06-05T07:41:00+10:00,2023-06-05,07:41,1,2,3
77,2023-06-05T07:41:00+10:00,2023-06-05,07:41,2,2,4
78,2023-06-05T07:41:00+10:00,2023-06-05,07:41,0,1,1
1,2023-06-05T07:41:00+10:00,2023-06-05,07:41,2,2,4
2,2023-06-05T07:41:00+10:00,2023-06-05,07:41,1,2,3
11,2023-06-05T07:41:00+10:00,2023-06-05,07:41,1,0,1
18,2023-06-05T07:41:00+10:00,2023-06-05,07:41,0,2,2
27,2023-06-05T07:41:00+10:00,2023-06-05,07:41,1,1,2
48,2023-06-05T07:41:00+10:00,2023-06-05,07:41,0,1,1
58,2023-06-05T07:41:00+10:00,2023-06-05,07:41,3,1,4
63,2023-06-05T07:41:00+10:00,2023-06-05,07:41,2,1,3
67,2023-06-05T07:41:00+10:00,2023-06-05,07:41,1,4,5
8,2023-06-05T07:40:00+10:00,2023-06-05,07:40,1,4,5
61,2023-06-05T07:40:00+10:00,2023-06-05,07:40,2,1,3
65,2023-06-05T07:40:00+10:00,2023-06-05,07:40,2,1,3
108,2023-06-05T07:40:00+10:00,2023-06-05,07:40,0,4,4
9,2023-06-05T07:40:00+10:00,2023-06-05,07:40,1,12,13
10,2023-06-05T07:40:00+10:00,2023-06-05,07:40,0,2,2
12,2023-06-05T07:40:00+10:00,2023-06-05,07:40,2,1,3
17,2023-06-05T07:40:00+10:00,2023-06-05,07:40,7,3,10
20,2023-06-05T07:40:00+10:00,2023-06-05,07:40,1,1,2
46,2023-06-05T07:40:00+10:00,2023-06-05,07:40,1,0,1
48,2023-06-05T07:40:00+10:00,2023-06-05,07:40,2,1,3
52,2023-06-05T07:40:00+10:00,2023-06-05,07:40,1,2,3
57,2023-06-05T07:40:00+10:00,2023-06-05,07:40,3,5,8
58,2023-06-05T07:40:00+10:00,2023-06-05,07:40,15,0,15
62,2023-06-05T07:40:00+10:00,2023-06-05,07:40,0,1,1
72,2023-06-05T07:40:00+10:00,2023-06-05,07:40,2,0,2
79,2023-06-05T07:40:00+10:00,2023-06-05,07:40,2,4,6
117,2023-06-05T07:40:00+10:00,2023-06-05,07:40,6,5,11
4,2023-06-05T07:40:00+10:00,2023-06-05,07:40,5,0,5
26,2023-06-05T07:40:00+10:00,2023-06-05,07:40,3,0,3
28,2023-06-05T07:40:00+10:00,2023-06-05,07:40,8,2,10
29,2023-06-05T07:40:00+10:00,2023-06-05,07:40,0,1,1
41,2023-06-05T07:40:00+10:00,2023-06-05,07:40,24,4,28
44,2023-06-05T07:40:00+10:00,2023-06-05,07:40,0,1,1
54,2023-06-05T07:40:00+10:00,2023-06-05,07:40,1,0,1
55,2023-06-05T07:40:00+10:00,2023-06-05,07:40,4,7,11
66,2023-06-05T07:40:00+10:00,2023-06-05,07:40,0,1,1
69,2023-06-05T07:40:00+10:00,2023-06-05,07:40,2,0,2
75,2023-06-05T07:40:00+10:00,2023-06-05,07:40,0,1,1
11,2023-06-05T07:40:00+10:00,2023-06-05,07:40,5,1,6
18,2023-06-05T07:40:00+10:00,2023-06-05,07:40,0,8,8
23,2023-06-05T07:40:00+10:00,2023-06-05,07:40,7,1,8
56,2023-06-05T07:40:00+10:00,2023-06-05,07:40,4,0,4
63,2023-06-05T07:40:00+10:00,2023-06-05,07:40,1,2,3
68,2023-06-05T07:40:00+10:00,2023-06-05,07:40,1,0,1
85,2023-06-05T07:40:00+10:00,2023-06-05,07:40,1,0,1
86,2023-06-05T07:40:00+10:00,2023-06-05,07:40,2,1,3
109,2023-06-05T07:40:00+10:00,2023-06-05,07:40,5,30,35
3,2023-06-05T07:40:00+10:00,2023-06-05,07:40,0,1,1
5,2023-06-05T07:40:00+10:00,2023-06-05,07:40,2,9,11
6,2023-06-05T07:40:00+10:00,2023-06-05,07:40,7,10,17
14,2023-06-05T07:40:00+10:00,2023-06-05,07:40,3,1,4
36,2023-06-05T07:40:00+10:00,2023-06-05,07:40,1,2,3
39,2023-06-05T07:40:00+10:00,2023-06-05,07:40,3,3,6
40,2023-06-05T07:40:00+10:00,2023-06-05,07:40,1,0,1
42,2023-06-05T07:40:00+10:00,2023-06-05,07:40,0,3,3
45,2023-06-05T07:40:00+10:00,2023-06-05,07:40,3,0,3
47,2023-06-05T07:40:00+10:00,2023-06-05,07:40,1,10,11
50,2023-06-05T07:40:00+10:00,2023-06-05,07:40,0,1,1
59,2023-06-05T07:40:00+10:00,2023-06-05,07:40,16,1,17
84,2023-06-05T07:40:00+10:00,2023-06-05,07:40,72,20,92
107,2023-06-05T07:40:00+10:00,2023-06-05,07:40,2,6,8
1,2023-06-05T07:40:00+10:00,2023-06-05,07:40,1,2,3
2,2023-06-05T07:40:00+10:00,2023-06-05,07:40,0,1,1
24,2023-06-05T07:40:00+10:00,2023-06-05,07:40,25,6,31
27,2023-06-05T07:40:00+10:00,2023-06-05,07:40,0,1,1
35,2023-06-05T07:40:00+10:00,2023-06-05,07:40,4,6,10
49,2023-06-05T07:40:00+10:00,2023-06-05,07:40,0,3,3
53,2023-06-05T07:40:00+10:00,2023-06-05,07:40,1,1,2
67,2023-06-05T07:40:00+10:00,2023-06-05,07:40,0,4,4
3,2023-06-05T07:39:00+10:00,2023-06-05,07:39,3,2,5
4,2023-06-05T07:39:00+10:00,2023-06-05,07:39,2,3,5
5,2023-06-05T07:39:00+10:00,2023-06-05,07:39,3,11,14
14,2023-06-05T07:39:00+10:00,2023-06-05,07:39,1,2,3
21,2023-06-05T07:39:00+10:00,2023-06-05,07:39,2,0,2
36,2023-06-05T07:39:00+10:00,2023-06-05,07:39,6,2,8
40,2023-06-05T07:39:00+10:00,2023-06-05,07:39,2,1,3
41,2023-06-05T07:39:00+10:00,2023-06-05,07:39,23,5,28
55,2023-06-05T07:39:00+10:00,2023-06-05,07:39,1,2,3
65,2023-06-05T07:39:00+10:00,2023-06-05,07:39,2,2,4
69,2023-06-05T07:39:00+10:00,2023-06-05,07:39,2,0,2
77,2023-06-05T07:39:00+10:00,2023-06-05,07:39,2,1,3
2,2023-06-05T07:39:00+10:00,2023-06-05,07:39,2,1,3
9,2023-06-05T07:39:00+10:00,2023-06-05,07:39,2,9,11
12,2023-06-05T07:39:00+10:00,2023-06-05,07:39,2,0,2
17,2023-06-05T07:39:00+10:00,2023-06-05,07:39,8,1,9
18,2023-06-05T07:39:00+10:00,2023-06-05,07:39,0,6,6
46,2023-06-05T07:39:00+10:00,2023-06-05,07:39,0,1,1
53,2023-06-05T07:39:00+10:00,2023-06-05,07:39,3,1,4
57,2023-06-05T07:39:00+10:00,2023-06-05,07:39,3,3,6
62,2023-06-05T07:39:00+10:00,2023-06-05,07:39,2,1,3
63,2023-06-05T07:39:00+10:00,2023-06-05,07:39,2,2,4
67,2023-06-05T07:39:00+10:00,2023-06-05,07:39,1,3,4
85,2023-06-05T07:39:00+10:00,2023-06-05,07:39,2,1,3
8,2023-06-05T07:39:00+10:00,2023-06-05,07:39,2,3,5
39,2023-06-05T07:39:00+10:00,2023-06-05,07:39,2,0,2
42,2023-06-05T07:39:00+10:00,2023-06-05,07:39,0,2,2
47,2023-06-05T07:39:00+10:00,2023-06-05,07:39,1,6,7
61,2023-06-05T07:39:00+10:00,2023-06-05,07:39,2,6,8
66,2023-06-05T07:39:00+10:00,2023-06-05,07:39,1,6,7
78,2023-06-05T07:39:00+10:00,2023-06-05,07:39,1,1,2
1,2023-06-05T07:39:00+10:00,2023-06-05,07:39,1,2,3
10,2023-06-05T07:39:00+10:00,2023-06-05,07:39,1,0,1
23,2023-06-05T07:39:00+10:00,2023-06-05,07:39,2,8,10
24,2023-06-05T07:39:00+10:00,2023-06-05,07:39,5,10,15
35,2023-06-05T07:39:00+10:00,2023-06-05,07:39,3,7,10
49,2023-06-05T07:39:00+10:00,2023-06-05,07:39,0,3,3
56,2023-06-05T07:39:00+10:00,2023-06-05,07:39,2,1,3
68,2023-06-05T07:39:00+10:00,2023-06-05,07:39,1,2,3
76,2023-06-05T07:39:00+10:00,2023-06-05,07:39,2,1,3
6,2023-06-05T07:39:00+10:00,2023-06-05,07:39,5,12,17
26,2023-06-05T07:39:00+10:00,2023-06-05,07:39,3,1,4
28,2023-06-05T07:39:00+10:00,2023-06-05,07:39,5,7,12
29,2023-06-05T07:39:00+10:00,2023-06-05,07:39,1,1,2
31,2023-06-05T07:39:00+10:00,2023-06-05,07:39,1,0,1
54,2023-06-05T07:39:00+10:00,2023-06-05,07:39,0,2,2
75,2023-06-05T07:39:00+10:00,2023-06-05,07:39,1,0,1
108,2023-06-05T07:39:00+10:00,2023-06-05,07:39,1,10,11
27,2023-06-05T07:39:00+10:00,2023-06-05,07:39,0,1,1
30,2023-06-05T07:39:00+10:00,2023-06-05,07:39,1,0,1
51,2023-06-05T07:39:00+10:00,2023-06-05,07:39,1,0,1
52,2023-06-05T07:39:00+10:00,2023-06-05,07:39,1,2,3
58,2023-06-05T07:39:00+10:00,2023-06-05,07:39,0,2,2
72,2023-06-05T07:39:00+10:00,2023-06-05,07:39,13,0,13
79,2023-06-05T07:39:00+10:00,2023-06-05,07:39,5,4,9
4,2023-06-05T07:38:00+10:00,2023-06-05,07:38,3,3,6
5,2023-06-05T07:38:00+10:00,2023-06-05,07:38,4,13,17
6,2023-06-05T07:38:00+10:00,2023-06-05,07:38,5,4,9
29,2023-06-05T07:38:00+10:00,2023-06-05,07:38,0,1,1
40,2023-06-05T07:38:00+10:00,2023-06-05,07:38,3,0,3
45,2023-06-05T07:38:00+10:00,2023-06-05,07:38,1,3,4
55,2023-06-05T07:38:00+10:00,2023-06-05,07:38,4,13,17
66,2023-06-05T07:38:00+10:00,2023-06-05,07:38,1,4,5
18,2023-06-05T07:38:00+10:00,2023-06-05,07:38,1,8,9
20,2023-06-05T07:38:00+10:00,2023-06-05,07:38,0,1,1
35,2023-06-05T07:38:00+10:00,2023-06-05,07:38,4,10,14
48,2023-06-05T07:38:00+10:00,2023-06-05,07:38,0,1,1
56,2023-06-05T07:38:00+10:00,2023-06-05,07:38,1,2,3
57,2023-06-05T07:38:00+10:00,2023-06-05,07:38,3,7,10
58,2023-06-05T07:38:00+10:00,2023-06-05,07:38,20,3,23
72,2023-06-05T07:38:00+10:00,2023-06-05,07:38,1,0,1
85,2023-06-05T07:38:00+10:00,2023-06-05,07:38,3,0,3
14,2023-06-05T07:38:00+10:00,2023-06-05,07:38,3,3,6
26,2023-06-05T07:38:00+10:00,2023-06-05,07:38,1,2,3
28,2023-06-05T07:38:00+10:00,2023-06-05,07:38,4,3,7
36,2023-06-05T07:38:00+10:00,2023-06-05,07:38,4,1,5
37,2023-06-05T07:38:00+10:00,2023-06-05,07:38,0,1,1
41,2023-06-05T07:38:00+10:00,2023-06-05,07:38,14,6,20
54,2023-06-05T07:38:00+10:00,2023-06-05,07:38,0,1,1
65,2023-06-05T07:38:00+10:00,2023-06-05,07:38,2,1,3
69,2023-06-05T07:38:00+10:00,2023-06-05,07:38,1,1,2
75,2023-06-05T07:38:00+10:00,2023-06-05,07:38,2,0,2
77,2023-06-05T07:38:00+10:00,2023-06-05,07:38,1,1,2
2,2023-06-05T07:38:00+10:00,2023-06-05,07:38,1,0,1
12,2023-06-05T07:38:00+10:00,2023-06-05,07:38,1,0,1
23,2023-06-05T07:38:00+10:00,2023-06-05,07:38,8,11,19
24,2023-06-05T07:38:00+10:00,2023-06-05,07:38,24,12,36
62,2023-06-05T07:38:00+10:00,2023-06-05,07:38,0,2,2
63,2023-06-05T07:38:00+10:00,2023-06-05,07:38,2,1,3
67,2023-06-05T07:38:00+10:00,2023-06-05,07:38,0,3,3
68,2023-06-05T07:38:00+10:00,2023-06-05,07:38,0,1,1
76,2023-06-05T07:38:00+10:00,2023-06-05,07:38,1,0,1
79,2023-06-05T07:38:00+10:00,2023-06-05,07:38,10,4,14
86,2023-06-05T07:38:00+10:00,2023-06-05,07:38,0,1,1
3,2023-06-05T07:38:00+10:00,2023-06-05,07:38,1,1,2
8,2023-06-05T07:38:00+10:00,2023-06-05,07:38,2,1,3
39,2023-06-05T07:38:00+10:00,2023-06-05,07:38,2,1,3
42,2023-06-05T07:38:00+10:00,2023-06-05,07:38,1,0,1
44,2023-06-05T07:38:00+10:00,2023-06-05,07:38,0,1,1
47,2023-06-05T07:38:00+10:00,2023-06-05,07:38,1,8,9
61,2023-06-05T07:38:00+10:00,2023-06-05,07:38,1,6,7
70,2023-06-05T07:38:00+10:00,2023-06-05,07:38,1,1,2
87,2023-06-05T07:38:00+10:00,2023-06-05,07:38,3,2,5
108,2023-06-05T07:38:00+10:00,2023-06-05,07:38,1,20,21
1,2023-06-05T07:38:00+10:00,2023-06-05,07:38,0,2,2
9,2023-06-05T07:38:00+10:00,2023-06-05,07:38,1,11,12
10,2023-06-05T07:38:00+10:00,2023-06-05,07:38,0,4,4
17,2023-06-05T07:38:00+10:00,2023-06-05,07:38,11,1,12
30,2023-06-05T07:38:00+10:00,2023-06-05,07:38,1,1,2
49,2023-06-05T07:38:00+10:00,2023-06-05,07:38,2,1,3
52,2023-06-05T07:38:00+10:00,2023-06-05,07:38,0,1,1
53,2023-06-05T07:38:00+10:00,2023-06-05,07:38,0,3,3
3,2023-06-05T07:37:00+10:00,2023-06-05,07:37,7,7,14
6,2023-06-05T07:37:00+10:00,2023-06-05,07:37,5,13,18
8,2023-06-05T07:37:00+10:00,2023-06-05,07:37,4,3,7
31,2023-06-05T07:37:00+10:00,2023-06-05,07:37,0,1,1
40,2023-06-05T07:37:00+10:00,2023-06-05,07:37,5,1,6
41,2023-06-05T07:37:00+10:00,2023-06-05,07:37,18,7,25
42,2023-06-05T07:37:00+10:00,2023-06-05,07:37,1,0,1
44,2023-06-05T07:37:00+10:00,2023-06-05,07:37,1,0,1
47,2023-06-05T07:37:00+10:00,2023-06-05,07:37,2,7,9
65,2023-06-05T07:37:00+10:00,2023-06-05,07:37,3,4,7
87,2023-06-05T07:37:00+10:00,2023-06-05,07:37,1,1,2
108,2023-06-05T07:37:00+10:00,2023-06-05,07:37,0,7,7
1,2023-06-05T07:37:00+10:00,2023-06-05,07:37,1,0,1
2,2023-06-05T07:37:00+10:00,2023-06-05,07:37,0,1,1
11,2023-06-05T07:37:00+10:00,2023-06-05,07:37,1,2,3
58,2023-06-05T07:37:00+10:00,2023-06-05,07:37,20,1,21
72,2023-06-05T07:37:00+10:00,2023-06-05,07:37,1,1,2
76,2023-06-05T07:37:00+10:00,2023-06-05,07:37,2,0,2
79,2023-06-05T07:37:00+10:00,2023-06-05,07:37,4,2,6
85,2023-06-05T07:37:00+10:00,2023-06-05,07:37,3,1,4
4,2023-06-05T07:37:00+10:00,2023-06-05,07:37,9,1,10
21,2023-06-05T07:37:00+10:00,2023-06-05,07:37,2,1,3
29,2023-06-05T07:37:00+10:00,2023-06-05,07:37,2,0,2
36,2023-06-05T07:37:00+10:00,2023-06-05,07:37,1,0,1
39,2023-06-05T07:37:00+10:00,2023-06-05,07:37,2,0,2
45,2023-06-05T07:37:00+10:00,2023-06-05,07:37,3,4,7
50,2023-06-05T07:37:00+10:00,2023-06-05,07:37,2,0,2
54,2023-06-05T07:37:00+10:00,2023-06-05,07:37,0,1,1
55,2023-06-05T07:37:00+10:00,2023-06-05,07:37,10,7,17
69,2023-06-05T07:37:00+10:00,2023-06-05,07:37,2,0,2
75,2023-06-05T07:37:00+10:00,2023-06-05,07:37,0,1,1
10,2023-06-05T07:37:00+10:00,2023-06-05,07:37,7,4,11
18,2023-06-05T07:37:00+10:00,2023-06-05,07:37,0,2,2
19,2023-06-05T07:37:00+10:00,2023-06-05,07:37,1,2,3
24,2023-06-05T07:37:00+10:00,2023-06-05,07:37,12,1,13
53,2023-06-05T07:37:00+10:00,2023-06-05,07:37,2,1,3
56,2023-06-05T07:37:00+10:00,2023-06-05,07:37,0,1,1
57,2023-06-05T07:37:00+10:00,2023-06-05,07:37,3,3,6
63,2023-06-05T07:37:00+10:00,2023-06-05,07:37,4,2,6
86,2023-06-05T07:37:00+10:00,2023-06-05,07:37,0,1,1
5,2023-06-05T07:37:00+10:00,2023-06-05,07:37,3,5,8
14,2023-06-05T07:37:00+10:00,2023-06-05,07:37,2,2,4
26,2023-06-05T07:37:00+10:00,2023-06-05,07:37,0,1,1
28,2023-06-05T07:37:00+10:00,2023-06-05,07:37,8,4,12
61,2023-06-05T07:37:00+10:00,2023-06-05,07:37,3,3,6
66,2023-06-05T07:37:00+10:00,2023-06-05,07:37,2,2,4
77,2023-06-05T07:37:00+10:00,2023-06-05,07:37,0,1,1
9,2023-06-05T07:37:00+10:00,2023-06-05,07:37,0,22,22
17,2023-06-05T07:37:00+10:00,2023-06-05,07:37,11,1,12
20,2023-06-05T07:37:00+10:00,2023-06-05,07:37,1,0,1
23,2023-06-05T07:37:00+10:00,2023-06-05,07:37,3,3,6
27,2023-06-05T07:37:00+10:00,2023-06-05,07:37,1,0,1
35,2023-06-05T07:37:00+10:00,2023-06-05,07:37,3,6,9
52,2023-06-05T07:37:00+10:00,2023-06-05,07:37,4,3,7
62,2023-06-05T07:37:00+10:00,2023-06-05,07:37,0,3,3
68,2023-06-05T07:37:00+10:00,2023-06-05,07:37,1,0,1
5,2023-06-05T07:36:00+10:00,2023-06-05,07:36,1,5,6
28,2023-06-05T07:36:00+10:00,2023-06-05,07:36,3,7,10
54,2023-06-05T07:36:00+10:00,2023-06-05,07:36,0,2,2
70,2023-06-05T07:36:00+10:00,2023-06-05,07:36,1,0,1
87,2023-06-05T07:36:00+10:00,2023-06-05,07:36,0,1,1
11,2023-06-05T07:36:00+10:00,2023-06-05,07:36,2,1,3
12,2023-06-05T07:36:00+10:00,2023-06-05,07:36,1,0,1
20,2023-06-05T07:36:00+10:00,2023-06-05,07:36,0,1,1
35,2023-06-05T07:36:00+10:00,2023-06-05,07:36,4,3,7
63,2023-06-05T07:36:00+10:00,2023-06-05,07:36,2,0,2
68,2023-06-05T07:36:00+10:00,2023-06-05,07:36,1,2,3
79,2023-06-05T07:36:00+10:00,2023-06-05,07:36,2,3,5
85,2023-06-05T07:36:00+10:00,2023-06-05,07:36,2,0,2
6,2023-06-05T07:36:00+10:00,2023-06-05,07:36,0,5,5
29,2023-06-05T07:36:00+10:00,2023-06-05,07:36,1,0,1
37,2023-06-05T07:36:00+10:00,2023-06-05,07:36,1,0,1
39,2023-06-05T07:36:00+10:00,2023-06-05,07:36,0,1,1
40,2023-06-05T07:36:00+10:00,2023-06-05,07:36,1,2,3
41,2023-06-05T07:36:00+10:00,2023-06-05,07:36,7,1,8
42,2023-06-05T07:36:00+10:00,2023-06-05,07:36,0,2,2
55,2023-06-05T07:36:00+10:00,2023-06-05,07:36,2,2,4
69,2023-06-05T07:36:00+10:00,2023-06-05,07:36,1,1,2
75,2023-06-05T07:36:00+10:00,2023-06-05,07:36,1,1,2
78,2023-06-05T07:36:00+10:00,2023-06-05,07:36,0,1,1
108,2023-06-05T07:36:00+10:00,2023-06-05,07:36,2,15,17
17,2023-06-05T07:36:00+10:00,2023-06-05,07:36,6,2,8
18,2023-06-05T07:36:00+10:00,2023-06-05,07:36,0,13,13
24,2023-06-05T07:36:00+10:00,2023-06-05,07:36,10,3,13
46,2023-06-05T07:36:00+10:00,2023-06-05,07:36,1,1,2
48,2023-06-05T07:36:00+10:00,2023-06-05,07:36,1,1,2
53,2023-06-05T07:36:00+10:00,2023-06-05,07:36,1,3,4
57,2023-06-05T07:36:00+10:00,2023-06-05,07:36,0,4,4
76,2023-06-05T07:36:00+10:00,2023-06-05,07:36,1,1,2
3,2023-06-05T07:36:00+10:00,2023-06-05,07:36,4,7,11
4,2023-06-05T07:36:00+10:00,2023-06-05,07:36,5,2,7
8,2023-06-05T07:36:00+10:00,2023-06-05,07:36,4,5,9
14,2023-06-05T07:36:00+10:00,2023-06-05,07:36,4,1,5
44,2023-06-05T07:36:00+10:00,2023-06-05,07:36,0,2,2
45,2023-06-05T07:36:00+10:00,2023-06-05,07:36,4,0,4
47,2023-06-05T07:36:00+10:00,2023-06-05,07:36,0,4,4
61,2023-06-05T07:36:00+10:00,2023-06-05,07:36,2,2,4
65,2023-06-05T07:36:00+10:00,2023-06-05,07:36,8,1,9
66,2023-06-05T07:36:00+10:00,2023-06-05,07:36,1,2,3
77,2023-06-05T07:36:00+10:00,2023-06-05,07:36,1,2,3
1,2023-06-05T07:36:00+10:00,2023-06-05,07:36,1,0,1
2,2023-06-05T07:36:00+10:00,2023-06-05,07:36,0,2,2
9,2023-06-05T07:36:00+10:00,2023-06-05,07:36,0,16,16
10,2023-06-05T07:36:00+10:00,2023-06-05,07:36,0,5,5
23,2023-06-05T07:36:00+10:00,2023-06-05,07:36,3,0,3
51,2023-06-05T07:36:00+10:00,2023-06-05,07:36,2,1,3
52,2023-06-05T07:36:00+10:00,2023-06-05,07:36,0,1,1
58,2023-06-05T07:36:00+10:00,2023-06-05,07:36,3,0,3
67,2023-06-05T07:36:00+10:00,2023-06-05,07:36,2,5,7
72,2023-06-05T07:36:00+10:00,2023-06-05,07:36,3,0,3
3,2023-06-05T07:35:00+10:00,2023-06-05,07:35,2,4,6
4,2023-06-05T07:35:00+10:00,2023-06-05,07:35,8,4,12
8,2023-06-05T07:35:00+10:00,2023-06-05,07:35,5,0,5
14,2023-06-05T07:35:00+10:00,2023-06-05,07:35,6,1,7
41,2023-06-05T07:35:00+10:00,2023-06-05,07:35,13,10,23
42,2023-06-05T07:35:00+10:00,2023-06-05,07:35,0,1,1
55,2023-06-05T07:35:00+10:00,2023-06-05,07:35,2,7,9
61,2023-06-05T07:35:00+10:00,2023-06-05,07:35,0,5,5
65,2023-06-05T07:35:00+10:00,2023-06-05,07:35,2,0,2
70,2023-06-05T07:35:00+10:00,2023-06-05,07:35,1,0,1
75,2023-06-05T07:35:00+10:00,2023-06-05,07:35,0,1,1
77,2023-06-05T07:35:00+10:00,2023-06-05,07:35,0,3,3
84,2023-06-05T07:35:00+10:00,2023-06-05,07:35,38,16,54
87,2023-06-05T07:35:00+10:00,2023-06-05,07:35,0,1,1
118,2023-06-05T07:35:00+10:00,2023-06-05,07:35,1,1,2
11,2023-06-05T07:35:00+10:00,2023-06-05,07:35,3,0,3
53,2023-06-05T07:35:00+10:00,2023-06-05,07:35,0,1,1
56,2023-06-05T07:35:00+10:00,2023-06-05,07:35,2,0,2
58,2023-06-05T07:35:00+10:00,2023-06-05,07:35,19,1,20
79,2023-06-05T07:35:00+10:00,2023-06-05,07:35,6,2,8
5,2023-06-05T07:35:00+10:00,2023-06-05,07:35,2,3,5
6,2023-06-05T07:35:00+10:00,2023-06-05,07:35,7,4,11
28,2023-06-05T07:35:00+10:00,2023-06-05,07:35,6,6,12
36,2023-06-05T07:35:00+10:00,2023-06-05,07:35,1,0,1
37,2023-06-05T07:35:00+10:00,2023-06-05,07:35,1,0,1
45,2023-06-05T07:35:00+10:00,2023-06-05,07:35,4,3,7
47,2023-06-05T07:35:00+10:00,2023-06-05,07:35,0,6,6
54,2023-06-05T07:35:00+10:00,2023-06-05,07:35,2,0,2
59,2023-06-05T07:35:00+10:00,2023-06-05,07:35,10,13,23
66,2023-06-05T07:35:00+10:00,2023-06-05,07:35,3,3,6
78,2023-06-05T07:35:00+10:00,2023-06-05,07:35,2,0,2
107,2023-06-05T07:35:00+10:00,2023-06-05,07:35,3,6,9
2,2023-06-05T07:35:00+10:00,2023-06-05,07:35,1,0,1
9,2023-06-05T07:35:00+10:00,2023-06-05,07:35,0,13,13
23,2023-06-05T07:35:00+10:00,2023-06-05,07:35,3,1,4
24,2023-06-05T07:35:00+10:00,2023-06-05,07:35,21,4,25
30,2023-06-05T07:35:00+10:00,2023-06-05,07:35,0,2,2
35,2023-06-05T07:35:00+10:00,2023-06-05,07:35,3,6,9
48,2023-06-05T07:35:00+10:00,2023-06-05,07:35,1,1,2
51,2023-06-05T07:35:00+10:00,2023-06-05,07:35,2,0,2
52,2023-06-05T07:35:00+10:00,2023-06-05,07:35,1,1,2
57,2023-06-05T07:35:00+10:00,2023-06-05,07:35,2,6,8
85,2023-06-05T07:35:00+10:00,2023-06-05,07:35,1,0,1
26,2023-06-05T07:35:00+10:00,2023-06-05,07:35,2,0,2
29,2023-06-05T07:35:00+10:00,2023-06-05,07:35,2,2,4
39,2023-06-05T07:35:00+10:00,2023-06-05,07:35,2,0,2
40,2023-06-05T07:35:00+10:00,2023-06-05,07:35,1,3,4
44,2023-06-05T07:35:00+10:00,2023-06-05,07:35,1,0,1
69,2023-06-05T07:35:00+10:00,2023-06-05,07:35,4,1,5
108,2023-06-05T07:35:00+10:00,2023-06-05,07:35,1,13,14
1,2023-06-05T07:35:00+10:00,2023-06-05,07:35,2,0,2
12,2023-06-05T07:35:00+10:00,2023-06-05,07:35,3,7,10
17,2023-06-05T07:35:00+10:00,2023-06-05,07:35,6,3,9
18,2023-06-05T07:35:00+10:00,2023-06-05,07:35,2,13,15
19,2023-06-05T07:35:00+10:00,2023-06-05,07:35,0,2,2
20,2023-06-05T07:35:00+10:00,2023-06-05,07:35,1,0,1
46,2023-06-05T07:35:00+10:00,2023-06-05,07:35,1,1,2
49,2023-06-05T07:35:00+10:00,2023-06-05,07:35,0,2,2
62,2023-06-05T07:35:00+10:00,2023-06-05,07:35,2,0,2
67,2023-06-05T07:35:00+10:00,2023-06-05,07:35,1,4,5
72,2023-06-05T07:35:00+10:00,2023-06-05,07:35,2,2,4
109,2023-06-05T07:35:00+10:00,2023-06-05,07:35,4,39,43
117,2023-06-05T07:35:00+10:00,2023-06-05,07:35,7,6,13
6,2023-06-05T07:34:00+10:00,2023-06-05,07:34,3,2,5
26,2023-06-05T07:34:00+10:00,2023-06-05,07:34,2,2,4
40,2023-06-05T07:34:00+10:00,2023-06-05,07:34,2,0,2
41,2023-06-05T07:34:00+10:00,2023-06-05,07:34,20,4,24
42,2023-06-05T07:34:00+10:00,2023-06-05,07:34,1,1,2
55,2023-06-05T07:34:00+10:00,2023-06-05,07:34,7,2,9
65,2023-06-05T07:34:00+10:00,2023-06-05,07:34,2,2,4
69,2023-06-05T07:34:00+10:00,2023-06-05,07:34,1,0,1
77,2023-06-05T07:34:00+10:00,2023-06-05,07:34,0,1,1
108,2023-06-05T07:34:00+10:00,2023-06-05,07:34,0,6,6
1,2023-06-05T07:34:00+10:00,2023-06-05,07:34,2,1,3
2,2023-06-05T07:34:00+10:00,2023-06-05,07:34,3,1,4
18,2023-06-05T07:34:00+10:00,2023-06-05,07:34,0,8,8
19,2023-06-05T07:34:00+10:00,2023-06-05,07:34,0,1,1
30,2023-06-05T07:34:00+10:00,2023-06-05,07:34,0,2,2
48,2023-06-05T07:34:00+10:00,2023-06-05,07:34,1,1,2
79,2023-06-05T07:34:00+10:00,2023-06-05,07:34,1,0,1
86,2023-06-05T07:34:00+10:00,2023-06-05,07:34,1,0,1
4,2023-06-05T07:34:00+10:00,2023-06-05,07:34,8,2,10
14,2023-06-05T07:34:00+10:00,2023-06-05,07:34,4,1,5
45,2023-06-05T07:34:00+10:00,2023-06-05,07:34,2,0,2
54,2023-06-05T07:34:00+10:00,2023-06-05,07:34,0,2,2
61,2023-06-05T07:34:00+10:00,2023-06-05,07:34,1,1,2
66,2023-06-05T07:34:00+10:00,2023-06-05,07:34,1,6,7
12,2023-06-05T07:34:00+10:00,2023-06-05,07:34,1,3,4
17,2023-06-05T07:34:00+10:00,2023-06-05,07:34,13,0,13
23,2023-06-05T07:34:00+10:00,2023-06-05,07:34,1,0,1
24,2023-06-05T07:34:00+10:00,2023-06-05,07:34,5,0,5
51,2023-06-05T07:34:00+10:00,2023-06-05,07:34,0,1,1
52,2023-06-05T07:34:00+10:00,2023-06-05,07:34,3,3,6
53,2023-06-05T07:34:00+10:00,2023-06-05,07:34,3,3,6
58,2023-06-05T07:34:00+10:00,2023-06-05,07:34,0,1,1
68,2023-06-05T07:34:00+10:00,2023-06-05,07:34,2,0,2
72,2023-06-05T07:34:00+10:00,2023-06-05,07:34,2,0,2
85,2023-06-05T07:34:00+10:00,2023-06-05,07:34,1,1,2
3,2023-06-05T07:34:00+10:00,2023-06-05,07:34,0,3,3
5,2023-06-05T07:34:00+10:00,2023-06-05,07:34,4,7,11
8,2023-06-05T07:34:00+10:00,2023-06-05,07:34,0,2,2
28,2023-06-05T07:34:00+10:00,2023-06-05,07:34,8,6,14
29,2023-06-05T07:34:00+10:00,2023-06-05,07:34,0,1,1
47,2023-06-05T07:34:00+10:00,2023-06-05,07:34,1,4,5
78,2023-06-05T07:34:00+10:00,2023-06-05,07:34,1,0,1
9,2023-06-05T07:34:00+10:00,2023-06-05,07:34,0,14,14
10,2023-06-05T07:34:00+10:00,2023-06-05,07:34,1,2,3
11,2023-06-05T07:34:00+10:00,2023-06-05,07:34,1,0,1
35,2023-06-05T07:34:00+10:00,2023-06-05,07:34,3,5,8
57,2023-06-05T07:34:00+10:00,2023-06-05,07:34,8,4,12
62,2023-06-05T07:34:00+10:00,2023-06-05,07:34,4,1,5
63,2023-06-05T07:34:00+10:00,2023-06-05,07:34,1,2,3
67,2023-06-05T07:34:00+10:00,2023-06-05,07:34,9,3,12
76,2023-06-05T07:34:00+10:00,2023-06-05,07:34,1,1,2
3,2023-06-05T07:33:00+10:00,2023-06-05,07:33,3,2,5
5,2023-06-05T07:33:00+10:00,2023-06-05,07:33,3,3,6
21,2023-06-05T07:33:00+10:00,2023-06-05,07:33,2,0,2
29,2023-06-05T07:33:00+10:00,2023-06-05,07:33,0,5,5
47,2023-06-05T07:33:00+10:00,2023-06-05,07:33,1,4,5
50,2023-06-05T07:33:00+10:00,2023-06-05,07:33,1,0,1
66,2023-06-05T07:33:00+10:00,2023-06-05,07:33,1,2,3
78,2023-06-05T07:33:00+10:00,2023-06-05,07:33,0,1,1
87,2023-06-05T07:33:00+10:00,2023-06-05,07:33,1,1,2
2,2023-06-05T07:33:00+10:00,2023-06-05,07:33,2,2,4
12,2023-06-05T07:33:00+10:00,2023-06-05,07:33,3,1,4
24,2023-06-05T07:33:00+10:00,2023-06-05,07:33,21,1,22
27,2023-06-05T07:33:00+10:00,2023-06-05,07:33,1,1,2
48,2023-06-05T07:33:00+10:00,2023-06-05,07:33,4,0,4
49,2023-06-05T07:33:00+10:00,2023-06-05,07:33,2,0,2
51,2023-06-05T07:33:00+10:00,2023-06-05,07:33,1,0,1
52,2023-06-05T07:33:00+10:00,2023-06-05,07:33,1,3,4
56,2023-06-05T07:33:00+10:00,2023-06-05,07:33,0,1,1
57,2023-06-05T07:33:00+10:00,2023-06-05,07:33,5,9,14
62,2023-06-05T07:33:00+10:00,2023-06-05,07:33,0,1,1
67,2023-06-05T07:33:00+10:00,2023-06-05,07:33,3,0,3
85,2023-06-05T07:33:00+10:00,2023-06-05,07:33,2,0,2
6,2023-06-05T07:33:00+10:00,2023-06-05,07:33,6,5,11
8,2023-06-05T07:33:00+10:00,2023-06-05,07:33,2,1,3
26,2023-06-05T07:33:00+10:00,2023-06-05,07:33,1,1,2
39,2023-06-05T07:33:00+10:00,2023-06-05,07:33,2,1,3
41,2023-06-05T07:33:00+10:00,2023-06-05,07:33,10,3,13
45,2023-06-05T07:33:00+10:00,2023-06-05,07:33,3,1,4
54,2023-06-05T07:33:00+10:00,2023-06-05,07:33,2,3,5
61,2023-06-05T07:33:00+10:00,2023-06-05,07:33,1,3,4
65,2023-06-05T07:33:00+10:00,2023-06-05,07:33,11,0,11
108,2023-06-05T07:33:00+10:00,2023-06-05,07:33,2,9,11
1,2023-06-05T07:33:00+10:00,2023-06-05,07:33,2,3,5
18,2023-06-05T07:33:00+10:00,2023-06-05,07:33,0,4,4
23,2023-06-05T07:33:00+10:00,2023-06-05,07:33,6,2,8
68,2023-06-05T07:33:00+10:00,2023-06-05,07:33,3,0,3
72,2023-06-05T07:33:00+10:00,2023-06-05,07:33,4,4,8
4,2023-06-05T07:33:00+10:00,2023-06-05,07:33,7,2,9
14,2023-06-05T07:33:00+10:00,2023-06-05,07:33,0,3,3
28,2023-06-05T07:33:00+10:00,2023-06-05,07:33,12,5,17
36,2023-06-05T07:33:00+10:00,2023-06-05,07:33,3,1,4
42,2023-06-05T07:33:00+10:00,2023-06-05,07:33,2,0,2
55,2023-06-05T07:33:00+10:00,2023-06-05,07:33,3,8,11
77,2023-06-05T07:33:00+10:00,2023-06-05,07:33,7,2,9
9,2023-06-05T07:33:00+10:00,2023-06-05,07:33,0,10,10
10,2023-06-05T07:33:00+10:00,2023-06-05,07:33,0,5,5
17,2023-06-05T07:33:00+10:00,2023-06-05,07:33,3,1,4
30,2023-06-05T07:33:00+10:00,2023-06-05,07:33,1,0,1
35,2023-06-05T07:33:00+10:00,2023-06-05,07:33,6,7,13
46,2023-06-05T07:33:00+10:00,2023-06-05,07:33,1,0,1
53,2023-06-05T07:33:00+10:00,2023-06-05,07:33,2,0,2
58,2023-06-05T07:33:00+10:00,2023-06-05,07:33,4,1,5
76,2023-06-05T07:33:00+10:00,2023-06-05,07:33,1,0,1
79,2023-06-05T07:33:00+10:00,2023-06-05,07:33,2,2,4
5,2023-06-05T07:32:00+10:00,2023-06-05,07:32,2,8,10
14,2023-06-05T07:32:00+10:00,2023-06-05,07:32,2,1,3
39,2023-06-05T07:32:00+10:00,2023-06-05,07:32,0,2,2
42,2023-06-05T07:32:00+10:00,2023-06-05,07:32,0,1,1
47,2023-06-05T07:32:00+10:00,2023-06-05,07:32,2,8,10
66,2023-06-05T07:32:00+10:00,2023-06-05,07:32,1,1,2
108,2023-06-05T07:32:00+10:00,2023-06-05,07:32,1,7,8
2,2023-06-05T07:32:00+10:00,2023-06-05,07:32,1,2,3
10,2023-06-05T07:32:00+10:00,2023-06-05,07:32,0,3,3
17,2023-06-05T07:32:00+10:00,2023-06-05,07:32,3,1,4
24,2023-06-05T07:32:00+10:00,2023-06-05,07:32,4,1,5
48,2023-06-05T07:32:00+10:00,2023-06-05,07:32,1,1,2
72,2023-06-05T07:32:00+10:00,2023-06-05,07:32,2,0,2
85,2023-06-05T07:32:00+10:00,2023-06-05,07:32,0,1,1
8,2023-06-05T07:32:00+10:00,2023-06-05,07:32,0,2,2
21,2023-06-05T07:32:00+10:00,2023-06-05,07:32,0,1,1
29,2023-06-05T07:32:00+10:00,2023-06-05,07:32,2,1,3
40,2023-06-05T07:32:00+10:00,2023-06-05,07:32,3,1,4
45,2023-06-05T07:32:00+10:00,2023-06-05,07:32,1,1,2
54,2023-06-05T07:32:00+10:00,2023-06-05,07:32,1,0,1
55,2023-06-05T07:32:00+10:00,2023-06-05,07:32,3,5,8
65,2023-06-05T07:32:00+10:00,2023-06-05,07:32,4,0,4
70,2023-06-05T07:32:00+10:00,2023-06-05,07:32,0,1,1
78,2023-06-05T07:32:00+10:00,2023-06-05,07:32,0,1,1
9,2023-06-05T07:32:00+10:00,2023-06-05,07:32,3,9,12
12,2023-06-05T07:32:00+10:00,2023-06-05,07:32,0,1,1
18,2023-06-05T07:32:00+10:00,2023-06-05,07:32,1,3,4
19,2023-06-05T07:32:00+10:00,2023-06-05,07:32,2,0,2
23,2023-06-05T07:32:00+10:00,2023-06-05,07:32,0,2,2
53,2023-06-05T07:32:00+10:00,2023-06-05,07:32,4,4,8
57,2023-06-05T07:32:00+10:00,2023-06-05,07:32,4,3,7
58,2023-06-05T07:32:00+10:00,2023-06-05,07:32,3,4,7
62,2023-06-05T07:32:00+10:00,2023-06-05,07:32,0,1,1
67,2023-06-05T07:32:00+10:00,2023-06-05,07:32,4,5,9
76,2023-06-05T07:32:00+10:00,2023-06-05,07:32,1,0,1
3,2023-06-05T07:32:00+10:00,2023-06-05,07:32,2,3,5
4,2023-06-05T07:32:00+10:00,2023-06-05,07:32,2,4,6
6,2023-06-05T07:32:00+10:00,2023-06-05,07:32,3,3,6
26,2023-06-05T07:32:00+10:00,2023-06-05,07:32,1,2,3
28,2023-06-05T07:32:00+10:00,2023-06-05,07:32,6,4,10
41,2023-06-05T07:32:00+10:00,2023-06-05,07:32,32,6,38
69,2023-06-05T07:32:00+10:00,2023-06-05,07:32,1,0,1
75,2023-06-05T07:32:00+10:00,2023-06-05,07:32,3,0,3
77,2023-06-05T07:32:00+10:00,2023-06-05,07:32,0,1,1
87,2023-06-05T07:32:00+10:00,2023-06-05,07:32,0,1,1
1,2023-06-05T07:32:00+10:00,2023-06-05,07:32,0,1,1
11,2023-06-05T07:32:00+10:00,2023-06-05,07:32,1,0,1
20,2023-06-05T07:32:00+10:00,2023-06-05,07:32,1,0,1
30,2023-06-05T07:32:00+10:00,2023-06-05,07:32,1,1,2
35,2023-06-05T07:32:00+10:00,2023-06-05,07:32,4,12,16
46,2023-06-05T07:32:00+10:00,2023-06-05,07:32,0,1,1
51,2023-06-05T07:32:00+10:00,2023-06-05,07:32,0,4,4
52,2023-06-05T07:32:00+10:00,2023-06-05,07:32,1,2,3
56,2023-06-05T07:32:00+10:00,2023-06-05,07:32,0,1,1
63,2023-06-05T07:32:00+10:00,2023-06-05,07:32,1,1,2
79,2023-06-05T07:32:00+10:00,2023-06-05,07:32,4,0,4
4,2023-06-05T07:31:00+10:00,2023-06-05,07:31,6,3,9
6,2023-06-05T07:31:00+10:00,2023-06-05,07:31,6,5,11
8,2023-06-05T07:31:00+10:00,2023-06-05,07:31,2,1,3
14,2023-06-05T07:31:00+10:00,2023-06-05,07:31,0,3,3
36,2023-06-05T07:31:00+10:00,2023-06-05,07:31,0,3,3
44,2023-06-05T07:31:00+10:00,2023-06-05,07:31,0,1,1
47,2023-06-05T07:31:00+10:00,2023-06-05,07:31,2,4,6
61,2023-06-05T07:31:00+10:00,2023-06-05,07:31,1,1,2
69,2023-06-05T07:31:00+10:00,2023-06-05,07:31,1,0,1
70,2023-06-05T07:31:00+10:00,2023-06-05,07:31,0,1,1
10,2023-06-05T07:31:00+10:00,2023-06-05,07:31,0,3,3
18,2023-06-05T07:31:00+10:00,2023-06-05,07:31,1,2,3
24,2023-06-05T07:31:00+10:00,2023-06-05,07:31,8,4,12
56,2023-06-05T07:31:00+10:00,2023-06-05,07:31,1,1,2
58,2023-06-05T07:31:00+10:00,2023-06-05,07:31,5,2,7
67,2023-06-05T07:31:00+10:00,2023-06-05,07:31,2,3,5
5,2023-06-05T07:31:00+10:00,2023-06-05,07:31,1,11,12
29,2023-06-05T07:31:00+10:00,2023-06-05,07:31,2,0,2
31,2023-06-05T07:31:00+10:00,2023-06-05,07:31,1,0,1
39,2023-06-05T07:31:00+10:00,2023-06-05,07:31,1,0,1
42,2023-06-05T07:31:00+10:00,2023-06-05,07:31,0,1,1
45,2023-06-05T07:31:00+10:00,2023-06-05,07:31,3,2,5
55,2023-06-05T07:31:00+10:00,2023-06-05,07:31,4,2,6
65,2023-06-05T07:31:00+10:00,2023-06-05,07:31,1,3,4
66,2023-06-05T07:31:00+10:00,2023-06-05,07:31,0,1,1
77,2023-06-05T07:31:00+10:00,2023-06-05,07:31,3,1,4
108,2023-06-05T07:31:00+10:00,2023-06-05,07:31,0,16,16
9,2023-06-05T07:31:00+10:00,2023-06-05,07:31,0,8,8
23,2023-06-05T07:31:00+10:00,2023-06-05,07:31,2,0,2
27,2023-06-05T07:31:00+10:00,2023-06-05,07:31,0,2,2
30,2023-06-05T07:31:00+10:00,2023-06-05,07:31,0,1,1
48,2023-06-05T07:31:00+10:00,2023-06-05,07:31,3,2,5
52,2023-06-05T07:31:00+10:00,2023-06-05,07:31,1,1,2
72,2023-06-05T07:31:00+10:00,2023-06-05,07:31,4,2,6
85,2023-06-05T07:31:00+10:00,2023-06-05,07:31,2,1,3
86,2023-06-05T07:31:00+10:00,2023-06-05,07:31,0,1,1
3,2023-06-05T07:31:00+10:00,2023-06-05,07:31,0,1,1
21,2023-06-05T07:31:00+10:00,2023-06-05,07:31,2,0,2
26,2023-06-05T07:31:00+10:00,2023-06-05,07:31,3,0,3
28,2023-06-05T07:31:00+10:00,2023-06-05,07:31,2,3,5
40,2023-06-05T07:31:00+10:00,2023-06-05,07:31,1,0,1
41,2023-06-05T07:31:00+10:00,2023-06-05,07:31,12,9,21
87,2023-06-05T07:31:00+10:00,2023-06-05,07:31,0,1,1
1,2023-06-05T07:31:00+10:00,2023-06-05,07:31,1,1,2
17,2023-06-05T07:31:00+10:00,2023-06-05,07:31,5,1,6
19,2023-06-05T07:31:00+10:00,2023-06-05,07:31,0,1,1
35,2023-06-05T07:31:00+10:00,2023-06-05,07:31,5,5,10
46,2023-06-05T07:31:00+10:00,2023-06-05,07:31,1,1,2
51,2023-06-05T07:31:00+10:00,2023-06-05,07:31,1,1,2
53,2023-06-05T07:31:00+10:00,2023-06-05,07:31,1,1,2
57,2023-06-05T07:31:00+10:00,2023-06-05,07:31,2,3,5
63,2023-06-05T07:31:00+10:00,2023-06-05,07:31,1,0,1
76,2023-06-05T07:31:00+10:00,2023-06-05,07:31,0,1,1
79,2023-06-05T07:31:00+10:00,2023-06-05,07:31,0,1,1
3,2023-06-05T07:30:00+10:00,2023-06-05,07:30,3,1,4
14,2023-06-05T07:30:00+10:00,2023-06-05,07:30,3,2,5
26,2023-06-05T07:30:00+10:00,2023-06-05,07:30,1,1,2
28,2023-06-05T07:30:00+10:00,2023-06-05,07:30,6,3,9
37,2023-06-05T07:30:00+10:00,2023-06-05,07:30,2,0,2
40,2023-06-05T07:30:00+10:00,2023-06-05,07:30,2,2,4
45,2023-06-05T07:30:00+10:00,2023-06-05,07:30,0,1,1
77,2023-06-05T07:30:00+10:00,2023-06-05,07:30,1,0,1
87,2023-06-05T07:30:00+10:00,2023-06-05,07:30,1,3,4
10,2023-06-05T07:30:00+10:00,2023-06-05,07:30,0,4,4
35,2023-06-05T07:30:00+10:00,2023-06-05,07:30,6,4,10
109,2023-06-05T07:30:00+10:00,2023-06-05,07:30,14,26,40
117,2023-06-05T07:30:00+10:00,2023-06-05,07:30,7,3,10
5,2023-06-05T07:30:00+10:00,2023-06-05,07:30,3,7,10
6,2023-06-05T07:30:00+10:00,2023-06-05,07:30,5,12,17
29,2023-06-05T07:30:00+10:00,2023-06-05,07:30,3,3,6
41,2023-06-05T07:30:00+10:00,2023-06-05,07:30,7,4,11
47,2023-06-05T07:30:00+10:00,2023-06-05,07:30,4,2,6
55,2023-06-05T07:30:00+10:00,2023-06-05,07:30,0,2,2
61,2023-06-05T07:30:00+10:00,2023-06-05,07:30,1,0,1
108,2023-06-05T07:30:00+10:00,2023-06-05,07:30,1,6,7
1,2023-06-05T07:30:00+10:00,2023-06-05,07:30,1,0,1
2,2023-06-05T07:30:00+10:00,2023-06-05,07:30,1,2,3
11,2023-06-05T07:30:00+10:00,2023-06-05,07:30,1,1,2
17,2023-06-05T07:30:00+10:00,2023-06-05,07:30,8,1,9
19,2023-06-05T07:30:00+10:00,2023-06-05,07:30,1,0,1
52,2023-06-05T07:30:00+10:00,2023-06-05,07:30,1,1,2
53,2023-06-05T07:30:00+10:00,2023-06-05,07:30,2,3,5
56,2023-06-05T07:30:00+10:00,2023-06-05,07:30,4,1,5
57,2023-06-05T07:30:00+10:00,2023-06-05,07:30,2,3,5
58,2023-06-05T07:30:00+10:00,2023-06-05,07:30,20,0,20
62,2023-06-05T07:30:00+10:00,2023-06-05,07:30,4,0,4
63,2023-06-05T07:30:00+10:00,2023-06-05,07:30,4,3,7
72,2023-06-05T07:30:00+10:00,2023-06-05,07:30,4,1,5
76,2023-06-05T07:30:00+10:00,2023-06-05,07:30,1,0,1
79,2023-06-05T07:30:00+10:00,2023-06-05,07:30,4,2,6
4,2023-06-05T07:30:00+10:00,2023-06-05,07:30,2,2,4
8,2023-06-05T07:30:00+10:00,2023-06-05,07:30,2,0,2
36,2023-06-05T07:30:00+10:00,2023-06-05,07:30,3,0,3
54,2023-06-05T07:30:00+10:00,2023-06-05,07:30,2,1,3
59,2023-06-05T07:30:00+10:00,2023-06-05,07:30,2,7,9
65,2023-06-05T07:30:00+10:00,2023-06-05,07:30,7,0,7
69,2023-06-05T07:30:00+10:00,2023-06-05,07:30,1,0,1
84,2023-06-05T07:30:00+10:00,2023-06-05,07:30,34,6,40
107,2023-06-05T07:30:00+10:00,2023-06-05,07:30,3,10,13
9,2023-06-05T07:30:00+10:00,2023-06-05,07:30,1,10,11
12,2023-06-05T07:30:00+10:00,2023-06-05,07:30,1,2,3
18,2023-06-05T07:30:00+10:00,2023-06-05,07:30,0,1,1
24,2023-06-05T07:30:00+10:00,2023-06-05,07:30,19,2,21
51,2023-06-05T07:30:00+10:00,2023-06-05,07:30,1,1,2
67,2023-06-05T07:30:00+10:00,2023-06-05,07:30,2,1,3
3,2023-06-05T07:29:00+10:00,2023-06-05,07:29,0,2,2
5,2023-06-05T07:29:00+10:00,2023-06-05,07:29,4,5,9
8,2023-06-05T07:29:00+10:00,2023-06-05,07:29,2,3,5
14,2023-06-05T07:29:00+10:00,2023-06-05,07:29,3,5,8
28,2023-06-05T07:29:00+10:00,2023-06-05,07:29,10,2,12
29,2023-06-05T07:29:00+10:00,2023-06-05,07:29,2,1,3
47,2023-06-05T07:29:00+10:00,2023-06-05,07:29,5,2,7
54,2023-06-05T07:29:00+10:00,2023-06-05,07:29,2,0,2
55,2023-06-05T07:29:00+10:00,2023-06-05,07:29,4,6,10
65,2023-06-05T07:29:00+10:00,2023-06-05,07:29,0,1,1
71,2023-06-05T07:29:00+10:00,2023-06-05,07:29,0,2,2
2,2023-06-05T07:29:00+10:00,2023-06-05,07:29,1,2,3
10,2023-06-05T07:29:00+10:00,2023-06-05,07:29,0,3,3
30,2023-06-05T07:29:00+10:00,2023-06-05,07:29,1,0,1
35,2023-06-05T07:29:00+10:00,2023-06-05,07:29,3,9,12
36,2023-06-05T07:29:00+10:00,2023-06-05,07:29,1,0,1
39,2023-06-05T07:29:00+10:00,2023-06-05,07:29,2,0,2
40,2023-06-05T07:29:00+10:00,2023-06-05,07:29,2,0,2
70,2023-06-05T07:29:00+10:00,2023-06-05,07:29,2,0,2
77,2023-06-05T07:29:00+10:00,2023-06-05,07:29,0,2,2
1,2023-06-05T07:29:00+10:00,2023-06-05,07:29,0,1,1
9,2023-06-05T07:29:00+10:00,2023-06-05,07:29,1,6,7
18,2023-06-05T07:29:00+10:00,2023-06-05,07:29,0,5,5
19,2023-06-05T07:29:00+10:00,2023-06-05,07:29,0,1,1
23,2023-06-05T07:29:00+10:00,2023-06-05,07:29,7,7,14
27,2023-06-05T07:29:00+10:00,2023-06-05,07:29,1,0,1
53,2023-06-05T07:29:00+10:00,2023-06-05,07:29,1,4,5
57,2023-06-05T07:29:00+10:00,2023-06-05,07:29,4,4,8
68,2023-06-05T07:29:00+10:00,2023-06-05,07:29,0,1,1
85,2023-06-05T07:29:00+10:00,2023-06-05,07:29,2,1,3
6,2023-06-05T07:29:00+10:00,2023-06-05,07:29,3,5,8
21,2023-06-05T07:29:00+10:00,2023-06-05,07:29,0,2,2
26,2023-06-05T07:29:00+10:00,2023-06-05,07:29,3,0,3
31,2023-06-05T07:29:00+10:00,2023-06-05,07:29,2,0,2
41,2023-06-05T07:29:00+10:00,2023-06-05,07:29,21,1,22
42,2023-06-05T07:29:00+10:00,2023-06-05,07:29,1,0,1
45,2023-06-05T07:29:00+10:00,2023-06-05,07:29,0,2,2
61,2023-06-05T07:29:00+10:00,2023-06-05,07:29,1,2,3
66,2023-06-05T07:29:00+10:00,2023-06-05,07:29,0,1,1
69,2023-06-05T07:29:00+10:00,2023-06-05,07:29,1,0,1
78,2023-06-05T07:29:00+10:00,2023-06-05,07:29,0,1,1
108,2023-06-05T07:29:00+10:00,2023-06-05,07:29,4,5,9
12,2023-06-05T07:29:00+10:00,2023-06-05,07:29,0,1,1
17,2023-06-05T07:29:00+10:00,2023-06-05,07:29,7,1,8
20,2023-06-05T07:29:00+10:00,2023-06-05,07:29,0,1,1
24,2023-06-05T07:29:00+10:00,2023-06-05,07:29,11,17,28
48,2023-06-05T07:29:00+10:00,2023-06-05,07:29,2,0,2
51,2023-06-05T07:29:00+10:00,2023-06-05,07:29,2,0,2
52,2023-06-05T07:29:00+10:00,2023-06-05,07:29,1,4,5
56,2023-06-05T07:29:00+10:00,2023-06-05,07:29,1,1,2
58,2023-06-05T07:29:00+10:00,2023-06-05,07:29,11,3,14
62,2023-06-05T07:29:00+10:00,2023-06-05,07:29,1,0,1
63,2023-06-05T07:29:00+10:00,2023-06-05,07:29,2,0,2
72,2023-06-05T07:29:00+10:00,2023-06-05,07:29,1,0,1
79,2023-06-05T07:29:00+10:00,2023-06-05,07:29,4,1,5
4,2023-06-05T07:28:00+10:00,2023-06-05,07:28,3,2,5
6,2023-06-05T07:28:00+10:00,2023-06-05,07:28,5,4,9
47,2023-06-05T07:28:00+10:00,2023-06-05,07:28,3,4,7
54,2023-06-05T07:28:00+10:00,2023-06-05,07:28,0,1,1
61,2023-06-05T07:28:00+10:00,2023-06-05,07:28,0,2,2
66,2023-06-05T07:28:00+10:00,2023-06-05,07:28,0,1,1
1,2023-06-05T07:28:00+10:00,2023-06-05,07:28,0,2,2
12,2023-06-05T07:28:00+10:00,2023-06-05,07:28,0,2,2
35,2023-06-05T07:28:00+10:00,2023-06-05,07:28,5,8,13
49,2023-06-05T07:28:00+10:00,2023-06-05,07:28,0,2,2
58,2023-06-05T07:28:00+10:00,2023-06-05,07:28,6,0,6
62,2023-06-05T07:28:00+10:00,2023-06-05,07:28,3,4,7
72,2023-06-05T07:28:00+10:00,2023-06-05,07:28,1,1,2
79,2023-06-05T07:28:00+10:00,2023-06-05,07:28,3,2,5
3,2023-06-05T07:28:00+10:00,2023-06-05,07:28,1,2,3
5,2023-06-05T07:28:00+10:00,2023-06-05,07:28,2,4,6
26,2023-06-05T07:28:00+10:00,2023-06-05,07:28,0,2,2
29,2023-06-05T07:28:00+10:00,2023-06-05,07:28,2,0,2
42,2023-06-05T07:28:00+10:00,2023-06-05,07:28,0,2,2
17,2023-06-05T07:28:00+10:00,2023-06-05,07:28,4,5,9
24,2023-06-05T07:28:00+10:00,2023-06-05,07:28,8,7,15
30,2023-06-05T07:28:00+10:00,2023-06-05,07:28,0,1,1
48,2023-06-05T07:28:00+10:00,2023-06-05,07:28,1,0,1
53,2023-06-05T07:28:00+10:00,2023-06-05,07:28,1,0,1
56,2023-06-05T07:28:00+10:00,2023-06-05,07:28,2,1,3
63,2023-06-05T07:28:00+10:00,2023-06-05,07:28,3,0,3
67,2023-06-05T07:28:00+10:00,2023-06-05,07:28,5,1,6
76,2023-06-05T07:28:00+10:00,2023-06-05,07:28,1,2,3
86,2023-06-05T07:28:00+10:00,2023-06-05,07:28,2,0,2
8,2023-06-05T07:28:00+10:00,2023-06-05,07:28,1,1,2
28,2023-06-05T07:28:00+10:00,2023-06-05,07:28,2,2,4
36,2023-06-05T07:28:00+10:00,2023-06-05,07:28,2,0,2
40,2023-06-05T07:28:00+10:00,2023-06-05,07:28,1,1,2
41,2023-06-05T07:28:00+10:00,2023-06-05,07:28,4,3,7
45,2023-06-05T07:28:00+10:00,2023-06-05,07:28,3,0,3
50,2023-06-05T07:28:00+10:00,2023-06-05,07:28,2,0,2
55,2023-06-05T07:28:00+10:00,2023-06-05,07:28,5,6,11
69,2023-06-05T07:28:00+10:00,2023-06-05,07:28,1,0,1
70,2023-06-05T07:28:00+10:00,2023-06-05,07:28,0,2,2
77,2023-06-05T07:28:00+10:00,2023-06-05,07:28,2,1,3
108,2023-06-05T07:28:00+10:00,2023-06-05,07:28,0,4,4
2,2023-06-05T07:28:00+10:00,2023-06-05,07:28,2,1,3
9,2023-06-05T07:28:00+10:00,2023-06-05,07:28,4,17,21
10,2023-06-05T07:28:00+10:00,2023-06-05,07:28,1,2,3
18,2023-06-05T07:28:00+10:00,2023-06-05,07:28,1,7,8
23,2023-06-05T07:28:00+10:00,2023-06-05,07:28,2,1,3
51,2023-06-05T07:28:00+10:00,2023-06-05,07:28,1,1,2
52,2023-06-05T07:28:00+10:00,2023-06-05,07:28,1,2,3
57,2023-06-05T07:28:00+10:00,2023-06-05,07:28,2,5,7
68,2023-06-05T07:28:00+10:00,2023-06-05,07:28,1,0,1
85,2023-06-05T07:28:00+10:00,2023-06-05,07:28,3,0,3
3,2023-06-05T07:27:00+10:00,2023-06-05,07:27,0,1,1
21,2023-06-05T07:27:00+10:00,2023-06-05,07:27,1,3,4
26,2023-06-05T07:27:00+10:00,2023-06-05,07:27,4,1,5
28,2023-06-05T07:27:00+10:00,2023-06-05,07:27,3,2,5
29,2023-06-05T07:27:00+10:00,2023-06-05,07:27,2,0,2
40,2023-06-05T07:27:00+10:00,2023-06-05,07:27,2,0,2
54,2023-06-05T07:27:00+10:00,2023-06-05,07:27,1,0,1
61,2023-06-05T07:27:00+10:00,2023-06-05,07:27,0,5,5
69,2023-06-05T07:27:00+10:00,2023-06-05,07:27,2,0,2
87,2023-06-05T07:27:00+10:00,2023-06-05,07:27,0,1,1
11,2023-06-05T07:27:00+10:00,2023-06-05,07:27,1,0,1
17,2023-06-05T07:27:00+10:00,2023-06-05,07:27,4,6,10
23,2023-06-05T07:27:00+10:00,2023-06-05,07:27,2,7,9
27,2023-06-05T07:27:00+10:00,2023-06-05,07:27,1,1,2
35,2023-06-05T07:27:00+10:00,2023-06-05,07:27,1,3,4
53,2023-06-05T07:27:00+10:00,2023-06-05,07:27,2,1,3
56,2023-06-05T07:27:00+10:00,2023-06-05,07:27,1,0,1
63,2023-06-05T07:27:00+10:00,2023-06-05,07:27,1,0,1
4,2023-06-05T07:27:00+10:00,2023-06-05,07:27,0,4,4
41,2023-06-05T07:27:00+10:00,2023-06-05,07:27,3,7,10
47,2023-06-05T07:27:00+10:00,2023-06-05,07:27,3,2,5
55,2023-06-05T07:27:00+10:00,2023-06-05,07:27,8,4,12
77,2023-06-05T07:27:00+10:00,2023-06-05,07:27,0,1,1
2,2023-06-05T07:27:00+10:00,2023-06-05,07:27,1,2,3
19,2023-06-05T07:27:00+10:00,2023-06-05,07:27,4,0,4
24,2023-06-05T07:27:00+10:00,2023-06-05,07:27,15,4,19
52,2023-06-05T07:27:00+10:00,2023-06-05,07:27,0,3,3
68,2023-06-05T07:27:00+10:00,2023-06-05,07:27,1,0,1
72,2023-06-05T07:27:00+10:00,2023-06-05,07:27,1,0,1
79,2023-06-05T07:27:00+10:00,2023-06-05,07:27,2,2,4
5,2023-06-05T07:27:00+10:00,2023-06-05,07:27,1,8,9
6,2023-06-05T07:27:00+10:00,2023-06-05,07:27,1,2,3
8,2023-06-05T07:27:00+10:00,2023-06-05,07:27,7,2,9
14,2023-06-05T07:27:00+10:00,2023-06-05,07:27,4,2,6
31,2023-06-05T07:27:00+10:00,2023-06-05,07:27,1,0,1
36,2023-06-05T07:27:00+10:00,2023-06-05,07:27,0,2,2
45,2023-06-05T07:27:00+10:00,2023-06-05,07:27,3,0,3
65,2023-06-05T07:27:00+10:00,2023-06-05,07:27,8,0,8
66,2023-06-05T07:27:00+10:00,2023-06-05,07:27,0,5,5
108,2023-06-05T07:27:00+10:00,2023-06-05,07:27,1,1,2
1,2023-06-05T07:27:00+10:00,2023-06-05,07:27,0,1,1
9,2023-06-05T07:27:00+10:00,2023-06-05,07:27,0,12,12
10,2023-06-05T07:27:00+10:00,2023-06-05,07:27,1,3,4
12,2023-06-05T07:27:00+10:00,2023-06-05,07:27,1,1,2
18,2023-06-05T07:27:00+10:00,2023-06-05,07:27,0,2,2
48,2023-06-05T07:27:00+10:00,2023-06-05,07:27,1,0,1
57,2023-06-05T07:27:00+10:00,2023-06-05,07:27,0,7,7
58,2023-06-05T07:27:00+10:00,2023-06-05,07:27,12,0,12
62,2023-06-05T07:27:00+10:00,2023-06-05,07:27,3,0,3
67,2023-06-05T07:27:00+10:00,2023-06-05,07:27,2,2,4
85,2023-06-05T07:27:00+10:00,2023-06-05,07:27,2,0,2
3,2023-06-05T07:26:00+10:00,2023-06-05,07:26,0,2,2
4,2023-06-05T07:26:00+10:00,2023-06-05,07:26,7,2,9
5,2023-06-05T07:26:00+10:00,2023-06-05,07:26,1,7,8
6,2023-06-05T07:26:00+10:00,2023-06-05,07:26,3,8,11
8,2023-06-05T07:26:00+10:00,2023-06-05,07:26,1,2,3
14,2023-06-05T07:26:00+10:00,2023-06-05,07:26,2,2,4
29,2023-06-05T07:26:00+10:00,2023-06-05,07:26,3,1,4
36,2023-06-05T07:26:00+10:00,2023-06-05,07:26,1,0,1
40,2023-06-05T07:26:00+10:00,2023-06-05,07:26,0,1,1
65,2023-06-05T07:26:00+10:00,2023-06-05,07:26,1,5,6
66,2023-06-05T07:26:00+10:00,2023-06-05,07:26,0,1,1
69,2023-06-05T07:26:00+10:00,2023-06-05,07:26,1,0,1
1,2023-06-05T07:26:00+10:00,2023-06-05,07:26,1,1,2
20,2023-06-05T07:26:00+10:00,2023-06-05,07:26,1,1,2
27,2023-06-05T07:26:00+10:00,2023-06-05,07:26,0,1,1
46,2023-06-05T07:26:00+10:00,2023-06-05,07:26,0,2,2
56,2023-06-05T07:26:00+10:00,2023-06-05,07:26,2,0,2
58,2023-06-05T07:26:00+10:00,2023-06-05,07:26,0,4,4
62,2023-06-05T07:26:00+10:00,2023-06-05,07:26,0,3,3
31,2023-06-05T07:26:00+10:00,2023-06-05,07:26,0,1,1
39,2023-06-05T07:26:00+10:00,2023-06-05,07:26,1,0,1
47,2023-06-05T07:26:00+10:00,2023-06-05,07:26,2,6,8
61,2023-06-05T07:26:00+10:00,2023-06-05,07:26,4,1,5
108,2023-06-05T07:26:00+10:00,2023-06-05,07:26,0,5,5
2,2023-06-05T07:26:00+10:00,2023-06-05,07:26,0,3,3
9,2023-06-05T07:26:00+10:00,2023-06-05,07:26,1,15,16
12,2023-06-05T07:26:00+10:00,2023-06-05,07:26,3,1,4
17,2023-06-05T07:26:00+10:00,2023-06-05,07:26,10,1,11
18,2023-06-05T07:26:00+10:00,2023-06-05,07:26,0,5,5
19,2023-06-05T07:26:00+10:00,2023-06-05,07:26,0,1,1
24,2023-06-05T07:26:00+10:00,2023-06-05,07:26,9,2,11
35,2023-06-05T07:26:00+10:00,2023-06-05,07:26,2,6,8
49,2023-06-05T07:26:00+10:00,2023-06-05,07:26,4,0,4
53,2023-06-05T07:26:00+10:00,2023-06-05,07:26,1,1,2
79,2023-06-05T07:26:00+10:00,2023-06-05,07:26,7,3,10
85,2023-06-05T07:26:00+10:00,2023-06-05,07:26,1,0,1
26,2023-06-05T07:26:00+10:00,2023-06-05,07:26,1,2,3
28,2023-06-05T07:26:00+10:00,2023-06-05,07:26,0,1,1
41,2023-06-05T07:26:00+10:00,2023-06-05,07:26,6,1,7
42,2023-06-05T07:26:00+10:00,2023-06-05,07:26,1,2,3
45,2023-06-05T07:26:00+10:00,2023-06-05,07:26,3,6,9
55,2023-06-05T07:26:00+10:00,2023-06-05,07:26,1,1,2
77,2023-06-05T07:26:00+10:00,2023-06-05,07:26,1,1,2
10,2023-06-05T07:26:00+10:00,2023-06-05,07:26,0,4,4
23,2023-06-05T07:26:00+10:00,2023-06-05,07:26,1,2,3
30,2023-06-05T07:26:00+10:00,2023-06-05,07:26,0,1,1
48,2023-06-05T07:26:00+10:00,2023-06-05,07:26,0,2,2
52,2023-06-05T07:26:00+10:00,2023-06-05,07:26,5,0,5
57,2023-06-05T07:26:00+10:00,2023-06-05,07:26,11,15,26
63,2023-06-05T07:26:00+10:00,2023-06-05,07:26,0,2,2
67,2023-06-05T07:26:00+10:00,2023-06-05,07:26,2,2,4
72,2023-06-05T07:26:00+10:00,2023-06-05,07:26,1,3,4
3,2023-06-05T07:25:00+10:00,2023-06-05,07:25,1,3,4
4,2023-06-05T07:25:00+10:00,2023-06-05,07:25,10,1,11
6,2023-06-05T07:25:00+10:00,2023-06-05,07:25,3,4,7
26,2023-06-05T07:25:00+10:00,2023-06-05,07:25,0,2,2
31,2023-06-05T07:25:00+10:00,2023-06-05,07:25,2,0,2
36,2023-06-05T07:25:00+10:00,2023-06-05,07:25,0,1,1
41,2023-06-05T07:25:00+10:00,2023-06-05,07:25,7,9,16
45,2023-06-05T07:25:00+10:00,2023-06-05,07:25,0,3,3
59,2023-06-05T07:25:00+10:00,2023-06-05,07:25,11,7,18
66,2023-06-05T07:25:00+10:00,2023-06-05,07:25,1,3,4
70,2023-06-05T07:25:00+10:00,2023-06-05,07:25,1,0,1
84,2023-06-05T07:25:00+10:00,2023-06-05,07:25,32,12,44
108,2023-06-05T07:25:00+10:00,2023-06-05,07:25,0,11,11
118,2023-06-05T07:25:00+10:00,2023-06-05,07:25,0,5,5
1,2023-06-05T07:25:00+10:00,2023-06-05,07:25,2,1,3
11,2023-06-05T07:25:00+10:00,2023-06-05,07:25,2,3,5
17,2023-06-05T07:25:00+10:00,2023-06-05,07:25,1,1,2
23,2023-06-05T07:25:00+10:00,2023-06-05,07:25,8,2,10
30,2023-06-05T07:25:00+10:00,2023-06-05,07:25,1,0,1
58,2023-06-05T07:25:00+10:00,2023-06-05,07:25,16,1,17
63,2023-06-05T07:25:00+10:00,2023-06-05,07:25,1,1,2
67,2023-06-05T07:25:00+10:00,2023-06-05,07:25,2,0,2
76,2023-06-05T07:25:00+10:00,2023-06-05,07:25,2,1,3
86,2023-06-05T07:25:00+10:00,2023-06-05,07:25,0,1,1
109,2023-06-05T07:25:00+10:00,2023-06-05,07:25,1,32,33
5,2023-06-05T07:25:00+10:00,2023-06-05,07:25,1,2,3
8,2023-06-05T07:25:00+10:00,2023-06-05,07:25,0,1,1
14,2023-06-05T07:25:00+10:00,2023-06-05,07:25,0,2,2
28,2023-06-05T07:25:00+10:00,2023-06-05,07:25,4,1,5
39,2023-06-05T07:25:00+10:00,2023-06-05,07:25,3,0,3
44,2023-06-05T07:25:00+10:00,2023-06-05,07:25,0,1,1
47,2023-06-05T07:25:00+10:00,2023-06-05,07:25,4,3,7
54,2023-06-05T07:25:00+10:00,2023-06-05,07:25,1,0,1
55,2023-06-05T07:25:00+10:00,2023-06-05,07:25,1,5,6
61,2023-06-05T07:25:00+10:00,2023-06-05,07:25,3,4,7
65,2023-06-05T07:25:00+10:00,2023-06-05,07:25,5,1,6
69,2023-06-05T07:25:00+10:00,2023-06-05,07:25,1,0,1
77,2023-06-05T07:25:00+10:00,2023-06-05,07:25,1,5,6
107,2023-06-05T07:25:00+10:00,2023-06-05,07:25,3,3,6
2,2023-06-05T07:25:00+10:00,2023-06-05,07:25,1,0,1
9,2023-06-05T07:25:00+10:00,2023-06-05,07:25,1,9,10
18,2023-06-05T07:25:00+10:00,2023-06-05,07:25,0,2,2
24,2023-06-05T07:25:00+10:00,2023-06-05,07:25,15,1,16
49,2023-06-05T07:25:00+10:00,2023-06-05,07:25,0,2,2
57,2023-06-05T07:25:00+10:00,2023-06-05,07:25,4,5,9
62,2023-06-05T07:25:00+10:00,2023-06-05,07:25,1,0,1
72,2023-06-05T07:25:00+10:00,2023-06-05,07:25,2,0,2
117,2023-06-05T07:25:00+10:00,2023-06-05,07:25,1,10,11
21,2023-06-05T07:25:00+10:00,2023-06-05,07:25,0,2,2
29,2023-06-05T07:25:00+10:00,2023-06-05,07:25,1,4,5
40,2023-06-05T07:25:00+10:00,2023-06-05,07:25,2,0,2
87,2023-06-05T07:25:00+10:00,2023-06-05,07:25,0,1,1
10,2023-06-05T07:25:00+10:00,2023-06-05,07:25,2,3,5
35,2023-06-05T07:25:00+10:00,2023-06-05,07:25,3,0,3
51,2023-06-05T07:25:00+10:00,2023-06-05,07:25,1,0,1
52,2023-06-05T07:25:00+10:00,2023-06-05,07:25,4,0,4
53,2023-06-05T07:25:00+10:00,2023-06-05,07:25,0,1,1
56,2023-06-05T07:25:00+10:00,2023-06-05,07:25,0,1,1
79,2023-06-05T07:25:00+10:00,2023-06-05,07:25,0,3,3
85,2023-06-05T07:25:00+10:00,2023-06-05,07:25,1,1,2
4,2023-06-05T07:24:00+10:00,2023-06-05,07:24,1,0,1
6,2023-06-05T07:24:00+10:00,2023-06-05,07:24,2,2,4
39,2023-06-05T07:24:00+10:00,2023-06-05,07:24,1,2,3
41,2023-06-05T07:24:00+10:00,2023-06-05,07:24,6,1,7
42,2023-06-05T07:24:00+10:00,2023-06-05,07:24,0,1,1
71,2023-06-05T07:24:00+10:00,2023-06-05,07:24,1,0,1
9,2023-06-05T07:24:00+10:00,2023-06-05,07:24,0,6,6
10,2023-06-05T07:24:00+10:00,2023-06-05,07:24,0,3,3
17,2023-06-05T07:24:00+10:00,2023-06-05,07:24,7,0,7
20,2023-06-05T07:24:00+10:00,2023-06-05,07:24,0,1,1
35,2023-06-05T07:24:00+10:00,2023-06-05,07:24,6,4,10
48,2023-06-05T07:24:00+10:00,2023-06-05,07:24,1,0,1
51,2023-06-05T07:24:00+10:00,2023-06-05,07:24,1,0,1
53,2023-06-05T07:24:00+10:00,2023-06-05,07:24,1,2,3
62,2023-06-05T07:24:00+10:00,2023-06-05,07:24,2,0,2
68,2023-06-05T07:24:00+10:00,2023-06-05,07:24,1,0,1
3,2023-06-05T07:24:00+10:00,2023-06-05,07:24,5,1,6
5,2023-06-05T07:24:00+10:00,2023-06-05,07:24,1,3,4
14,2023-06-05T07:24:00+10:00,2023-06-05,07:24,3,1,4
21,2023-06-05T07:24:00+10:00,2023-06-05,07:24,2,1,3
28,2023-06-05T07:24:00+10:00,2023-06-05,07:24,1,3,4
47,2023-06-05T07:24:00+10:00,2023-06-05,07:24,2,0,2
54,2023-06-05T07:24:00+10:00,2023-06-05,07:24,0,1,1
55,2023-06-05T07:24:00+10:00,2023-06-05,07:24,1,5,6
61,2023-06-05T07:24:00+10:00,2023-06-05,07:24,2,3,5
69,2023-06-05T07:24:00+10:00,2023-06-05,07:24,1,0,1
77,2023-06-05T07:24:00+10:00,2023-06-05,07:24,0,3,3
1,2023-06-05T07:24:00+10:00,2023-06-05,07:24,2,0,2
24,2023-06-05T07:24:00+10:00,2023-06-05,07:24,11,0,11
57,2023-06-05T07:24:00+10:00,2023-06-05,07:24,0,2,2
58,2023-06-05T07:24:00+10:00,2023-06-05,07:24,11,6,17
79,2023-06-05T07:24:00+10:00,2023-06-05,07:24,3,2,5
8,2023-06-05T07:24:00+10:00,2023-06-05,07:24,2,3,5
29,2023-06-05T07:24:00+10:00,2023-06-05,07:24,0,2,2
40,2023-06-05T07:24:00+10:00,2023-06-05,07:24,0,1,1
45,2023-06-05T07:24:00+10:00,2023-06-05,07:24,3,0,3
65,2023-06-05T07:24:00+10:00,2023-06-05,07:24,2,1,3
66,2023-06-05T07:24:00+10:00,2023-06-05,07:24,0,3,3
70,2023-06-05T07:24:00+10:00,2023-06-05,07:24,1,1,2
75,2023-06-05T07:24:00+10:00,2023-06-05,07:24,1,0,1
108,2023-06-05T07:24:00+10:00,2023-06-05,07:24,1,7,8
19,2023-06-05T07:24:00+10:00,2023-06-05,07:24,1,1,2
23,2023-06-05T07:24:00+10:00,2023-06-05,07:24,2,1,3
52,2023-06-05T07:24:00+10:00,2023-06-05,07:24,0,3,3
63,2023-06-05T07:24:00+10:00,2023-06-05,07:24,0,1,1
67,2023-06-05T07:24:00+10:00,2023-06-05,07:24,1,1,2
72,2023-06-05T07:24:00+10:00,2023-06-05,07:24,6,2,8
3,2023-06-05T07:23:00+10:00,2023-06-05,07:23,1,0,1
4,2023-06-05T07:23:00+10:00,2023-06-05,07:23,5,2,7
6,2023-06-05T07:23:00+10:00,2023-06-05,07:23,3,2,5
8,2023-06-05T07:23:00+10:00,2023-06-05,07:23,2,2,4
14,2023-06-05T07:23:00+10:00,2023-06-05,07:23,4,3,7
26,2023-06-05T07:23:00+10:00,2023-06-05,07:23,2,0,2
66,2023-06-05T07:23:00+10:00,2023-06-05,07:23,0,2,2
69,2023-06-05T07:23:00+10:00,2023-06-05,07:23,0,1,1
108,2023-06-05T07:23:00+10:00,2023-06-05,07:23,0,2,2
24,2023-06-05T07:23:00+10:00,2023-06-05,07:23,12,0,12
35,2023-06-05T07:23:00+10:00,2023-06-05,07:23,1,4,5
72,2023-06-05T07:23:00+10:00,2023-06-05,07:23,2,0,2
79,2023-06-05T07:23:00+10:00,2023-06-05,07:23,1,3,4
21,2023-06-05T07:23:00+10:00,2023-06-05,07:23,0,3,3
28,2023-06-05T07:23:00+10:00,2023-06-05,07:23,3,1,4
36,2023-06-05T07:23:00+10:00,2023-06-05,07:23,3,0,3
45,2023-06-05T07:23:00+10:00,2023-06-05,07:23,3,4,7
65,2023-06-05T07:23:00+10:00,2023-06-05,07:23,3,4,7
87,2023-06-05T07:23:00+10:00,2023-06-05,07:23,0,1,1
1,2023-06-05T07:23:00+10:00,2023-06-05,07:23,2,0,2
12,2023-06-05T07:23:00+10:00,2023-06-05,07:23,7,0,7
23,2023-06-05T07:23:00+10:00,2023-06-05,07:23,2,0,2
51,2023-06-05T07:23:00+10:00,2023-06-05,07:23,0,2,2
53,2023-06-05T07:23:00+10:00,2023-06-05,07:23,2,4,6
56,2023-06-05T07:23:00+10:00,2023-06-05,07:23,0,1,1
62,2023-06-05T07:23:00+10:00,2023-06-05,07:23,0,1,1
5,2023-06-05T07:23:00+10:00,2023-06-05,07:23,2,1,3
29,2023-06-05T07:23:00+10:00,2023-06-05,07:23,1,0,1
40,2023-06-05T07:23:00+10:00,2023-06-05,07:23,0,1,1
41,2023-06-05T07:23:00+10:00,2023-06-05,07:23,19,1,20
47,2023-06-05T07:23:00+10:00,2023-06-05,07:23,2,3,5
54,2023-06-05T07:23:00+10:00,2023-06-05,07:23,0,1,1
55,2023-06-05T07:23:00+10:00,2023-06-05,07:23,2,2,4
9,2023-06-05T07:23:00+10:00,2023-06-05,07:23,3,12,15
10,2023-06-05T07:23:00+10:00,2023-06-05,07:23,0,1,1
17,2023-06-05T07:23:00+10:00,2023-06-05,07:23,9,0,9
19,2023-06-05T07:23:00+10:00,2023-06-05,07:23,1,0,1
30,2023-06-05T07:23:00+10:00,2023-06-05,07:23,1,0,1
48,2023-06-05T07:23:00+10:00,2023-06-05,07:23,0,1,1
57,2023-06-05T07:23:00+10:00,2023-06-05,07:23,1,3,4
58,2023-06-05T07:23:00+10:00,2023-06-05,07:23,14,3,17
67,2023-06-05T07:23:00+10:00,2023-06-05,07:23,2,4,6
68,2023-06-05T07:23:00+10:00,2023-06-05,07:23,1,0,1
76,2023-06-05T07:23:00+10:00,2023-06-05,07:23,2,0,2
85,2023-06-05T07:23:00+10:00,2023-06-05,07:23,1,0,1
3,2023-06-05T07:22:00+10:00,2023-06-05,07:22,1,0,1
4,2023-06-05T07:22:00+10:00,2023-06-05,07:22,1,3,4
8,2023-06-05T07:22:00+10:00,2023-06-05,07:22,4,0,4
29,2023-06-05T07:22:00+10:00,2023-06-05,07:22,1,0,1
36,2023-06-05T07:22:00+10:00,2023-06-05,07:22,1,0,1
41,2023-06-05T07:22:00+10:00,2023-06-05,07:22,18,8,26
65,2023-06-05T07:22:00+10:00,2023-06-05,07:22,6,2,8
18,2023-06-05T07:22:00+10:00,2023-06-05,07:22,1,5,6
23,2023-06-05T07:22:00+10:00,2023-06-05,07:22,4,1,5
57,2023-06-05T07:22:00+10:00,2023-06-05,07:22,0,8,8
79,2023-06-05T07:22:00+10:00,2023-06-05,07:22,2,2,4
14,2023-06-05T07:22:00+10:00,2023-06-05,07:22,8,2,10
26,2023-06-05T07:22:00+10:00,2023-06-05,07:22,0,3,3
31,2023-06-05T07:22:00+10:00,2023-06-05,07:22,0,1,1
40,2023-06-05T07:22:00+10:00,2023-06-05,07:22,3,2,5
47,2023-06-05T07:22:00+10:00,2023-06-05,07:22,0,3,3
50,2023-06-05T07:22:00+10:00,2023-06-05,07:22,1,0,1
54,2023-06-05T07:22:00+10:00,2023-06-05,07:22,1,3,4
77,2023-06-05T07:22:00+10:00,2023-06-05,07:22,0,1,1
78,2023-06-05T07:22:00+10:00,2023-06-05,07:22,0,2,2
87,2023-06-05T07:22:00+10:00,2023-06-05,07:22,1,3,4
2,2023-06-05T07:22:00+10:00,2023-06-05,07:22,0,2,2
24,2023-06-05T07:22:00+10:00,2023-06-05,07:22,18,4,22
56,2023-06-05T07:22:00+10:00,2023-06-05,07:22,2,0,2
58,2023-06-05T07:22:00+10:00,2023-06-05,07:22,13,0,13
67,2023-06-05T07:22:00+10:00,2023-06-05,07:22,4,4,8
72,2023-06-05T07:22:00+10:00,2023-06-05,07:22,3,1,4
5,2023-06-05T07:22:00+10:00,2023-06-05,07:22,0,7,7
6,2023-06-05T07:22:00+10:00,2023-06-05,07:22,4,5,9
28,2023-06-05T07:22:00+10:00,2023-06-05,07:22,2,1,3
44,2023-06-05T07:22:00+10:00,2023-06-05,07:22,1,1,2
55,2023-06-05T07:22:00+10:00,2023-06-05,07:22,2,2,4
61,2023-06-05T07:22:00+10:00,2023-06-05,07:22,2,3,5
75,2023-06-05T07:22:00+10:00,2023-06-05,07:22,1,0,1
108,2023-06-05T07:22:00+10:00,2023-06-05,07:22,1,6,7
9,2023-06-05T07:22:00+10:00,2023-06-05,07:22,0,8,8
10,2023-06-05T07:22:00+10:00,2023-06-05,07:22,0,4,4
12,2023-06-05T07:22:00+10:00,2023-06-05,07:22,2,0,2
17,2023-06-05T07:22:00+10:00,2023-06-05,07:22,4,1,5
35,2023-06-05T07:22:00+10:00,2023-06-05,07:22,7,5,12
48,2023-06-05T07:22:00+10:00,2023-06-05,07:22,1,0,1
51,2023-06-05T07:22:00+10:00,2023-06-05,07:22,2,0,2
52,2023-06-05T07:22:00+10:00,2023-06-05,07:22,1,6,7
53,2023-06-05T07:22:00+10:00,2023-06-05,07:22,3,2,5
85,2023-06-05T07:22:00+10:00,2023-06-05,07:22,1,0,1
4,2023-06-05T07:21:00+10:00,2023-06-05,07:21,1,0,1
8,2023-06-05T07:21:00+10:00,2023-06-05,07:21,0,2,2
28,2023-06-05T07:21:00+10:00,2023-06-05,07:21,5,2,7
29,2023-06-05T07:21:00+10:00,2023-06-05,07:21,2,0,2
36,2023-06-05T07:21:00+10:00,2023-06-05,07:21,1,1,2
40,2023-06-05T07:21:00+10:00,2023-06-05,07:21,0,1,1
47,2023-06-05T07:21:00+10:00,2023-06-05,07:21,1,2,3
55,2023-06-05T07:21:00+10:00,2023-06-05,07:21,1,3,4
61,2023-06-05T07:21:00+10:00,2023-06-05,07:21,1,3,4
70,2023-06-05T07:21:00+10:00,2023-06-05,07:21,1,0,1
108,2023-06-05T07:21:00+10:00,2023-06-05,07:21,0,7,7
12,2023-06-05T07:21:00+10:00,2023-06-05,07:21,5,0,5
18,2023-06-05T07:21:00+10:00,2023-06-05,07:21,0,5,5
20,2023-06-05T07:21:00+10:00,2023-06-05,07:21,0,1,1
23,2023-06-05T07:21:00+10:00,2023-06-05,07:21,4,4,8
35,2023-06-05T07:21:00+10:00,2023-06-05,07:21,3,7,10
58,2023-06-05T07:21:00+10:00,2023-06-05,07:21,2,0,2
3,2023-06-05T07:21:00+10:00,2023-06-05,07:21,2,4,6
5,2023-06-05T07:21:00+10:00,2023-06-05,07:21,3,3,6
6,2023-06-05T07:21:00+10:00,2023-06-05,07:21,5,6,11
39,2023-06-05T07:21:00+10:00,2023-06-05,07:21,1,0,1
42,2023-06-05T07:21:00+10:00,2023-06-05,07:21,1,0,1
45,2023-06-05T07:21:00+10:00,2023-06-05,07:21,0,1,1
65,2023-06-05T07:21:00+10:00,2023-06-05,07:21,2,0,2
66,2023-06-05T07:21:00+10:00,2023-06-05,07:21,0,3,3
77,2023-06-05T07:21:00+10:00,2023-06-05,07:21,1,0,1
9,2023-06-05T07:21:00+10:00,2023-06-05,07:21,0,5,5
17,2023-06-05T07:21:00+10:00,2023-06-05,07:21,6,2,8
30,2023-06-05T07:21:00+10:00,2023-06-05,07:21,0,1,1
48,2023-06-05T07:21:00+10:00,2023-06-05,07:21,0,1,1
51,2023-06-05T07:21:00+10:00,2023-06-05,07:21,0,1,1
53,2023-06-05T07:21:00+10:00,2023-06-05,07:21,3,2,5
57,2023-06-05T07:21:00+10:00,2023-06-05,07:21,3,8,11
62,2023-06-05T07:21:00+10:00,2023-06-05,07:21,2,2,4
86,2023-06-05T07:21:00+10:00,2023-06-05,07:21,1,0,1
14,2023-06-05T07:21:00+10:00,2023-06-05,07:21,8,1,9
26,2023-06-05T07:21:00+10:00,2023-06-05,07:21,4,3,7
31,2023-06-05T07:21:00+10:00,2023-06-05,07:21,1,0,1
41,2023-06-05T07:21:00+10:00,2023-06-05,07:21,11,3,14
54,2023-06-05T07:21:00+10:00,2023-06-05,07:21,0,1,1
75,2023-06-05T07:21:00+10:00,2023-06-05,07:21,4,1,5
1,2023-06-05T07:21:00+10:00,2023-06-05,07:21,1,1,2
10,2023-06-05T07:21:00+10:00,2023-06-05,07:21,0,2,2
11,2023-06-05T07:21:00+10:00,2023-06-05,07:21,2,0,2
24,2023-06-05T07:21:00+10:00,2023-06-05,07:21,6,15,21
27,2023-06-05T07:21:00+10:00,2023-06-05,07:21,0,1,1
52,2023-06-05T07:21:00+10:00,2023-06-05,07:21,0,1,1
63,2023-06-05T07:21:00+10:00,2023-06-05,07:21,2,0,2
67,2023-06-05T07:21:00+10:00,2023-06-05,07:21,4,1,5
72,2023-06-05T07:21:00+10:00,2023-06-05,07:21,3,2,5
79,2023-06-05T07:21:00+10:00,2023-06-05,07:21,3,7,10
85,2023-06-05T07:21:00+10:00,2023-06-05,07:21,4,0,4
4,2023-06-05T07:20:00+10:00,2023-06-05,07:20,3,4,7
21,2023-06-05T07:20:00+10:00,2023-06-05,07:20,0,4,4
26,2023-06-05T07:20:00+10:00,2023-06-05,07:20,1,0,1
28,2023-06-05T07:20:00+10:00,2023-06-05,07:20,6,1,7
29,2023-06-05T07:20:00+10:00,2023-06-05,07:20,0,2,2
39,2023-06-05T07:20:00+10:00,2023-06-05,07:20,1,0,1
47,2023-06-05T07:20:00+10:00,2023-06-05,07:20,2,1,3
54,2023-06-05T07:20:00+10:00,2023-06-05,07:20,1,1,2
70,2023-06-05T07:20:00+10:00,2023-06-05,07:20,0,1,1
75,2023-06-05T07:20:00+10:00,2023-06-05,07:20,1,1,2
87,2023-06-05T07:20:00+10:00,2023-06-05,07:20,1,0,1
107,2023-06-05T07:20:00+10:00,2023-06-05,07:20,4,2,6
118,2023-06-05T07:20:00+10:00,2023-06-05,07:20,1,0,1
1,2023-06-05T07:20:00+10:00,2023-06-05,07:20,0,1,1
10,2023-06-05T07:20:00+10:00,2023-06-05,07:20,0,1,1
11,2023-06-05T07:20:00+10:00,2023-06-05,07:20,2,0,2
17,2023-06-05T07:20:00+10:00,2023-06-05,07:20,3,0,3
23,2023-06-05T07:20:00+10:00,2023-06-05,07:20,2,0,2
24,2023-06-05T07:20:00+10:00,2023-06-05,07:20,10,0,10
48,2023-06-05T07:20:00+10:00,2023-06-05,07:20,0,1,1
57,2023-06-05T07:20:00+10:00,2023-06-05,07:20,0,3,3
85,2023-06-05T07:20:00+10:00,2023-06-05,07:20,1,0,1
3,2023-06-05T07:20:00+10:00,2023-06-05,07:20,0,3,3
5,2023-06-05T07:20:00+10:00,2023-06-05,07:20,2,2,4
6,2023-06-05T07:20:00+10:00,2023-06-05,07:20,3,3,6
14,2023-06-05T07:20:00+10:00,2023-06-05,07:20,2,3,5
41,2023-06-05T07:20:00+10:00,2023-06-05,07:20,9,1,10
42,2023-06-05T07:20:00+10:00,2023-06-05,07:20,1,1,2
44,2023-06-05T07:20:00+10:00,2023-06-05,07:20,0,1,1
66,2023-06-05T07:20:00+10:00,2023-06-05,07:20,0,4,4
71,2023-06-05T07:20:00+10:00,2023-06-05,07:20,0,3,3
84,2023-06-05T07:20:00+10:00,2023-06-05,07:20,32,6,38
2,2023-06-05T07:20:00+10:00,2023-06-05,07:20,1,0,1
18,2023-06-05T07:20:00+10:00,2023-06-05,07:20,0,2,2
27,2023-06-05T07:20:00+10:00,2023-06-05,07:20,1,1,2
46,2023-06-05T07:20:00+10:00,2023-06-05,07:20,0,1,1
52,2023-06-05T07:20:00+10:00,2023-06-05,07:20,1,1,2
53,2023-06-05T07:20:00+10:00,2023-06-05,07:20,0,4,4
63,2023-06-05T07:20:00+10:00,2023-06-05,07:20,1,1,2
67,2023-06-05T07:20:00+10:00,2023-06-05,07:20,6,1,7
79,2023-06-05T07:20:00+10:00,2023-06-05,07:20,6,3,9
109,2023-06-05T07:20:00+10:00,2023-06-05,07:20,4,17,21
36,2023-06-05T07:20:00+10:00,2023-06-05,07:20,1,0,1
40,2023-06-05T07:20:00+10:00,2023-06-05,07:20,0,2,2
45,2023-06-05T07:20:00+10:00,2023-06-05,07:20,1,4,5
55,2023-06-05T07:20:00+10:00,2023-06-05,07:20,0,2,2
59,2023-06-05T07:20:00+10:00,2023-06-05,07:20,8,5,13
61,2023-06-05T07:20:00+10:00,2023-06-05,07:20,4,3,7
65,2023-06-05T07:20:00+10:00,2023-06-05,07:20,0,1,1
78,2023-06-05T07:20:00+10:00,2023-06-05,07:20,0,1,1
108,2023-06-05T07:20:00+10:00,2023-06-05,07:20,1,5,6
9,2023-06-05T07:20:00+10:00,2023-06-05,07:20,1,8,9
35,2023-06-05T07:20:00+10:00,2023-06-05,07:20,4,4,8
58,2023-06-05T07:20:00+10:00,2023-06-05,07:20,7,0,7
62,2023-06-05T07:20:00+10:00,2023-06-05,07:20,0,2,2
117,2023-06-05T07:20:00+10:00,2023-06-05,07:20,3,4,7
21,2023-06-05T07:19:00+10:00,2023-06-05,07:19,1,0,1
26,2023-06-05T07:19:00+10:00,2023-06-05,07:19,1,0,1
28,2023-06-05T07:19:00+10:00,2023-06-05,07:19,6,1,7
36,2023-06-05T07:19:00+10:00,2023-06-05,07:19,1,3,4
108,2023-06-05T07:19:00+10:00,2023-06-05,07:19,2,7,9
12,2023-06-05T07:19:00+10:00,2023-06-05,07:19,1,0,1
18,2023-06-05T07:19:00+10:00,2023-06-05,07:19,1,0,1
20,2023-06-05T07:19:00+10:00,2023-06-05,07:19,1,3,4
35,2023-06-05T07:19:00+10:00,2023-06-05,07:19,5,3,8
67,2023-06-05T07:19:00+10:00,2023-06-05,07:19,2,1,3
4,2023-06-05T07:19:00+10:00,2023-06-05,07:19,2,3,5
6,2023-06-05T07:19:00+10:00,2023-06-05,07:19,8,7,15
8,2023-06-05T07:19:00+10:00,2023-06-05,07:19,1,2,3
29,2023-06-05T07:19:00+10:00,2023-06-05,07:19,3,0,3
40,2023-06-05T07:19:00+10:00,2023-06-05,07:19,2,1,3
41,2023-06-05T07:19:00+10:00,2023-06-05,07:19,16,5,21
42,2023-06-05T07:19:00+10:00,2023-06-05,07:19,1,0,1
47,2023-06-05T07:19:00+10:00,2023-06-05,07:19,3,0,3
50,2023-06-05T07:19:00+10:00,2023-06-05,07:19,0,1,1
55,2023-06-05T07:19:00+10:00,2023-06-05,07:19,1,7,8
65,2023-06-05T07:19:00+10:00,2023-06-05,07:19,1,0,1
66,2023-06-05T07:19:00+10:00,2023-06-05,07:19,1,0,1
77,2023-06-05T07:19:00+10:00,2023-06-05,07:19,1,1,2
11,2023-06-05T07:19:00+10:00,2023-06-05,07:19,1,1,2
23,2023-06-05T07:19:00+10:00,2023-06-05,07:19,6,4,10
46,2023-06-05T07:19:00+10:00,2023-06-05,07:19,2,1,3
52,2023-06-05T07:19:00+10:00,2023-06-05,07:19,1,0,1
58,2023-06-05T07:19:00+10:00,2023-06-05,07:19,11,0,11
63,2023-06-05T07:19:00+10:00,2023-06-05,07:19,1,3,4
79,2023-06-05T07:19:00+10:00,2023-06-05,07:19,1,0,1
85,2023-06-05T07:19:00+10:00,2023-06-05,07:19,1,0,1
86,2023-06-05T07:19:00+10:00,2023-06-05,07:19,0,1,1
5,2023-06-05T07:19:00+10:00,2023-06-05,07:19,1,3,4
14,2023-06-05T07:19:00+10:00,2023-06-05,07:19,3,1,4
45,2023-06-05T07:19:00+10:00,2023-06-05,07:19,0,2,2
61,2023-06-05T07:19:00+10:00,2023-06-05,07:19,0,1,1
75,2023-06-05T07:19:00+10:00,2023-06-05,07:19,0,1,1
1,2023-06-05T07:19:00+10:00,2023-06-05,07:19,3,0,3
2,2023-06-05T07:19:00+10:00,2023-06-05,07:19,2,1,3
9,2023-06-05T07:19:00+10:00,2023-06-05,07:19,1,10,11
10,2023-06-05T07:19:00+10:00,2023-06-05,07:19,1,4,5
17,2023-06-05T07:19:00+10:00,2023-06-05,07:19,5,2,7
24,2023-06-05T07:19:00+10:00,2023-06-05,07:19,17,9,26
48,2023-06-05T07:19:00+10:00,2023-06-05,07:19,2,0,2
57,2023-06-05T07:19:00+10:00,2023-06-05,07:19,1,4,5
76,2023-06-05T07:19:00+10:00,2023-06-05,07:19,2,0,2
5,2023-06-05T07:18:00+10:00,2023-06-05,07:18,3,4,7
8,2023-06-05T07:18:00+10:00,2023-06-05,07:18,1,0,1
14,2023-06-05T07:18:00+10:00,2023-06-05,07:18,8,0,8
28,2023-06-05T07:18:00+10:00,2023-06-05,07:18,4,0,4
29,2023-06-05T07:18:00+10:00,2023-06-05,07:18,1,0,1
41,2023-06-05T07:18:00+10:00,2023-06-05,07:18,4,3,7
42,2023-06-05T07:18:00+10:00,2023-06-05,07:18,0,1,1
47,2023-06-05T07:18:00+10:00,2023-06-05,07:18,1,1,2
66,2023-06-05T07:18:00+10:00,2023-06-05,07:18,0,1,1
77,2023-06-05T07:18:00+10:00,2023-06-05,07:18,0,1,1
108,2023-06-05T07:18:00+10:00,2023-06-05,07:18,0,6,6
10,2023-06-05T07:18:00+10:00,2023-06-05,07:18,0,7,7
17,2023-06-05T07:18:00+10:00,2023-06-05,07:18,7,4,11
27,2023-06-05T07:18:00+10:00,2023-06-05,07:18,1,0,1
72,2023-06-05T07:18:00+10:00,2023-06-05,07:18,2,1,3
3,2023-06-05T07:18:00+10:00,2023-06-05,07:18,1,3,4
6,2023-06-05T07:18:00+10:00,2023-06-05,07:18,3,1,4
21,2023-06-05T07:18:00+10:00,2023-06-05,07:18,1,0,1
36,2023-06-05T07:18:00+10:00,2023-06-05,07:18,1,2,3
39,2023-06-05T07:18:00+10:00,2023-06-05,07:18,1,0,1
44,2023-06-05T07:18:00+10:00,2023-06-05,07:18,0,1,1
55,2023-06-05T07:18:00+10:00,2023-06-05,07:18,3,1,4
71,2023-06-05T07:18:00+10:00,2023-06-05,07:18,1,0,1
75,2023-06-05T07:18:00+10:00,2023-06-05,07:18,1,0,1
87,2023-06-05T07:18:00+10:00,2023-06-05,07:18,0,3,3
1,2023-06-05T07:18:00+10:00,2023-06-05,07:18,1,1,2
2,2023-06-05T07:18:00+10:00,2023-06-05,07:18,2,2,4
9,2023-06-05T07:18:00+10:00,2023-06-05,07:18,0,12,12
11,2023-06-05T07:18:00+10:00,2023-06-05,07:18,0,1,1
24,2023-06-05T07:18:00+10:00,2023-06-05,07:18,6,2,8
35,2023-06-05T07:18:00+10:00,2023-06-05,07:18,1,5,6
52,2023-06-05T07:18:00+10:00,2023-06-05,07:18,1,1,2
57,2023-06-05T07:18:00+10:00,2023-06-05,07:18,3,6,9
63,2023-06-05T07:18:00+10:00,2023-06-05,07:18,1,0,1
4,2023-06-05T07:18:00+10:00,2023-06-05,07:18,6,4,10
26,2023-06-05T07:18:00+10:00,2023-06-05,07:18,2,0,2
40,2023-06-05T07:18:00+10:00,2023-06-05,07:18,6,1,7
45,2023-06-05T07:18:00+10:00,2023-06-05,07:18,1,2,3
69,2023-06-05T07:18:00+10:00,2023-06-05,07:18,2,0,2
70,2023-06-05T07:18:00+10:00,2023-06-05,07:18,1,0,1
12,2023-06-05T07:18:00+10:00,2023-06-05,07:18,1,2,3
19,2023-06-05T07:18:00+10:00,2023-06-05,07:18,1,0,1
23,2023-06-05T07:18:00+10:00,2023-06-05,07:18,1,3,4
53,2023-06-05T07:18:00+10:00,2023-06-05,07:18,0,2,2
58,2023-06-05T07:18:00+10:00,2023-06-05,07:18,8,2,10
62,2023-06-05T07:18:00+10:00,2023-06-05,07:18,2,0,2
67,2023-06-05T07:18:00+10:00,2023-06-05,07:18,0,1,1
68,2023-06-05T07:18:00+10:00,2023-06-05,07:18,2,0,2
76,2023-06-05T07:18:00+10:00,2023-06-05,07:18,1,0,1
5,2023-06-05T07:17:00+10:00,2023-06-05,07:17,1,6,7
6,2023-06-05T07:17:00+10:00,2023-06-05,07:17,1,4,5
21,2023-06-05T07:17:00+10:00,2023-06-05,07:17,2,6,8
28,2023-06-05T07:17:00+10:00,2023-06-05,07:17,9,0,9
31,2023-06-05T07:17:00+10:00,2023-06-05,07:17,2,0,2
36,2023-06-05T07:17:00+10:00,2023-06-05,07:17,2,0,2
55,2023-06-05T07:17:00+10:00,2023-06-05,07:17,2,2,4
61,2023-06-05T07:17:00+10:00,2023-06-05,07:17,3,1,4
65,2023-06-05T07:17:00+10:00,2023-06-05,07:17,3,0,3
10,2023-06-05T07:17:00+10:00,2023-06-05,07:17,0,1,1
11,2023-06-05T07:17:00+10:00,2023-06-05,07:17,0,1,1
18,2023-06-05T07:17:00+10:00,2023-06-05,07:17,1,6,7
27,2023-06-05T07:17:00+10:00,2023-06-05,07:17,2,1,3
76,2023-06-05T07:17:00+10:00,2023-06-05,07:17,2,1,3
4,2023-06-05T07:17:00+10:00,2023-06-05,07:17,3,0,3
8,2023-06-05T07:17:00+10:00,2023-06-05,07:17,0,5,5
37,2023-06-05T07:17:00+10:00,2023-06-05,07:17,0,1,1
41,2023-06-05T07:17:00+10:00,2023-06-05,07:17,6,2,8
45,2023-06-05T07:17:00+10:00,2023-06-05,07:17,1,2,3
47,2023-06-05T07:17:00+10:00,2023-06-05,07:17,0,1,1
75,2023-06-05T07:17:00+10:00,2023-06-05,07:17,0,1,1
108,2023-06-05T07:17:00+10:00,2023-06-05,07:17,0,4,4
12,2023-06-05T07:17:00+10:00,2023-06-05,07:17,1,0,1
23,2023-06-05T07:17:00+10:00,2023-06-05,07:17,3,2,5
24,2023-06-05T07:17:00+10:00,2023-06-05,07:17,9,12,21
35,2023-06-05T07:17:00+10:00,2023-06-05,07:17,3,5,8
48,2023-06-05T07:17:00+10:00,2023-06-05,07:17,0,3,3
57,2023-06-05T07:17:00+10:00,2023-06-05,07:17,1,1,2
58,2023-06-05T07:17:00+10:00,2023-06-05,07:17,0,1,1
67,2023-06-05T07:17:00+10:00,2023-06-05,07:17,0,3,3
85,2023-06-05T07:17:00+10:00,2023-06-05,07:17,1,1,2
3,2023-06-05T07:17:00+10:00,2023-06-05,07:17,0,5,5
14,2023-06-05T07:17:00+10:00,2023-06-05,07:17,4,1,5
26,2023-06-05T07:17:00+10:00,2023-06-05,07:17,0,1,1
29,2023-06-05T07:17:00+10:00,2023-06-05,07:17,0,1,1
39,2023-06-05T07:17:00+10:00,2023-06-05,07:17,1,1,2
40,2023-06-05T07:17:00+10:00,2023-06-05,07:17,2,2,4
66,2023-06-05T07:17:00+10:00,2023-06-05,07:17,0,1,1
77,2023-06-05T07:17:00+10:00,2023-06-05,07:17,1,1,2
1,2023-06-05T07:17:00+10:00,2023-06-05,07:17,0,1,1
9,2023-06-05T07:17:00+10:00,2023-06-05,07:17,3,8,11
17,2023-06-05T07:17:00+10:00,2023-06-05,07:17,6,2,8
46,2023-06-05T07:17:00+10:00,2023-06-05,07:17,0,3,3
49,2023-06-05T07:17:00+10:00,2023-06-05,07:17,0,2,2
52,2023-06-05T07:17:00+10:00,2023-06-05,07:17,1,1,2
62,2023-06-05T07:17:00+10:00,2023-06-05,07:17,1,0,1
63,2023-06-05T07:17:00+10:00,2023-06-05,07:17,0,1,1
79,2023-06-05T07:17:00+10:00,2023-06-05,07:17,2,2,4
4,2023-06-05T07:16:00+10:00,2023-06-05,07:16,3,1,4
8,2023-06-05T07:16:00+10:00,2023-06-05,07:16,1,1,2
29,2023-06-05T07:16:00+10:00,2023-06-05,07:16,0,4,4
40,2023-06-05T07:16:00+10:00,2023-06-05,07:16,1,2,3
44,2023-06-05T07:16:00+10:00,2023-06-05,07:16,0,1,1
47,2023-06-05T07:16:00+10:00,2023-06-05,07:16,0,5,5
55,2023-06-05T07:16:00+10:00,2023-06-05,07:16,1,2,3
70,2023-06-05T07:16:00+10:00,2023-06-05,07:16,0,1,1
77,2023-06-05T07:16:00+10:00,2023-06-05,07:16,0,2,2
87,2023-06-05T07:16:00+10:00,2023-06-05,07:16,1,0,1
108,2023-06-05T07:16:00+10:00,2023-06-05,07:16,1,3,4
1,2023-06-05T07:16:00+10:00,2023-06-05,07:16,1,0,1
2,2023-06-05T07:16:00+10:00,2023-06-05,07:16,1,1,2
9,2023-06-05T07:16:00+10:00,2023-06-05,07:16,0,13,13
18,2023-06-05T07:16:00+10:00,2023-06-05,07:16,0,3,3
35,2023-06-05T07:16:00+10:00,2023-06-05,07:16,3,4,7
48,2023-06-05T07:16:00+10:00,2023-06-05,07:16,1,0,1
52,2023-06-05T07:16:00+10:00,2023-06-05,07:16,1,0,1
63,2023-06-05T07:16:00+10:00,2023-06-05,07:16,0,1,1
76,2023-06-05T07:16:00+10:00,2023-06-05,07:16,1,0,1
79,2023-06-05T07:16:00+10:00,2023-06-05,07:16,3,3,6
3,2023-06-05T07:16:00+10:00,2023-06-05,07:16,2,1,3
6,2023-06-05T07:16:00+10:00,2023-06-05,07:16,4,3,7
14,2023-06-05T07:16:00+10:00,2023-06-05,07:16,5,2,7
26,2023-06-05T07:16:00+10:00,2023-06-05,07:16,2,1,3
28,2023-06-05T07:16:00+10:00,2023-06-05,07:16,4,0,4
42,2023-06-05T07:16:00+10:00,2023-06-05,07:16,0,1,1
45,2023-06-05T07:16:00+10:00,2023-06-05,07:16,4,4,8
54,2023-06-05T07:16:00+10:00,2023-06-05,07:16,5,2,7
65,2023-06-05T07:16:00+10:00,2023-06-05,07:16,3,1,4
10,2023-06-05T07:16:00+10:00,2023-06-05,07:16,0,1,1
57,2023-06-05T07:16:00+10:00,2023-06-05,07:16,3,5,8
58,2023-06-05T07:16:00+10:00,2023-06-05,07:16,11,0,11
62,2023-06-05T07:16:00+10:00,2023-06-05,07:16,1,0,1
5,2023-06-05T07:16:00+10:00,2023-06-05,07:16,3,8,11
41,2023-06-05T07:16:00+10:00,2023-06-05,07:16,5,1,6
61,2023-06-05T07:16:00+10:00,2023-06-05,07:16,0,2,2
66,2023-06-05T07:16:00+10:00,2023-06-05,07:16,2,4,6
12,2023-06-05T07:16:00+10:00,2023-06-05,07:16,0,2,2
17,2023-06-05T07:16:00+10:00,2023-06-05,07:16,4,0,4
19,2023-06-05T07:16:00+10:00,2023-06-05,07:16,0,1,1
23,2023-06-05T07:16:00+10:00,2023-06-05,07:16,5,0,5
24,2023-06-05T07:16:00+10:00,2023-06-05,07:16,22,1,23
30,2023-06-05T07:16:00+10:00,2023-06-05,07:16,0,2,2
51,2023-06-05T07:16:00+10:00,2023-06-05,07:16,1,0,1
67,2023-06-05T07:16:00+10:00,2023-06-05,07:16,0,1,1
3,2023-06-05T07:15:00+10:00,2023-06-05,07:15,1,1,2
4,2023-06-05T07:15:00+10:00,2023-06-05,07:15,3,0,3
5,2023-06-05T07:15:00+10:00,2023-06-05,07:15,3,4,7
26,2023-06-05T07:15:00+10:00,2023-06-05,07:15,2,1,3
28,2023-06-05T07:15:00+10:00,2023-06-05,07:15,9,3,12
39,2023-06-05T07:15:00+10:00,2023-06-05,07:15,0,1,1
40,2023-06-05T07:15:00+10:00,2023-06-05,07:15,5,0,5
69,2023-06-05T07:15:00+10:00,2023-06-05,07:15,1,0,1
118,2023-06-05T07:15:00+10:00,2023-06-05,07:15,0,1,1
9,2023-06-05T07:15:00+10:00,2023-06-05,07:15,1,16,17
11,2023-06-05T07:15:00+10:00,2023-06-05,07:15,1,0,1
23,2023-06-05T07:15:00+10:00,2023-06-05,07:15,3,2,5
30,2023-06-05T07:15:00+10:00,2023-06-05,07:15,0,1,1
35,2023-06-05T07:15:00+10:00,2023-06-05,07:15,8,4,12
48,2023-06-05T07:15:00+10:00,2023-06-05,07:15,3,0,3
52,2023-06-05T07:15:00+10:00,2023-06-05,07:15,2,1,3
63,2023-06-05T07:15:00+10:00,2023-06-05,07:15,1,1,2
67,2023-06-05T07:15:00+10:00,2023-06-05,07:15,2,0,2
79,2023-06-05T07:15:00+10:00,2023-06-05,07:15,1,1,2
6,2023-06-05T07:15:00+10:00,2023-06-05,07:15,6,3,9
8,2023-06-05T07:15:00+10:00,2023-06-05,07:15,1,0,1
65,2023-06-05T07:15:00+10:00,2023-06-05,07:15,1,1,2
77,2023-06-05T07:15:00+10:00,2023-06-05,07:15,2,2,4
108,2023-06-05T07:15:00+10:00,2023-06-05,07:15,1,7,8
1,2023-06-05T07:15:00+10:00,2023-06-05,07:15,1,1,2
12,2023-06-05T07:15:00+10:00,2023-06-05,07:15,0,1,1
17,2023-06-05T07:15:00+10:00,2023-06-05,07:15,2,0,2
18,2023-06-05T07:15:00+10:00,2023-06-05,07:15,0,3,3
19,2023-06-05T07:15:00+10:00,2023-06-05,07:15,0,6,6
57,2023-06-05T07:15:00+10:00,2023-06-05,07:15,0,8,8
68,2023-06-05T07:15:00+10:00,2023-06-05,07:15,2,0,2
14,2023-06-05T07:15:00+10:00,2023-06-05,07:15,4,1,5
29,2023-06-05T07:15:00+10:00,2023-06-05,07:15,1,0,1
31,2023-06-05T07:15:00+10:00,2023-06-05,07:15,0,1,1
37,2023-06-05T07:15:00+10:00,2023-06-05,07:15,0,2,2
41,2023-06-05T07:15:00+10:00,2023-06-05,07:15,19,4,23
44,2023-06-05T07:15:00+10:00,2023-06-05,07:15,0,1,1
47,2023-06-05T07:15:00+10:00,2023-06-05,07:15,3,9,12
54,2023-06-05T07:15:00+10:00,2023-06-05,07:15,0,2,2
55,2023-06-05T07:15:00+10:00,2023-06-05,07:15,5,1,6
59,2023-06-05T07:15:00+10:00,2023-06-05,07:15,10,4,14
66,2023-06-05T07:15:00+10:00,2023-06-05,07:15,1,1,2
75,2023-06-05T07:15:00+10:00,2023-06-05,07:15,1,0,1
84,2023-06-05T07:15:00+10:00,2023-06-05,07:15,31,13,44
107,2023-06-05T07:15:00+10:00,2023-06-05,07:15,1,10,11
2,2023-06-05T07:15:00+10:00,2023-06-05,07:15,0,2,2
10,2023-06-05T07:15:00+10:00,2023-06-05,07:15,0,3,3
24,2023-06-05T07:15:00+10:00,2023-06-05,07:15,6,3,9
46,2023-06-05T07:15:00+10:00,2023-06-05,07:15,2,0,2
53,2023-06-05T07:15:00+10:00,2023-06-05,07:15,0,2,2
58,2023-06-05T07:15:00+10:00,2023-06-05,07:15,4,1,5
76,2023-06-05T07:15:00+10:00,2023-06-05,07:15,1,0,1
109,2023-06-05T07:15:00+10:00,2023-06-05,07:15,1,13,14
117,2023-06-05T07:15:00+10:00,2023-06-05,07:15,4,5,9
4,2023-06-05T07:14:00+10:00,2023-06-05,07:14,2,1,3
5,2023-06-05T07:14:00+10:00,2023-06-05,07:14,2,2,4
8,2023-06-05T07:14:00+10:00,2023-06-05,07:14,5,1,6
26,2023-06-05T07:14:00+10:00,2023-06-05,07:14,1,0,1
28,2023-06-05T07:14:00+10:00,2023-06-05,07:14,4,0,4
40,2023-06-05T07:14:00+10:00,2023-06-05,07:14,0,2,2
55,2023-06-05T07:14:00+10:00,2023-06-05,07:14,4,4,8
65,2023-06-05T07:14:00+10:00,2023-06-05,07:14,1,1,2
108,2023-06-05T07:14:00+10:00,2023-06-05,07:14,0,13,13
10,2023-06-05T07:14:00+10:00,2023-06-05,07:14,0,1,1
18,2023-06-05T07:14:00+10:00,2023-06-05,07:14,1,1,2
24,2023-06-05T07:14:00+10:00,2023-06-05,07:14,8,0,8
52,2023-06-05T07:14:00+10:00,2023-06-05,07:14,2,1,3
57,2023-06-05T07:14:00+10:00,2023-06-05,07:14,6,10,16
79,2023-06-05T07:14:00+10:00,2023-06-05,07:14,0,3,3
3,2023-06-05T07:14:00+10:00,2023-06-05,07:14,1,5,6
21,2023-06-05T07:14:00+10:00,2023-06-05,07:14,3,2,5
36,2023-06-05T07:14:00+10:00,2023-06-05,07:14,2,0,2
39,2023-06-05T07:14:00+10:00,2023-06-05,07:14,1,1,2
45,2023-06-05T07:14:00+10:00,2023-06-05,07:14,1,2,3
47,2023-06-05T07:14:00+10:00,2023-06-05,07:14,1,0,1
66,2023-06-05T07:14:00+10:00,2023-06-05,07:14,0,1,1
87,2023-06-05T07:14:00+10:00,2023-06-05,07:14,1,1,2
1,2023-06-05T07:14:00+10:00,2023-06-05,07:14,0,2,2
2,2023-06-05T07:14:00+10:00,2023-06-05,07:14,1,1,2
12,2023-06-05T07:14:00+10:00,2023-06-05,07:14,1,1,2
17,2023-06-05T07:14:00+10:00,2023-06-05,07:14,5,0,5
20,2023-06-05T07:14:00+10:00,2023-06-05,07:14,2,0,2
35,2023-06-05T07:14:00+10:00,2023-06-05,07:14,3,4,7
46,2023-06-05T07:14:00+10:00,2023-06-05,07:14,2,0,2
51,2023-06-05T07:14:00+10:00,2023-06-05,07:14,0,2,2
53,2023-06-05T07:14:00+10:00,2023-06-05,07:14,2,2,4
67,2023-06-05T07:14:00+10:00,2023-06-05,07:14,3,0,3
72,2023-06-05T07:14:00+10:00,2023-06-05,07:14,3,0,3
6,2023-06-05T07:14:00+10:00,2023-06-05,07:14,3,3,6
14,2023-06-05T07:14:00+10:00,2023-06-05,07:14,0,1,1
29,2023-06-05T07:14:00+10:00,2023-06-05,07:14,1,2,3
41,2023-06-05T07:14:00+10:00,2023-06-05,07:14,17,3,20
54,2023-06-05T07:14:00+10:00,2023-06-05,07:14,2,0,2
61,2023-06-05T07:14:00+10:00,2023-06-05,07:14,2,1,3
70,2023-06-05T07:14:00+10:00,2023-06-05,07:14,0,1,1
77,2023-06-05T07:14:00+10:00,2023-06-05,07:14,2,1,3
9,2023-06-05T07:14:00+10:00,2023-06-05,07:14,1,6,7
23,2023-06-05T07:14:00+10:00,2023-06-05,07:14,1,1,2
48,2023-06-05T07:14:00+10:00,2023-06-05,07:14,0,1,1
58,2023-06-05T07:14:00+10:00,2023-06-05,07:14,4,0,4
63,2023-06-05T07:14:00+10:00,2023-06-05,07:14,0,2,2
14,2023-06-05T07:13:00+10:00,2023-06-05,07:13,2,1,3
40,2023-06-05T07:13:00+10:00,2023-06-05,07:13,1,7,8
41,2023-06-05T07:13:00+10:00,2023-06-05,07:13,1,9,10
65,2023-06-05T07:13:00+10:00,2023-06-05,07:13,4,0,4
66,2023-06-05T07:13:00+10:00,2023-06-05,07:13,0,1,1
69,2023-06-05T07:13:00+10:00,2023-06-05,07:13,4,0,4
71,2023-06-05T07:13:00+10:00,2023-06-05,07:13,0,3,3
75,2023-06-05T07:13:00+10:00,2023-06-05,07:13,2,1,3
77,2023-06-05T07:13:00+10:00,2023-06-05,07:13,1,0,1
9,2023-06-05T07:13:00+10:00,2023-06-05,07:13,0,5,5
10,2023-06-05T07:13:00+10:00,2023-06-05,07:13,1,1,2
18,2023-06-05T07:13:00+10:00,2023-06-05,07:13,1,6,7
20,2023-06-05T07:13:00+10:00,2023-06-05,07:13,0,1,1
51,2023-06-05T07:13:00+10:00,2023-06-05,07:13,2,0,2
52,2023-06-05T07:13:00+10:00,2023-06-05,07:13,0,3,3
72,2023-06-05T07:13:00+10:00,2023-06-05,07:13,6,2,8
3,2023-06-05T07:13:00+10:00,2023-06-05,07:13,0,3,3
5,2023-06-05T07:13:00+10:00,2023-06-05,07:13,2,8,10
6,2023-06-05T07:13:00+10:00,2023-06-05,07:13,4,6,10
42,2023-06-05T07:13:00+10:00,2023-06-05,07:13,0,4,4
45,2023-06-05T07:13:00+10:00,2023-06-05,07:13,0,2,2
47,2023-06-05T07:13:00+10:00,2023-06-05,07:13,3,9,12
61,2023-06-05T07:13:00+10:00,2023-06-05,07:13,3,1,4
108,2023-06-05T07:13:00+10:00,2023-06-05,07:13,0,10,10
2,2023-06-05T07:13:00+10:00,2023-06-05,07:13,1,0,1
12,2023-06-05T07:13:00+10:00,2023-06-05,07:13,1,0,1
19,2023-06-05T07:13:00+10:00,2023-06-05,07:13,2,2,4
23,2023-06-05T07:13:00+10:00,2023-06-05,07:13,9,0,9
48,2023-06-05T07:13:00+10:00,2023-06-05,07:13,1,0,1
53,2023-06-05T07:13:00+10:00,2023-06-05,07:13,3,1,4
58,2023-06-05T07:13:00+10:00,2023-06-05,07:13,3,0,3
67,2023-06-05T07:13:00+10:00,2023-06-05,07:13,2,3,5
85,2023-06-05T07:13:00+10:00,2023-06-05,07:13,1,0,1
86,2023-06-05T07:13:00+10:00,2023-06-05,07:13,2,0,2
4,2023-06-05T07:13:00+10:00,2023-06-05,07:13,1,3,4
8,2023-06-05T07:13:00+10:00,2023-06-05,07:13,0,1,1
21,2023-06-05T07:13:00+10:00,2023-06-05,07:13,3,1,4
26,2023-06-05T07:13:00+10:00,2023-06-05,07:13,0,1,1
28,2023-06-05T07:13:00+10:00,2023-06-05,07:13,4,2,6
55,2023-06-05T07:13:00+10:00,2023-06-05,07:13,3,2,5
87,2023-06-05T07:13:00+10:00,2023-06-05,07:13,1,0,1
1,2023-06-05T07:13:00+10:00,2023-06-05,07:13,0,1,1
17,2023-06-05T07:13:00+10:00,2023-06-05,07:13,2,3,5
24,2023-06-05T07:13:00+10:00,2023-06-05,07:13,4,10,14
35,2023-06-05T07:13:00+10:00,2023-06-05,07:13,2,5,7
49,2023-06-05T07:13:00+10:00,2023-06-05,07:13,0,1,1
57,2023-06-05T07:13:00+10:00,2023-06-05,07:13,1,4,5
79,2023-06-05T07:13:00+10:00,2023-06-05,07:13,4,2,6
14,2023-06-05T07:12:00+10:00,2023-06-05,07:12,6,2,8
26,2023-06-05T07:12:00+10:00,2023-06-05,07:12,2,0,2
29,2023-06-05T07:12:00+10:00,2023-06-05,07:12,1,1,2
36,2023-06-05T07:12:00+10:00,2023-06-05,07:12,0,1,1
41,2023-06-05T07:12:00+10:00,2023-06-05,07:12,6,3,9
45,2023-06-05T07:12:00+10:00,2023-06-05,07:12,1,1,2
66,2023-06-05T07:12:00+10:00,2023-06-05,07:12,2,2,4
69,2023-06-05T07:12:00+10:00,2023-06-05,07:12,3,0,3
71,2023-06-05T07:12:00+10:00,2023-06-05,07:12,0,5,5
1,2023-06-05T07:12:00+10:00,2023-06-05,07:12,1,2,3
17,2023-06-05T07:12:00+10:00,2023-06-05,07:12,6,0,6
23,2023-06-05T07:12:00+10:00,2023-06-05,07:12,0,5,5
35,2023-06-05T07:12:00+10:00,2023-06-05,07:12,4,3,7
51,2023-06-05T07:12:00+10:00,2023-06-05,07:12,2,0,2
53,2023-06-05T07:12:00+10:00,2023-06-05,07:12,0,1,1
63,2023-06-05T07:12:00+10:00,2023-06-05,07:12,1,0,1
72,2023-06-05T07:12:00+10:00,2023-06-05,07:12,2,2,4
85,2023-06-05T07:12:00+10:00,2023-06-05,07:12,1,0,1
3,2023-06-05T07:12:00+10:00,2023-06-05,07:12,4,0,4
4,2023-06-05T07:12:00+10:00,2023-06-05,07:12,3,0,3
21,2023-06-05T07:12:00+10:00,2023-06-05,07:12,0,1,1
31,2023-06-05T07:12:00+10:00,2023-06-05,07:12,0,2,2
44,2023-06-05T07:12:00+10:00,2023-06-05,07:12,0,2,2
47,2023-06-05T07:12:00+10:00,2023-06-05,07:12,1,2,3
55,2023-06-05T07:12:00+10:00,2023-06-05,07:12,0,1,1
9,2023-06-05T07:12:00+10:00,2023-06-05,07:12,1,3,4
11,2023-06-05T07:12:00+10:00,2023-06-05,07:12,0,2,2
18,2023-06-05T07:12:00+10:00,2023-06-05,07:12,0,3,3
24,2023-06-05T07:12:00+10:00,2023-06-05,07:12,2,13,15
79,2023-06-05T07:12:00+10:00,2023-06-05,07:12,4,2,6
5,2023-06-05T07:12:00+10:00,2023-06-05,07:12,0,5,5
6,2023-06-05T07:12:00+10:00,2023-06-05,07:12,4,8,12
28,2023-06-05T07:12:00+10:00,2023-06-05,07:12,1,1,2
61,2023-06-05T07:12:00+10:00,2023-06-05,07:12,0,2,2
70,2023-06-05T07:12:00+10:00,2023-06-05,07:12,1,0,1
108,2023-06-05T07:12:00+10:00,2023-06-05,07:12,1,24,25
2,2023-06-05T07:12:00+10:00,2023-06-05,07:12,1,0,1
27,2023-06-05T07:12:00+10:00,2023-06-05,07:12,0,2,2
46,2023-06-05T07:12:00+10:00,2023-06-05,07:12,0,1,1
48,2023-06-05T07:12:00+10:00,2023-06-05,07:12,1,0,1
57,2023-06-05T07:12:00+10:00,2023-06-05,07:12,0,2,2
58,2023-06-05T07:12:00+10:00,2023-06-05,07:12,2,2,4
67,2023-06-05T07:12:00+10:00,2023-06-05,07:12,0,4,4
5,2023-06-05T07:11:00+10:00,2023-06-05,07:11,1,7,8
36,2023-06-05T07:11:00+10:00,2023-06-05,07:11,0,1,1
66,2023-06-05T07:11:00+10:00,2023-06-05,07:11,0,3,3
75,2023-06-05T07:11:00+10:00,2023-06-05,07:11,1,0,1
17,2023-06-05T07:11:00+10:00,2023-06-05,07:11,3,1,4
20,2023-06-05T07:11:00+10:00,2023-06-05,07:11,1,1,2
24,2023-06-05T07:11:00+10:00,2023-06-05,07:11,12,9,21
56,2023-06-05T07:11:00+10:00,2023-06-05,07:11,1,0,1
63,2023-06-05T07:11:00+10:00,2023-06-05,07:11,1,0,1
67,2023-06-05T07:11:00+10:00,2023-06-05,07:11,1,0,1
14,2023-06-05T07:11:00+10:00,2023-06-05,07:11,5,2,7
26,2023-06-05T07:11:00+10:00,2023-06-05,07:11,1,2,3
40,2023-06-05T07:11:00+10:00,2023-06-05,07:11,2,1,3
41,2023-06-05T07:11:00+10:00,2023-06-05,07:11,3,5,8
65,2023-06-05T07:11:00+10:00,2023-06-05,07:11,2,0,2
71,2023-06-05T07:11:00+10:00,2023-06-05,07:11,0,12,12
77,2023-06-05T07:11:00+10:00,2023-06-05,07:11,0,1,1
108,2023-06-05T07:11:00+10:00,2023-06-05,07:11,0,3,3
9,2023-06-05T07:11:00+10:00,2023-06-05,07:11,0,12,12
10,2023-06-05T07:11:00+10:00,2023-06-05,07:11,0,3,3
27,2023-06-05T07:11:00+10:00,2023-06-05,07:11,1,0,1
35,2023-06-05T07:11:00+10:00,2023-06-05,07:11,3,6,9
51,2023-06-05T07:11:00+10:00,2023-06-05,07:11,1,0,1
62,2023-06-05T07:11:00+10:00,2023-06-05,07:11,2,0,2
72,2023-06-05T07:11:00+10:00,2023-06-05,07:11,1,3,4
85,2023-06-05T07:11:00+10:00,2023-06-05,07:11,2,0,2
3,2023-06-05T07:11:00+10:00,2023-06-05,07:11,2,2,4
4,2023-06-05T07:11:00+10:00,2023-06-05,07:11,3,0,3
6,2023-06-05T07:11:00+10:00,2023-06-05,07:11,3,2,5
8,2023-06-05T07:11:00+10:00,2023-06-05,07:11,1,1,2
28,2023-06-05T07:11:00+10:00,2023-06-05,07:11,3,2,5
45,2023-06-05T07:11:00+10:00,2023-06-05,07:11,1,1,2
47,2023-06-05T07:11:00+10:00,2023-06-05,07:11,2,1,3
54,2023-06-05T07:11:00+10:00,2023-06-05,07:11,0,1,1
55,2023-06-05T07:11:00+10:00,2023-06-05,07:11,5,0,5
1,2023-06-05T07:11:00+10:00,2023-06-05,07:11,1,1,2
12,2023-06-05T07:11:00+10:00,2023-06-05,07:11,0,3,3
18,2023-06-05T07:11:00+10:00,2023-06-05,07:11,0,3,3
23,2023-06-05T07:11:00+10:00,2023-06-05,07:11,3,2,5
57,2023-06-05T07:11:00+10:00,2023-06-05,07:11,0,3,3
58,2023-06-05T07:11:00+10:00,2023-06-05,07:11,6,0,6
79,2023-06-05T07:11:00+10:00,2023-06-05,07:11,1,2,3
3,2023-06-05T07:10:00+10:00,2023-06-05,07:10,1,0,1
4,2023-06-05T07:10:00+10:00,2023-06-05,07:10,7,1,8
5,2023-06-05T07:10:00+10:00,2023-06-05,07:10,2,5,7
8,2023-06-05T07:10:00+10:00,2023-06-05,07:10,1,0,1
28,2023-06-05T07:10:00+10:00,2023-06-05,07:10,6,1,7
31,2023-06-05T07:10:00+10:00,2023-06-05,07:10,0,1,1
41,2023-06-05T07:10:00+10:00,2023-06-05,07:10,7,1,8
47,2023-06-05T07:10:00+10:00,2023-06-05,07:10,1,2,3
59,2023-06-05T07:10:00+10:00,2023-06-05,07:10,7,6,13
66,2023-06-05T07:10:00+10:00,2023-06-05,07:10,0,1,1
87,2023-06-05T07:10:00+10:00,2023-06-05,07:10,0,1,1
24,2023-06-05T07:10:00+10:00,2023-06-05,07:10,4,2,6
56,2023-06-05T07:10:00+10:00,2023-06-05,07:10,1,0,1
72,2023-06-05T07:10:00+10:00,2023-06-05,07:10,0,1,1
86,2023-06-05T07:10:00+10:00,2023-06-05,07:10,0,1,1
109,2023-06-05T07:10:00+10:00,2023-06-05,07:10,2,19,21
14,2023-06-05T07:10:00+10:00,2023-06-05,07:10,2,3,5
21,2023-06-05T07:10:00+10:00,2023-06-05,07:10,2,1,3
26,2023-06-05T07:10:00+10:00,2023-06-05,07:10,1,1,2
29,2023-06-05T07:10:00+10:00,2023-06-05,07:10,1,2,3
36,2023-06-05T07:10:00+10:00,2023-06-05,07:10,1,0,1
39,2023-06-05T07:10:00+10:00,2023-06-05,07:10,0,1,1
45,2023-06-05T07:10:00+10:00,2023-06-05,07:10,0,2,2
70,2023-06-05T07:10:00+10:00,2023-06-05,07:10,0,1,1
77,2023-06-05T07:10:00+10:00,2023-06-05,07:10,1,2,3
84,2023-06-05T07:10:00+10:00,2023-06-05,07:10,19,20,39
108,2023-06-05T07:10:00+10:00,2023-06-05,07:10,0,2,2
9,2023-06-05T07:10:00+10:00,2023-06-05,07:10,0,14,14
12,2023-06-05T07:10:00+10:00,2023-06-05,07:10,0,1,1
27,2023-06-05T07:10:00+10:00,2023-06-05,07:10,0,2,2
35,2023-06-05T07:10:00+10:00,2023-06-05,07:10,3,2,5
53,2023-06-05T07:10:00+10:00,2023-06-05,07:10,0,1,1
67,2023-06-05T07:10:00+10:00,2023-06-05,07:10,3,3,6
79,2023-06-05T07:10:00+10:00,2023-06-05,07:10,1,0,1
6,2023-06-05T07:10:00+10:00,2023-06-05,07:10,3,1,4
69,2023-06-05T07:10:00+10:00,2023-06-05,07:10,2,0,2
71,2023-06-05T07:10:00+10:00,2023-06-05,07:10,0,2,2
107,2023-06-05T07:10:00+10:00,2023-06-05,07:10,3,7,10
1,2023-06-05T07:10:00+10:00,2023-06-05,07:10,1,1,2
10,2023-06-05T07:10:00+10:00,2023-06-05,07:10,0,4,4
17,2023-06-05T07:10:00+10:00,2023-06-05,07:10,2,1,3
18,2023-06-05T07:10:00+10:00,2023-06-05,07:10,0,2,2
23,2023-06-05T07:10:00+10:00,2023-06-05,07:10,1,2,3
52,2023-06-05T07:10:00+10:00,2023-06-05,07:10,0,2,2
57,2023-06-05T07:10:00+10:00,2023-06-05,07:10,4,5,9
58,2023-06-05T07:10:00+10:00,2023-06-05,07:10,5,0,5
117,2023-06-05T07:10:00+10:00,2023-06-05,07:10,8,5,13
5,2023-06-05T07:09:00+10:00,2023-06-05,07:09,1,4,5
6,2023-06-05T07:09:00+10:00,2023-06-05,07:09,3,3,6
28,2023-06-05T07:09:00+10:00,2023-06-05,07:09,4,0,4
29,2023-06-05T07:09:00+10:00,2023-06-05,07:09,2,0,2
41,2023-06-05T07:09:00+10:00,2023-06-05,07:09,1,4,5
42,2023-06-05T07:09:00+10:00,2023-06-05,07:09,1,0,1
55,2023-06-05T07:09:00+10:00,2023-06-05,07:09,2,3,5
71,2023-06-05T07:09:00+10:00,2023-06-05,07:09,0,6,6
77,2023-06-05T07:09:00+10:00,2023-06-05,07:09,1,0,1
12,2023-06-05T07:09:00+10:00,2023-06-05,07:09,2,0,2
48,2023-06-05T07:09:00+10:00,2023-06-05,07:09,2,0,2
53,2023-06-05T07:09:00+10:00,2023-06-05,07:09,3,0,3
79,2023-06-05T07:09:00+10:00,2023-06-05,07:09,3,0,3
4,2023-06-05T07:09:00+10:00,2023-06-05,07:09,2,1,3
8,2023-06-05T07:09:00+10:00,2023-06-05,07:09,1,0,1
14,2023-06-05T07:09:00+10:00,2023-06-05,07:09,3,1,4
65,2023-06-05T07:09:00+10:00,2023-06-05,07:09,1,1,2
70,2023-06-05T07:09:00+10:00,2023-06-05,07:09,0,1,1
108,2023-06-05T07:09:00+10:00,2023-06-05,07:09,0,4,4
9,2023-06-05T07:09:00+10:00,2023-06-05,07:09,1,14,15
23,2023-06-05T07:09:00+10:00,2023-06-05,07:09,8,1,9
35,2023-06-05T07:09:00+10:00,2023-06-05,07:09,6,2,8
49,2023-06-05T07:09:00+10:00,2023-06-05,07:09,1,1,2
51,2023-06-05T07:09:00+10:00,2023-06-05,07:09,2,0,2
37,2023-06-05T07:09:00+10:00,2023-06-05,07:09,1,0,1
45,2023-06-05T07:09:00+10:00,2023-06-05,07:09,3,0,3
47,2023-06-05T07:09:00+10:00,2023-06-05,07:09,1,0,1
54,2023-06-05T07:09:00+10:00,2023-06-05,07:09,5,1,6
61,2023-06-05T07:09:00+10:00,2023-06-05,07:09,1,3,4
66,2023-06-05T07:09:00+10:00,2023-06-05,07:09,0,2,2
1,2023-06-05T07:09:00+10:00,2023-06-05,07:09,1,0,1
10,2023-06-05T07:09:00+10:00,2023-06-05,07:09,0,1,1
17,2023-06-05T07:09:00+10:00,2023-06-05,07:09,2,1,3
18,2023-06-05T07:09:00+10:00,2023-06-05,07:09,0,1,1
24,2023-06-05T07:09:00+10:00,2023-06-05,07:09,19,7,26
27,2023-06-05T07:09:00+10:00,2023-06-05,07:09,0,1,1
30,2023-06-05T07:09:00+10:00,2023-06-05,07:09,1,0,1
52,2023-06-05T07:09:00+10:00,2023-06-05,07:09,1,0,1
57,2023-06-05T07:09:00+10:00,2023-06-05,07:09,4,2,6
58,2023-06-05T07:09:00+10:00,2023-06-05,07:09,7,2,9
67,2023-06-05T07:09:00+10:00,2023-06-05,07:09,2,2,4
72,2023-06-05T07:09:00+10:00,2023-06-05,07:09,2,4,6
3,2023-06-05T07:08:00+10:00,2023-06-05,07:08,0,3,3
5,2023-06-05T07:08:00+10:00,2023-06-05,07:08,3,7,10
14,2023-06-05T07:08:00+10:00,2023-06-05,07:08,1,2,3
28,2023-06-05T07:08:00+10:00,2023-06-05,07:08,4,0,4
36,2023-06-05T07:08:00+10:00,2023-06-05,07:08,2,0,2
40,2023-06-05T07:08:00+10:00,2023-06-05,07:08,2,3,5
65,2023-06-05T07:08:00+10:00,2023-06-05,07:08,3,0,3
71,2023-06-05T07:08:00+10:00,2023-06-05,07:08,0,8,8
75,2023-06-05T07:08:00+10:00,2023-06-05,07:08,2,0,2
77,2023-06-05T07:08:00+10:00,2023-06-05,07:08,0,1,1
18,2023-06-05T07:08:00+10:00,2023-06-05,07:08,2,4,6
23,2023-06-05T07:08:00+10:00,2023-06-05,07:08,5,3,8
24,2023-06-05T07:08:00+10:00,2023-06-05,07:08,24,1,25
35,2023-06-05T07:08:00+10:00,2023-06-05,07:08,3,4,7
57,2023-06-05T07:08:00+10:00,2023-06-05,07:08,2,6,8
72,2023-06-05T07:08:00+10:00,2023-06-05,07:08,3,1,4
76,2023-06-05T07:08:00+10:00,2023-06-05,07:08,1,0,1
4,2023-06-05T07:08:00+10:00,2023-06-05,07:08,2,0,2
6,2023-06-05T07:08:00+10:00,2023-06-05,07:08,2,2,4
21,2023-06-05T07:08:00+10:00,2023-06-05,07:08,1,2,3
29,2023-06-05T07:08:00+10:00,2023-06-05,07:08,0,2,2
39,2023-06-05T07:08:00+10:00,2023-06-05,07:08,1,0,1
44,2023-06-05T07:08:00+10:00,2023-06-05,07:08,1,1,2
55,2023-06-05T07:08:00+10:00,2023-06-05,07:08,0,5,5
66,2023-06-05T07:08:00+10:00,2023-06-05,07:08,0,1,1
9,2023-06-05T07:08:00+10:00,2023-06-05,07:08,0,7,7
51,2023-06-05T07:08:00+10:00,2023-06-05,07:08,1,0,1
58,2023-06-05T07:08:00+10:00,2023-06-05,07:08,18,3,21
26,2023-06-05T07:08:00+10:00,2023-06-05,07:08,1,1,2
37,2023-06-05T07:08:00+10:00,2023-06-05,07:08,0,1,1
41,2023-06-05T07:08:00+10:00,2023-06-05,07:08,4,5,9
47,2023-06-05T07:08:00+10:00,2023-06-05,07:08,1,1,2
61,2023-06-05T07:08:00+10:00,2023-06-05,07:08,3,1,4
108,2023-06-05T07:08:00+10:00,2023-06-05,07:08,0,15,15
10,2023-06-05T07:08:00+10:00,2023-06-05,07:08,0,3,3
30,2023-06-05T07:08:00+10:00,2023-06-05,07:08,0,5,5
46,2023-06-05T07:08:00+10:00,2023-06-05,07:08,1,0,1
48,2023-06-05T07:08:00+10:00,2023-06-05,07:08,1,0,1
53,2023-06-05T07:08:00+10:00,2023-06-05,07:08,1,0,1
62,2023-06-05T07:08:00+10:00,2023-06-05,07:08,0,1,1
79,2023-06-05T07:08:00+10:00,2023-06-05,07:08,5,4,9
85,2023-06-05T07:08:00+10:00,2023-06-05,07:08,1,0,1
4,2023-06-05T07:07:00+10:00,2023-06-05,07:07,0,1,1
5,2023-06-05T07:07:00+10:00,2023-06-05,07:07,0,4,4
14,2023-06-05T07:07:00+10:00,2023-06-05,07:07,0,2,2
21,2023-06-05T07:07:00+10:00,2023-06-05,07:07,0,2,2
42,2023-06-05T07:07:00+10:00,2023-06-05,07:07,2,1,3
45,2023-06-05T07:07:00+10:00,2023-06-05,07:07,0,2,2
55,2023-06-05T07:07:00+10:00,2023-06-05,07:07,3,2,5
61,2023-06-05T07:07:00+10:00,2023-06-05,07:07,1,0,1
108,2023-06-05T07:07:00+10:00,2023-06-05,07:07,0,8,8
2,2023-06-05T07:07:00+10:00,2023-06-05,07:07,1,1,2
9,2023-06-05T07:07:00+10:00,2023-06-05,07:07,0,8,8
17,2023-06-05T07:07:00+10:00,2023-06-05,07:07,1,1,2
27,2023-06-05T07:07:00+10:00,2023-06-05,07:07,2,0,2
30,2023-06-05T07:07:00+10:00,2023-06-05,07:07,1,0,1
49,2023-06-05T07:07:00+10:00,2023-06-05,07:07,0,3,3
62,2023-06-05T07:07:00+10:00,2023-06-05,07:07,2,0,2
79,2023-06-05T07:07:00+10:00,2023-06-05,07:07,2,2,4
3,2023-06-05T07:07:00+10:00,2023-06-05,07:07,0,1,1
26,2023-06-05T07:07:00+10:00,2023-06-05,07:07,1,0,1
75,2023-06-05T07:07:00+10:00,2023-06-05,07:07,1,1,2
10,2023-06-05T07:07:00+10:00,2023-06-05,07:07,0,1,1
12,2023-06-05T07:07:00+10:00,2023-06-05,07:07,1,0,1
18,2023-06-05T07:07:00+10:00,2023-06-05,07:07,0,2,2
23,2023-06-05T07:07:00+10:00,2023-06-05,07:07,3,3,6
24,2023-06-05T07:07:00+10:00,2023-06-05,07:07,7,13,20
35,2023-06-05T07:07:00+10:00,2023-06-05,07:07,1,1,2
53,2023-06-05T07:07:00+10:00,2023-06-05,07:07,2,0,2
67,2023-06-05T07:07:00+10:00,2023-06-05,07:07,0,3,3
68,2023-06-05T07:07:00+10:00,2023-06-05,07:07,1,0,1
6,2023-06-05T07:07:00+10:00,2023-06-05,07:07,4,3,7
28,2023-06-05T07:07:00+10:00,2023-06-05,07:07,6,2,8
29,2023-06-05T07:07:00+10:00,2023-06-05,07:07,0,1,1
31,2023-06-05T07:07:00+10:00,2023-06-05,07:07,1,1,2
36,2023-06-05T07:07:00+10:00,2023-06-05,07:07,1,4,5
40,2023-06-05T07:07:00+10:00,2023-06-05,07:07,1,6,7
41,2023-06-05T07:07:00+10:00,2023-06-05,07:07,5,3,8
47,2023-06-05T07:07:00+10:00,2023-06-05,07:07,0,5,5
50,2023-06-05T07:07:00+10:00,2023-06-05,07:07,0,1,1
65,2023-06-05T07:07:00+10:00,2023-06-05,07:07,3,0,3
66,2023-06-05T07:07:00+10:00,2023-06-05,07:07,2,4,6
71,2023-06-05T07:07:00+10:00,2023-06-05,07:07,0,5,5
87,2023-06-05T07:07:00+10:00,2023-06-05,07:07,1,0,1
1,2023-06-05T07:07:00+10:00,2023-06-05,07:07,2,0,2
11,2023-06-05T07:07:00+10:00,2023-06-05,07:07,1,0,1
57,2023-06-05T07:07:00+10:00,2023-06-05,07:07,2,5,7
58,2023-06-05T07:07:00+10:00,2023-06-05,07:07,0,1,1
72,2023-06-05T07:07:00+10:00,2023-06-05,07:07,0,1,1
76,2023-06-05T07:07:00+10:00,2023-06-05,07:07,0,1,1
85,2023-06-05T07:07:00+10:00,2023-06-05,07:07,0,1,1
5,2023-06-05T07:06:00+10:00,2023-06-05,07:06,0,6,6
6,2023-06-05T07:06:00+10:00,2023-06-05,07:06,4,2,6
8,2023-06-05T07:06:00+10:00,2023-06-05,07:06,1,1,2
14,2023-06-05T07:06:00+10:00,2023-06-05,07:06,0,1,1
47,2023-06-05T07:06:00+10:00,2023-06-05,07:06,4,6,10
54,2023-06-05T07:06:00+10:00,2023-06-05,07:06,1,0,1
75,2023-06-05T07:06:00+10:00,2023-06-05,07:06,0,1,1
108,2023-06-05T07:06:00+10:00,2023-06-05,07:06,0,2,2
10,2023-06-05T07:06:00+10:00,2023-06-05,07:06,0,1,1
17,2023-06-05T07:06:00+10:00,2023-06-05,07:06,3,2,5
19,2023-06-05T07:06:00+10:00,2023-06-05,07:06,2,2,4
35,2023-06-05T07:06:00+10:00,2023-06-05,07:06,3,3,6
52,2023-06-05T07:06:00+10:00,2023-06-05,07:06,1,2,3
57,2023-06-05T07:06:00+10:00,2023-06-05,07:06,4,16,20
79,2023-06-05T07:06:00+10:00,2023-06-05,07:06,0,2,2
3,2023-06-05T07:06:00+10:00,2023-06-05,07:06,2,0,2
36,2023-06-05T07:06:00+10:00,2023-06-05,07:06,1,0,1
41,2023-06-05T07:06:00+10:00,2023-06-05,07:06,14,4,18
42,2023-06-05T07:06:00+10:00,2023-06-05,07:06,1,2,3
65,2023-06-05T07:06:00+10:00,2023-06-05,07:06,5,1,6
69,2023-06-05T07:06:00+10:00,2023-06-05,07:06,1,1,2
77,2023-06-05T07:06:00+10:00,2023-06-05,07:06,0,1,1
87,2023-06-05T07:06:00+10:00,2023-06-05,07:06,1,0,1
1,2023-06-05T07:06:00+10:00,2023-06-05,07:06,0,1,1
9,2023-06-05T07:06:00+10:00,2023-06-05,07:06,0,4,4
20,2023-06-05T07:06:00+10:00,2023-06-05,07:06,1,0,1
23,2023-06-05T07:06:00+10:00,2023-06-05,07:06,1,0,1
24,2023-06-05T07:06:00+10:00,2023-06-05,07:06,19,4,23
49,2023-06-05T07:06:00+10:00,2023-06-05,07:06,2,0,2
62,2023-06-05T07:06:00+10:00,2023-06-05,07:06,1,0,1
67,2023-06-05T07:06:00+10:00,2023-06-05,07:06,1,1,2
4,2023-06-05T07:06:00+10:00,2023-06-05,07:06,4,0,4
28,2023-06-05T07:06:00+10:00,2023-06-05,07:06,7,1,8
37,2023-06-05T07:06:00+10:00,2023-06-05,07:06,0,1,1
55,2023-06-05T07:06:00+10:00,2023-06-05,07:06,4,3,7
61,2023-06-05T07:06:00+10:00,2023-06-05,07:06,1,1,2
66,2023-06-05T07:06:00+10:00,2023-06-05,07:06,1,1,2
71,2023-06-05T07:06:00+10:00,2023-06-05,07:06,0,8,8
2,2023-06-05T07:06:00+10:00,2023-06-05,07:06,3,0,3
12,2023-06-05T07:06:00+10:00,2023-06-05,07:06,0,1,1
18,2023-06-05T07:06:00+10:00,2023-06-05,07:06,0,1,1
51,2023-06-05T07:06:00+10:00,2023-06-05,07:06,2,0,2
53,2023-06-05T07:06:00+10:00,2023-06-05,07:06,2,1,3
58,2023-06-05T07:06:00+10:00,2023-06-05,07:06,7,0,7
72,2023-06-05T07:06:00+10:00,2023-06-05,07:06,0,3,3
14,2023-06-05T07:05:00+10:00,2023-06-05,07:05,0,2,2
42,2023-06-05T07:05:00+10:00,2023-06-05,07:05,1,0,1
44,2023-06-05T07:05:00+10:00,2023-06-05,07:05,0,1,1
47,2023-06-05T07:05:00+10:00,2023-06-05,07:05,1,5,6
66,2023-06-05T07:05:00+10:00,2023-06-05,07:05,3,3,6
69,2023-06-05T07:05:00+10:00,2023-06-05,07:05,2,0,2
75,2023-06-05T07:05:00+10:00,2023-06-05,07:05,1,0,1
2,2023-06-05T07:05:00+10:00,2023-06-05,07:05,1,1,2
10,2023-06-05T07:05:00+10:00,2023-06-05,07:05,0,1,1
12,2023-06-05T07:05:00+10:00,2023-06-05,07:05,1,0,1
20,2023-06-05T07:05:00+10:00,2023-06-05,07:05,1,0,1
27,2023-06-05T07:05:00+10:00,2023-06-05,07:05,1,0,1
35,2023-06-05T07:05:00+10:00,2023-06-05,07:05,1,6,7
56,2023-06-05T07:05:00+10:00,2023-06-05,07:05,1,1,2
67,2023-06-05T07:05:00+10:00,2023-06-05,07:05,3,0,3
86,2023-06-05T07:05:00+10:00,2023-06-05,07:05,1,2,3
109,2023-06-05T07:05:00+10:00,2023-06-05,07:05,2,11,13
4,2023-06-05T07:05:00+10:00,2023-06-05,07:05,3,2,5
6,2023-06-05T07:05:00+10:00,2023-06-05,07:05,1,1,2
8,2023-06-05T07:05:00+10:00,2023-06-05,07:05,1,0,1
21,2023-06-05T07:05:00+10:00,2023-06-05,07:05,0,1,1
26,2023-06-05T07:05:00+10:00,2023-06-05,07:05,3,0,3
45,2023-06-05T07:05:00+10:00,2023-06-05,07:05,1,0,1
55,2023-06-05T07:05:00+10:00,2023-06-05,07:05,0,3,3
59,2023-06-05T07:05:00+10:00,2023-06-05,07:05,5,3,8
77,2023-06-05T07:05:00+10:00,2023-06-05,07:05,0,1,1
84,2023-06-05T07:05:00+10:00,2023-06-05,07:05,34,14,48
107,2023-06-05T07:05:00+10:00,2023-06-05,07:05,2,3,5
1,2023-06-05T07:05:00+10:00,2023-06-05,07:05,2,1,3
9,2023-06-05T07:05:00+10:00,2023-06-05,07:05,0,12,12
19,2023-06-05T07:05:00+10:00,2023-06-05,07:05,1,0,1
23,2023-06-05T07:05:00+10:00,2023-06-05,07:05,2,0,2
53,2023-06-05T07:05:00+10:00,2023-06-05,07:05,1,1,2
62,2023-06-05T07:05:00+10:00,2023-06-05,07:05,3,0,3
117,2023-06-05T07:05:00+10:00,2023-06-05,07:05,4,2,6
3,2023-06-05T07:05:00+10:00,2023-06-05,07:05,1,1,2
5,2023-06-05T07:05:00+10:00,2023-06-05,07:05,2,4,6
28,2023-06-05T07:05:00+10:00,2023-06-05,07:05,2,0,2
29,2023-06-05T07:05:00+10:00,2023-06-05,07:05,2,0,2
31,2023-06-05T07:05:00+10:00,2023-06-05,07:05,1,0,1
40,2023-06-05T07:05:00+10:00,2023-06-05,07:05,1,0,1
41,2023-06-05T07:05:00+10:00,2023-06-05,07:05,8,0,8
65,2023-06-05T07:05:00+10:00,2023-06-05,07:05,0,1,1
71,2023-06-05T07:05:00+10:00,2023-06-05,07:05,1,5,6
87,2023-06-05T07:05:00+10:00,2023-06-05,07:05,1,0,1
108,2023-06-05T07:05:00+10:00,2023-06-05,07:05,0,7,7
17,2023-06-05T07:05:00+10:00,2023-06-05,07:05,10,0,10
18,2023-06-05T07:05:00+10:00,2023-06-05,07:05,0,1,1
24,2023-06-05T07:05:00+10:00,2023-06-05,07:05,13,0,13
49,2023-06-05T07:05:00+10:00,2023-06-05,07:05,1,0,1
57,2023-06-05T07:05:00+10:00,2023-06-05,07:05,3,6,9
58,2023-06-05T07:05:00+10:00,2023-06-05,07:05,7,2,9
72,2023-06-05T07:05:00+10:00,2023-06-05,07:05,2,1,3
79,2023-06-05T07:05:00+10:00,2023-06-05,07:05,0,1,1
4,2023-06-05T07:04:00+10:00,2023-06-05,07:04,1,3,4
6,2023-06-05T07:04:00+10:00,2023-06-05,07:04,2,9,11
37,2023-06-05T07:04:00+10:00,2023-06-05,07:04,0,1,1
41,2023-06-05T07:04:00+10:00,2023-06-05,07:04,14,1,15
42,2023-06-05T07:04:00+10:00,2023-06-05,07:04,0,1,1
47,2023-06-05T07:04:00+10:00,2023-06-05,07:04,0,2,2
55,2023-06-05T07:04:00+10:00,2023-06-05,07:04,2,1,3
108,2023-06-05T07:04:00+10:00,2023-06-05,07:04,2,2,4
2,2023-06-05T07:04:00+10:00,2023-06-05,07:04,1,0,1
9,2023-06-05T07:04:00+10:00,2023-06-05,07:04,0,8,8
12,2023-06-05T07:04:00+10:00,2023-06-05,07:04,0,1,1
18,2023-06-05T07:04:00+10:00,2023-06-05,07:04,0,11,11
20,2023-06-05T07:04:00+10:00,2023-06-05,07:04,1,2,3
49,2023-06-05T07:04:00+10:00,2023-06-05,07:04,2,0,2
52,2023-06-05T07:04:00+10:00,2023-06-05,07:04,1,0,1
53,2023-06-05T07:04:00+10:00,2023-06-05,07:04,2,1,3
58,2023-06-05T07:04:00+10:00,2023-06-05,07:04,6,1,7
62,2023-06-05T07:04:00+10:00,2023-06-05,07:04,1,0,1
67,2023-06-05T07:04:00+10:00,2023-06-05,07:04,4,2,6
21,2023-06-05T07:04:00+10:00,2023-06-05,07:04,1,1,2
26,2023-06-05T07:04:00+10:00,2023-06-05,07:04,4,2,6
28,2023-06-05T07:04:00+10:00,2023-06-05,07:04,1,0,1
29,2023-06-05T07:04:00+10:00,2023-06-05,07:04,0,1,1
31,2023-06-05T07:04:00+10:00,2023-06-05,07:04,0,2,2
40,2023-06-05T07:04:00+10:00,2023-06-05,07:04,0,3,3
54,2023-06-05T07:04:00+10:00,2023-06-05,07:04,2,0,2
65,2023-06-05T07:04:00+10:00,2023-06-05,07:04,1,0,1
71,2023-06-05T07:04:00+10:00,2023-06-05,07:04,2,4,6
75,2023-06-05T07:04:00+10:00,2023-06-05,07:04,2,0,2
77,2023-06-05T07:04:00+10:00,2023-06-05,07:04,0,1,1
17,2023-06-05T07:04:00+10:00,2023-06-05,07:04,5,0,5
23,2023-06-05T07:04:00+10:00,2023-06-05,07:04,1,1,2
35,2023-06-05T07:04:00+10:00,2023-06-05,07:04,5,7,12
72,2023-06-05T07:04:00+10:00,2023-06-05,07:04,0,1,1
3,2023-06-05T07:04:00+10:00,2023-06-05,07:04,0,2,2
5,2023-06-05T07:04:00+10:00,2023-06-05,07:04,1,5,6
8,2023-06-05T07:04:00+10:00,2023-06-05,07:04,2,0,2
45,2023-06-05T07:04:00+10:00,2023-06-05,07:04,1,4,5
70,2023-06-05T07:04:00+10:00,2023-06-05,07:04,0,1,1
1,2023-06-05T07:04:00+10:00,2023-06-05,07:04,0,3,3
24,2023-06-05T07:04:00+10:00,2023-06-05,07:04,6,1,7
48,2023-06-05T07:04:00+10:00,2023-06-05,07:04,0,2,2
57,2023-06-05T07:04:00+10:00,2023-06-05,07:04,3,2,5
76,2023-06-05T07:04:00+10:00,2023-06-05,07:04,0,1,1
79,2023-06-05T07:04:00+10:00,2023-06-05,07:04,4,4,8
3,2023-06-05T07:03:00+10:00,2023-06-05,07:03,4,1,5
4,2023-06-05T07:03:00+10:00,2023-06-05,07:03,0,1,1
6,2023-06-05T07:03:00+10:00,2023-06-05,07:03,3,6,9
21,2023-06-05T07:03:00+10:00,2023-06-05,07:03,2,0,2
39,2023-06-05T07:03:00+10:00,2023-06-05,07:03,0,1,1
42,2023-06-05T07:03:00+10:00,2023-06-05,07:03,0,1,1
55,2023-06-05T07:03:00+10:00,2023-06-05,07:03,1,3,4
65,2023-06-05T07:03:00+10:00,2023-06-05,07:03,1,0,1
71,2023-06-05T07:03:00+10:00,2023-06-05,07:03,4,3,7
77,2023-06-05T07:03:00+10:00,2023-06-05,07:03,1,2,3
17,2023-06-05T07:03:00+10:00,2023-06-05,07:03,4,1,5
24,2023-06-05T07:03:00+10:00,2023-06-05,07:03,13,2,15
48,2023-06-05T07:03:00+10:00,2023-06-05,07:03,2,0,2
58,2023-06-05T07:03:00+10:00,2023-06-05,07:03,11,0,11
5,2023-06-05T07:03:00+10:00,2023-06-05,07:03,4,6,10
14,2023-06-05T07:03:00+10:00,2023-06-05,07:03,2,0,2
28,2023-06-05T07:03:00+10:00,2023-06-05,07:03,6,0,6
41,2023-06-05T07:03:00+10:00,2023-06-05,07:03,7,9,16
50,2023-06-05T07:03:00+10:00,2023-06-05,07:03,0,1,1
54,2023-06-05T07:03:00+10:00,2023-06-05,07:03,1,0,1
61,2023-06-05T07:03:00+10:00,2023-06-05,07:03,0,1,1
108,2023-06-05T07:03:00+10:00,2023-06-05,07:03,0,1,1
9,2023-06-05T07:03:00+10:00,2023-06-05,07:03,1,0,1
10,2023-06-05T07:03:00+10:00,2023-06-05,07:03,0,1,1
18,2023-06-05T07:03:00+10:00,2023-06-05,07:03,0,1,1
23,2023-06-05T07:03:00+10:00,2023-06-05,07:03,5,4,9
30,2023-06-05T07:03:00+10:00,2023-06-05,07:03,1,0,1
35,2023-06-05T07:03:00+10:00,2023-06-05,07:03,3,3,6
72,2023-06-05T07:03:00+10:00,2023-06-05,07:03,3,2,5
76,2023-06-05T07:03:00+10:00,2023-06-05,07:03,1,0,1
79,2023-06-05T07:03:00+10:00,2023-06-05,07:03,1,1,2
47,2023-06-05T07:03:00+10:00,2023-06-05,07:03,0,1,1
66,2023-06-05T07:03:00+10:00,2023-06-05,07:03,3,1,4
75,2023-06-05T07:03:00+10:00,2023-06-05,07:03,1,0,1
12,2023-06-05T07:03:00+10:00,2023-06-05,07:03,1,0,1
27,2023-06-05T07:03:00+10:00,2023-06-05,07:03,1,0,1
46,2023-06-05T07:03:00+10:00,2023-06-05,07:03,1,0,1
49,2023-06-05T07:03:00+10:00,2023-06-05,07:03,0,1,1
53,2023-06-05T07:03:00+10:00,2023-06-05,07:03,1,0,1
57,2023-06-05T07:03:00+10:00,2023-06-05,07:03,4,8,12
67,2023-06-05T07:03:00+10:00,2023-06-05,07:03,3,1,4
86,2023-06-05T07:03:00+10:00,2023-06-05,07:03,1,0,1
4,2023-06-05T07:02:00+10:00,2023-06-05,07:02,1,0,1
6,2023-06-05T07:02:00+10:00,2023-06-05,07:02,4,6,10
14,2023-06-05T07:02:00+10:00,2023-06-05,07:02,0,1,1
21,2023-06-05T07:02:00+10:00,2023-06-05,07:02,0,2,2
29,2023-06-05T07:02:00+10:00,2023-06-05,07:02,0,2,2
45,2023-06-05T07:02:00+10:00,2023-06-05,07:02,1,2,3
55,2023-06-05T07:02:00+10:00,2023-06-05,07:02,1,0,1
1,2023-06-05T07:02:00+10:00,2023-06-05,07:02,0,1,1
9,2023-06-05T07:02:00+10:00,2023-06-05,07:02,2,1,3
18,2023-06-05T07:02:00+10:00,2023-06-05,07:02,0,1,1
30,2023-06-05T07:02:00+10:00,2023-06-05,07:02,0,1,1
35,2023-06-05T07:02:00+10:00,2023-06-05,07:02,3,12,15
79,2023-06-05T07:02:00+10:00,2023-06-05,07:02,1,2,3
26,2023-06-05T07:02:00+10:00,2023-06-05,07:02,2,0,2
28,2023-06-05T07:02:00+10:00,2023-06-05,07:02,5,0,5
36,2023-06-05T07:02:00+10:00,2023-06-05,07:02,1,1,2
39,2023-06-05T07:02:00+10:00,2023-06-05,07:02,1,0,1
54,2023-06-05T07:02:00+10:00,2023-06-05,07:02,2,0,2
61,2023-06-05T07:02:00+10:00,2023-06-05,07:02,0,1,1
65,2023-06-05T07:02:00+10:00,2023-06-05,07:02,4,3,7
70,2023-06-05T07:02:00+10:00,2023-06-05,07:02,1,0,1
77,2023-06-05T07:02:00+10:00,2023-06-05,07:02,1,0,1
12,2023-06-05T07:02:00+10:00,2023-06-05,07:02,1,0,1
20,2023-06-05T07:02:00+10:00,2023-06-05,07:02,0,1,1
23,2023-06-05T07:02:00+10:00,2023-06-05,07:02,0,2,2
24,2023-06-05T07:02:00+10:00,2023-06-05,07:02,5,5,10
27,2023-06-05T07:02:00+10:00,2023-06-05,07:02,0,2,2
46,2023-06-05T07:02:00+10:00,2023-06-05,07:02,0,1,1
48,2023-06-05T07:02:00+10:00,2023-06-05,07:02,1,1,2
58,2023-06-05T07:02:00+10:00,2023-06-05,07:02,2,0,2
72,2023-06-05T07:02:00+10:00,2023-06-05,07:02,0,1,1
86,2023-06-05T07:02:00+10:00,2023-06-05,07:02,1,0,1
3,2023-06-05T07:02:00+10:00,2023-06-05,07:02,0,2,2
5,2023-06-05T07:02:00+10:00,2023-06-05,07:02,2,3,5
40,2023-06-05T07:02:00+10:00,2023-06-05,07:02,1,2,3
41,2023-06-05T07:02:00+10:00,2023-06-05,07:02,6,0,6
47,2023-06-05T07:02:00+10:00,2023-06-05,07:02,1,2,3
66,2023-06-05T07:02:00+10:00,2023-06-05,07:02,0,3,3
71,2023-06-05T07:02:00+10:00,2023-06-05,07:02,0,2,2
108,2023-06-05T07:02:00+10:00,2023-06-05,07:02,1,0,1
2,2023-06-05T07:02:00+10:00,2023-06-05,07:02,0,1,1
10,2023-06-05T07:02:00+10:00,2023-06-05,07:02,0,1,1
17,2023-06-05T07:02:00+10:00,2023-06-05,07:02,0,1,1
51,2023-06-05T07:02:00+10:00,2023-06-05,07:02,2,0,2
53,2023-06-05T07:02:00+10:00,2023-06-05,07:02,1,0,1
62,2023-06-05T07:02:00+10:00,2023-06-05,07:02,1,0,1
68,2023-06-05T07:02:00+10:00,2023-06-05,07:02,3,0,3
85,2023-06-05T07:02:00+10:00,2023-06-05,07:02,1,0,1
4,2023-06-05T07:01:00+10:00,2023-06-05,07:01,4,0,4
6,2023-06-05T07:01:00+10:00,2023-06-05,07:01,2,4,6
39,2023-06-05T07:01:00+10:00,2023-06-05,07:01,1,0,1
45,2023-06-05T07:01:00+10:00,2023-06-05,07:01,0,1,1
1,2023-06-05T07:01:00+10:00,2023-06-05,07:01,2,0,2
10,2023-06-05T07:01:00+10:00,2023-06-05,07:01,0,2,2
12,2023-06-05T07:01:00+10:00,2023-06-05,07:01,1,0,1
17,2023-06-05T07:01:00+10:00,2023-06-05,07:01,2,0,2
24,2023-06-05T07:01:00+10:00,2023-06-05,07:01,6,6,12
35,2023-06-05T07:01:00+10:00,2023-06-05,07:01,2,3,5
57,2023-06-05T07:01:00+10:00,2023-06-05,07:01,2,1,3
85,2023-06-05T07:01:00+10:00,2023-06-05,07:01,2,0,2
26,2023-06-05T07:01:00+10:00,2023-06-05,07:01,1,1,2
28,2023-06-05T07:01:00+10:00,2023-06-05,07:01,4,0,4
29,2023-06-05T07:01:00+10:00,2023-06-05,07:01,1,1,2
31,2023-06-05T07:01:00+10:00,2023-06-05,07:01,1,0,1
40,2023-06-05T07:01:00+10:00,2023-06-05,07:01,1,1,2
41,2023-06-05T07:01:00+10:00,2023-06-05,07:01,9,0,9
65,2023-06-05T07:01:00+10:00,2023-06-05,07:01,1,0,1
66,2023-06-05T07:01:00+10:00,2023-06-05,07:01,1,1,2
69,2023-06-05T07:01:00+10:00,2023-06-05,07:01,3,1,4
71,2023-06-05T07:01:00+10:00,2023-06-05,07:01,1,1,2
75,2023-06-05T07:01:00+10:00,2023-06-05,07:01,1,0,1
78,2023-06-05T07:01:00+10:00,2023-06-05,07:01,1,0,1
108,2023-06-05T07:01:00+10:00,2023-06-05,07:01,1,3,4
2,2023-06-05T07:01:00+10:00,2023-06-05,07:01,1,0,1
9,2023-06-05T07:01:00+10:00,2023-06-05,07:01,0,9,9
20,2023-06-05T07:01:00+10:00,2023-06-05,07:01,1,1,2
23,2023-06-05T07:01:00+10:00,2023-06-05,07:01,2,0,2
30,2023-06-05T07:01:00+10:00,2023-06-05,07:01,0,1,1
48,2023-06-05T07:01:00+10:00,2023-06-05,07:01,1,0,1
72,2023-06-05T07:01:00+10:00,2023-06-05,07:01,5,0,5
3,2023-06-05T07:01:00+10:00,2023-06-05,07:01,0,4,4
5,2023-06-05T07:01:00+10:00,2023-06-05,07:01,0,1,1
8,2023-06-05T07:01:00+10:00,2023-06-05,07:01,0,1,1
47,2023-06-05T07:01:00+10:00,2023-06-05,07:01,0,1,1
54,2023-06-05T07:01:00+10:00,2023-06-05,07:01,0,1,1
55,2023-06-05T07:01:00+10:00,2023-06-05,07:01,1,1,2
18,2023-06-05T07:01:00+10:00,2023-06-05,07:01,0,2,2
49,2023-06-05T07:01:00+10:00,2023-06-05,07:01,0,1,1
58,2023-06-05T07:01:00+10:00,2023-06-05,07:01,6,1,7
79,2023-06-05T07:01:00+10:00,2023-06-05,07:01,2,1,3
5,2023-06-05T07:00:00+10:00,2023-06-05,07:00,4,8,12
6,2023-06-05T07:00:00+10:00,2023-06-05,07:00,2,5,7
26,2023-06-05T07:00:00+10:00,2023-06-05,07:00,2,0,2
29,2023-06-05T07:00:00+10:00,2023-06-05,07:00,0,3,3
36,2023-06-05T07:00:00+10:00,2023-06-05,07:00,1,0,1
45,2023-06-05T07:00:00+10:00,2023-06-05,07:00,3,1,4
47,2023-06-05T07:00:00+10:00,2023-06-05,07:00,0,3,3
65,2023-06-05T07:00:00+10:00,2023-06-05,07:00,2,0,2
107,2023-06-05T07:00:00+10:00,2023-06-05,07:00,0,4,4
108,2023-06-05T07:00:00+10:00,2023-06-05,07:00,0,5,5
118,2023-06-05T07:00:00+10:00,2023-06-05,07:00,0,1,1
20,2023-06-05T07:00:00+10:00,2023-06-05,07:00,0,1,1
24,2023-06-05T07:00:00+10:00,2023-06-05,07:00,9,1,10
30,2023-06-05T07:00:00+10:00,2023-06-05,07:00,0,1,1
53,2023-06-05T07:00:00+10:00,2023-06-05,07:00,1,1,2
86,2023-06-05T07:00:00+10:00,2023-06-05,07:00,1,0,1
109,2023-06-05T07:00:00+10:00,2023-06-05,07:00,10,10,20
3,2023-06-05T07:00:00+10:00,2023-06-05,07:00,0,2,2
31,2023-06-05T07:00:00+10:00,2023-06-05,07:00,0,1,1
42,2023-06-05T07:00:00+10:00,2023-06-05,07:00,0,2,2
55,2023-06-05T07:00:00+10:00,2023-06-05,07:00,2,1,3
59,2023-06-05T07:00:00+10:00,2023-06-05,07:00,1,2,3
70,2023-06-05T07:00:00+10:00,2023-06-05,07:00,3,0,3
71,2023-06-05T07:00:00+10:00,2023-06-05,07:00,0,4,4
1,2023-06-05T07:00:00+10:00,2023-06-05,07:00,0,1,1
9,2023-06-05T07:00:00+10:00,2023-06-05,07:00,1,14,15
11,2023-06-05T07:00:00+10:00,2023-06-05,07:00,0,1,1
17,2023-06-05T07:00:00+10:00,2023-06-05,07:00,6,0,6
18,2023-06-05T07:00:00+10:00,2023-06-05,07:00,0,1,1
23,2023-06-05T07:00:00+10:00,2023-06-05,07:00,4,0,4
46,2023-06-05T07:00:00+10:00,2023-06-05,07:00,0,1,1
48,2023-06-05T07:00:00+10:00,2023-06-05,07:00,0,1,1
49,2023-06-05T07:00:00+10:00,2023-06-05,07:00,2,0,2
62,2023-06-05T07:00:00+10:00,2023-06-05,07:00,1,0,1
67,2023-06-05T07:00:00+10:00,2023-06-05,07:00,1,0,1
79,2023-06-05T07:00:00+10:00,2023-06-05,07:00,2,1,3
85,2023-06-05T07:00:00+10:00,2023-06-05,07:00,1,0,1
4,2023-06-05T07:00:00+10:00,2023-06-05,07:00,2,1,3
28,2023-06-05T07:00:00+10:00,2023-06-05,07:00,1,0,1
40,2023-06-05T07:00:00+10:00,2023-06-05,07:00,0,1,1
41,2023-06-05T07:00:00+10:00,2023-06-05,07:00,5,2,7
61,2023-06-05T07:00:00+10:00,2023-06-05,07:00,1,1,2
66,2023-06-05T07:00:00+10:00,2023-06-05,07:00,0,1,1
84,2023-06-05T07:00:00+10:00,2023-06-05,07:00,34,14,48
19,2023-06-05T07:00:00+10:00,2023-06-05,07:00,0,2,2
35,2023-06-05T07:00:00+10:00,2023-06-05,07:00,2,4,6
51,2023-06-05T07:00:00+10:00,2023-06-05,07:00,1,1,2
57,2023-06-05T07:00:00+10:00,2023-06-05,07:00,1,3,4
58,2023-06-05T07:00:00+10:00,2023-06-05,07:00,16,0,16
72,2023-06-05T07:00:00+10:00,2023-06-05,07:00,1,5,6
117,2023-06-05T07:00:00+10:00,2023-06-05,07:00,4,4,8
5,2023-06-05T06:59:00+10:00,2023-06-05,06:59,0,5,5
6,2023-06-05T06:59:00+10:00,2023-06-05,06:59,6,7,13
26,2023-06-05T06:59:00+10:00,2023-06-05,06:59,2,0,2
28,2023-06-05T06:59:00+10:00,2023-06-05,06:59,1,0,1
29,2023-06-05T06:59:00+10:00,2023-06-05,06:59,3,1,4
41,2023-06-05T06:59:00+10:00,2023-06-05,06:59,5,3,8
42,2023-06-05T06:59:00+10:00,2023-06-05,06:59,1,0,1
54,2023-06-05T06:59:00+10:00,2023-06-05,06:59,1,0,1
55,2023-06-05T06:59:00+10:00,2023-06-05,06:59,1,3,4
61,2023-06-05T06:59:00+10:00,2023-06-05,06:59,1,0,1
66,2023-06-05T06:59:00+10:00,2023-06-05,06:59,0,1,1
71,2023-06-05T06:59:00+10:00,2023-06-05,06:59,3,4,7
75,2023-06-05T06:59:00+10:00,2023-06-05,06:59,1,2,3
87,2023-06-05T06:59:00+10:00,2023-06-05,06:59,1,0,1
108,2023-06-05T06:59:00+10:00,2023-06-05,06:59,0,12,12
12,2023-06-05T06:59:00+10:00,2023-06-05,06:59,1,1,2
18,2023-06-05T06:59:00+10:00,2023-06-05,06:59,0,1,1
24,2023-06-05T06:59:00+10:00,2023-06-05,06:59,6,5,11
52,2023-06-05T06:59:00+10:00,2023-06-05,06:59,1,1,2
53,2023-06-05T06:59:00+10:00,2023-06-05,06:59,1,0,1
56,2023-06-05T06:59:00+10:00,2023-06-05,06:59,1,0,1
79,2023-06-05T06:59:00+10:00,2023-06-05,06:59,3,1,4
85,2023-06-05T06:59:00+10:00,2023-06-05,06:59,1,0,1
3,2023-06-05T06:59:00+10:00,2023-06-05,06:59,0,1,1
4,2023-06-05T06:59:00+10:00,2023-06-05,06:59,4,1,5
8,2023-06-05T06:59:00+10:00,2023-06-05,06:59,1,0,1
14,2023-06-05T06:59:00+10:00,2023-06-05,06:59,0,1,1
40,2023-06-05T06:59:00+10:00,2023-06-05,06:59,0,2,2
47,2023-06-05T06:59:00+10:00,2023-06-05,06:59,0,5,5
65,2023-06-05T06:59:00+10:00,2023-06-05,06:59,1,0,1
1,2023-06-05T06:59:00+10:00,2023-06-05,06:59,1,1,2
9,2023-06-05T06:59:00+10:00,2023-06-05,06:59,0,2,2
11,2023-06-05T06:59:00+10:00,2023-06-05,06:59,1,0,1
45,2023-06-05T06:59:00+10:00,2023-06-05,06:59,2,1,3
77,2023-06-05T06:59:00+10:00,2023-06-05,06:59,0,1,1
2,2023-06-05T06:59:00+10:00,2023-06-05,06:59,0,1,1
10,2023-06-05T06:59:00+10:00,2023-06-05,06:59,3,2,5
17,2023-06-05T06:59:00+10:00,2023-06-05,06:59,2,3,5
23,2023-06-05T06:59:00+10:00,2023-06-05,06:59,2,3,5
35,2023-06-05T06:59:00+10:00,2023-06-05,06:59,7,5,12
46,2023-06-05T06:59:00+10:00,2023-06-05,06:59,0,1,1
48,2023-06-05T06:59:00+10:00,2023-06-05,06:59,0,1,1
57,2023-06-05T06:59:00+10:00,2023-06-05,06:59,1,8,9
58,2023-06-05T06:59:00+10:00,2023-06-05,06:59,2,2,4
67,2023-06-05T06:59:00+10:00,2023-06-05,06:59,3,1,4
68,2023-06-05T06:59:00+10:00,2023-06-05,06:59,1,0,1
72,2023-06-05T06:59:00+10:00,2023-06-05,06:59,2,1,3
5,2023-06-05T06:58:00+10:00,2023-06-05,06:58,1,5,6
14,2023-06-05T06:58:00+10:00,2023-06-05,06:58,2,2,4
26,2023-06-05T06:58:00+10:00,2023-06-05,06:58,0,1,1
55,2023-06-05T06:58:00+10:00,2023-06-05,06:58,1,3,4
65,2023-06-05T06:58:00+10:00,2023-06-05,06:58,1,1,2
17,2023-06-05T06:58:00+10:00,2023-06-05,06:58,3,2,5
18,2023-06-05T06:58:00+10:00,2023-06-05,06:58,0,1,1
19,2023-06-05T06:58:00+10:00,2023-06-05,06:58,1,0,1
23,2023-06-05T06:58:00+10:00,2023-06-05,06:58,6,2,8
52,2023-06-05T06:58:00+10:00,2023-06-05,06:58,1,1,2
4,2023-06-05T06:58:00+10:00,2023-06-05,06:58,0,3,3
28,2023-06-05T06:58:00+10:00,2023-06-05,06:58,2,1,3
41,2023-06-05T06:58:00+10:00,2023-06-05,06:58,4,0,4
47,2023-06-05T06:58:00+10:00,2023-06-05,06:58,2,10,12
61,2023-06-05T06:58:00+10:00,2023-06-05,06:58,1,3,4
66,2023-06-05T06:58:00+10:00,2023-06-05,06:58,0,2,2
71,2023-06-05T06:58:00+10:00,2023-06-05,06:58,3,1,4
77,2023-06-05T06:58:00+10:00,2023-06-05,06:58,0,1,1
87,2023-06-05T06:58:00+10:00,2023-06-05,06:58,1,0,1
108,2023-06-05T06:58:00+10:00,2023-06-05,06:58,0,16,16
1,2023-06-05T06:58:00+10:00,2023-06-05,06:58,2,1,3
2,2023-06-05T06:58:00+10:00,2023-06-05,06:58,0,2,2
9,2023-06-05T06:58:00+10:00,2023-06-05,06:58,1,11,12
24,2023-06-05T06:58:00+10:00,2023-06-05,06:58,22,1,23
53,2023-06-05T06:58:00+10:00,2023-06-05,06:58,2,0,2
58,2023-06-05T06:58:00+10:00,2023-06-05,06:58,7,1,8
67,2023-06-05T06:58:00+10:00,2023-06-05,06:58,1,0,1
72,2023-06-05T06:58:00+10:00,2023-06-05,06:58,4,1,5
3,2023-06-05T06:58:00+10:00,2023-06-05,06:58,0,1,1
6,2023-06-05T06:58:00+10:00,2023-06-05,06:58,1,11,12
21,2023-06-05T06:58:00+10:00,2023-06-05,06:58,2,0,2
40,2023-06-05T06:58:00+10:00,2023-06-05,06:58,1,1,2
69,2023-06-05T06:58:00+10:00,2023-06-05,06:58,2,1,3
75,2023-06-05T06:58:00+10:00,2023-06-05,06:58,1,1,2
35,2023-06-05T06:58:00+10:00,2023-06-05,06:58,2,0,2
56,2023-06-05T06:58:00+10:00,2023-06-05,06:58,0,1,1
57,2023-06-05T06:58:00+10:00,2023-06-05,06:58,4,5,9
62,2023-06-05T06:58:00+10:00,2023-06-05,06:58,0,1,1
79,2023-06-05T06:58:00+10:00,2023-06-05,06:58,7,0,7
3,2023-06-05T06:57:00+10:00,2023-06-05,06:57,2,0,2
39,2023-06-05T06:57:00+10:00,2023-06-05,06:57,0,1,1
41,2023-06-05T06:57:00+10:00,2023-06-05,06:57,7,3,10
54,2023-06-05T06:57:00+10:00,2023-06-05,06:57,0,1,1
69,2023-06-05T06:57:00+10:00,2023-06-05,06:57,2,1,3
19,2023-06-05T06:57:00+10:00,2023-06-05,06:57,1,0,1
23,2023-06-05T06:57:00+10:00,2023-06-05,06:57,0,1,1
48,2023-06-05T06:57:00+10:00,2023-06-05,06:57,1,1,2
72,2023-06-05T06:57:00+10:00,2023-06-05,06:57,2,0,2
4,2023-06-05T06:57:00+10:00,2023-06-05,06:57,1,1,2
6,2023-06-05T06:57:00+10:00,2023-06-05,06:57,2,4,6
14,2023-06-05T06:57:00+10:00,2023-06-05,06:57,1,3,4
21,2023-06-05T06:57:00+10:00,2023-06-05,06:57,0,1,1
28,2023-06-05T06:57:00+10:00,2023-06-05,06:57,0,2,2
29,2023-06-05T06:57:00+10:00,2023-06-05,06:57,1,0,1
40,2023-06-05T06:57:00+10:00,2023-06-05,06:57,1,2,3
61,2023-06-05T06:57:00+10:00,2023-06-05,06:57,1,0,1
71,2023-06-05T06:57:00+10:00,2023-06-05,06:57,2,0,2
75,2023-06-05T06:57:00+10:00,2023-06-05,06:57,0,1,1
1,2023-06-05T06:57:00+10:00,2023-06-05,06:57,0,1,1
2,2023-06-05T06:57:00+10:00,2023-06-05,06:57,0,2,2
10,2023-06-05T06:57:00+10:00,2023-06-05,06:57,0,3,3
17,2023-06-05T06:57:00+10:00,2023-06-05,06:57,4,0,4
18,2023-06-05T06:57:00+10:00,2023-06-05,06:57,0,1,1
24,2023-06-05T06:57:00+10:00,2023-06-05,06:57,2,2,4
35,2023-06-05T06:57:00+10:00,2023-06-05,06:57,4,2,6
53,2023-06-05T06:57:00+10:00,2023-06-05,06:57,1,1,2
57,2023-06-05T06:57:00+10:00,2023-06-05,06:57,2,4,6
67,2023-06-05T06:57:00+10:00,2023-06-05,06:57,2,1,3
76,2023-06-05T06:57:00+10:00,2023-06-05,06:57,1,0,1
79,2023-06-05T06:57:00+10:00,2023-06-05,06:57,1,0,1
5,2023-06-05T06:57:00+10:00,2023-06-05,06:57,1,1,2
8,2023-06-05T06:57:00+10:00,2023-06-05,06:57,2,2,4
26,2023-06-05T06:57:00+10:00,2023-06-05,06:57,0,4,4
42,2023-06-05T06:57:00+10:00,2023-06-05,06:57,0,1,1
45,2023-06-05T06:57:00+10:00,2023-06-05,06:57,0,1,1
47,2023-06-05T06:57:00+10:00,2023-06-05,06:57,0,5,5
55,2023-06-05T06:57:00+10:00,2023-06-05,06:57,11,1,12
65,2023-06-05T06:57:00+10:00,2023-06-05,06:57,5,1,6
77,2023-06-05T06:57:00+10:00,2023-06-05,06:57,1,2,3
108,2023-06-05T06:57:00+10:00,2023-06-05,06:57,0,6,6
9,2023-06-05T06:57:00+10:00,2023-06-05,06:57,0,7,7
12,2023-06-05T06:57:00+10:00,2023-06-05,06:57,0,1,1
46,2023-06-05T06:57:00+10:00,2023-06-05,06:57,0,1,1
58,2023-06-05T06:57:00+10:00,2023-06-05,06:57,1,2,3
62,2023-06-05T06:57:00+10:00,2023-06-05,06:57,4,2,6
28,2023-06-05T06:56:00+10:00,2023-06-05,06:56,3,1,4
36,2023-06-05T06:56:00+10:00,2023-06-05,06:56,0,1,1
40,2023-06-05T06:56:00+10:00,2023-06-05,06:56,1,0,1
9,2023-06-05T06:56:00+10:00,2023-06-05,06:56,0,6,6
10,2023-06-05T06:56:00+10:00,2023-06-05,06:56,1,2,3
12,2023-06-05T06:56:00+10:00,2023-06-05,06:56,1,1,2
18,2023-06-05T06:56:00+10:00,2023-06-05,06:56,0,3,3
24,2023-06-05T06:56:00+10:00,2023-06-05,06:56,9,11,20
30,2023-06-05T06:56:00+10:00,2023-06-05,06:56,1,2,3
35,2023-06-05T06:56:00+10:00,2023-06-05,06:56,6,10,16
57,2023-06-05T06:56:00+10:00,2023-06-05,06:56,4,5,9
58,2023-06-05T06:56:00+10:00,2023-06-05,06:56,12,4,16
62,2023-06-05T06:56:00+10:00,2023-06-05,06:56,0,1,1
29,2023-06-05T06:56:00+10:00,2023-06-05,06:56,1,0,1
45,2023-06-05T06:56:00+10:00,2023-06-05,06:56,3,3,6
47,2023-06-05T06:56:00+10:00,2023-06-05,06:56,1,5,6
55,2023-06-05T06:56:00+10:00,2023-06-05,06:56,1,4,5
61,2023-06-05T06:56:00+10:00,2023-06-05,06:56,1,0,1
66,2023-06-05T06:56:00+10:00,2023-06-05,06:56,1,4,5
71,2023-06-05T06:56:00+10:00,2023-06-05,06:56,1,2,3
108,2023-06-05T06:56:00+10:00,2023-06-05,06:56,0,9,9
23,2023-06-05T06:56:00+10:00,2023-06-05,06:56,9,0,9
52,2023-06-05T06:56:00+10:00,2023-06-05,06:56,2,1,3
72,2023-06-05T06:56:00+10:00,2023-06-05,06:56,1,2,3
3,2023-06-05T06:56:00+10:00,2023-06-05,06:56,0,2,2
5,2023-06-05T06:56:00+10:00,2023-06-05,06:56,0,4,4
6,2023-06-05T06:56:00+10:00,2023-06-05,06:56,3,1,4
14,2023-06-05T06:56:00+10:00,2023-06-05,06:56,0,3,3
26,2023-06-05T06:56:00+10:00,2023-06-05,06:56,1,2,3
39,2023-06-05T06:56:00+10:00,2023-06-05,06:56,2,1,3
41,2023-06-05T06:56:00+10:00,2023-06-05,06:56,20,3,23
42,2023-06-05T06:56:00+10:00,2023-06-05,06:56,1,0,1
1,2023-06-05T06:56:00+10:00,2023-06-05,06:56,0,1,1
17,2023-06-05T06:56:00+10:00,2023-06-05,06:56,4,3,7
51,2023-06-05T06:56:00+10:00,2023-06-05,06:56,1,0,1
53,2023-06-05T06:56:00+10:00,2023-06-05,06:56,1,0,1
67,2023-06-05T06:56:00+10:00,2023-06-05,06:56,3,1,4
79,2023-06-05T06:56:00+10:00,2023-06-05,06:56,2,2,4
4,2023-06-05T06:55:00+10:00,2023-06-05,06:55,0,1,1
5,2023-06-05T06:55:00+10:00,2023-06-05,06:55,3,3,6
14,2023-06-05T06:55:00+10:00,2023-06-05,06:55,0,2,2
28,2023-06-05T06:55:00+10:00,2023-06-05,06:55,3,1,4
36,2023-06-05T06:55:00+10:00,2023-06-05,06:55,1,0,1
40,2023-06-05T06:55:00+10:00,2023-06-05,06:55,1,3,4
54,2023-06-05T06:55:00+10:00,2023-06-05,06:55,1,0,1
55,2023-06-05T06:55:00+10:00,2023-06-05,06:55,4,2,6
107,2023-06-05T06:55:00+10:00,2023-06-05,06:55,4,3,7
108,2023-06-05T06:55:00+10:00,2023-06-05,06:55,1,4,5
9,2023-06-05T06:55:00+10:00,2023-06-05,06:55,2,10,12
11,2023-06-05T06:55:00+10:00,2023-06-05,06:55,0,1,1
12,2023-06-05T06:55:00+10:00,2023-06-05,06:55,1,0,1
48,2023-06-05T06:55:00+10:00,2023-06-05,06:55,3,1,4
51,2023-06-05T06:55:00+10:00,2023-06-05,06:55,1,0,1
52,2023-06-05T06:55:00+10:00,2023-06-05,06:55,1,2,3
56,2023-06-05T06:55:00+10:00,2023-06-05,06:55,0,1,1
57,2023-06-05T06:55:00+10:00,2023-06-05,06:55,1,1,2
58,2023-06-05T06:55:00+10:00,2023-06-05,06:55,4,1,5
62,2023-06-05T06:55:00+10:00,2023-06-05,06:55,3,0,3
79,2023-06-05T06:55:00+10:00,2023-06-05,06:55,3,1,4
117,2023-06-05T06:55:00+10:00,2023-06-05,06:55,4,6,10
6,2023-06-05T06:55:00+10:00,2023-06-05,06:55,4,4,8
39,2023-06-05T06:55:00+10:00,2023-06-05,06:55,1,0,1
41,2023-06-05T06:55:00+10:00,2023-06-05,06:55,0,1,1
66,2023-06-05T06:55:00+10:00,2023-06-05,06:55,0,1,1
75,2023-06-05T06:55:00+10:00,2023-06-05,06:55,3,0,3
77,2023-06-05T06:55:00+10:00,2023-06-05,06:55,0,1,1
118,2023-06-05T06:55:00+10:00,2023-06-05,06:55,1,0,1
1,2023-06-05T06:55:00+10:00,2023-06-05,06:55,0,2,2
2,2023-06-05T06:55:00+10:00,2023-06-05,06:55,0,4,4
17,2023-06-05T06:55:00+10:00,2023-06-05,06:55,1,1,2
23,2023-06-05T06:55:00+10:00,2023-06-05,06:55,3,1,4
24,2023-06-05T06:55:00+10:00,2023-06-05,06:55,7,3,10
67,2023-06-05T06:55:00+10:00,2023-06-05,06:55,3,0,3
85,2023-06-05T06:55:00+10:00,2023-06-05,06:55,1,1,2
3,2023-06-05T06:55:00+10:00,2023-06-05,06:55,0,4,4
26,2023-06-05T06:55:00+10:00,2023-06-05,06:55,1,0,1
45,2023-06-05T06:55:00+10:00,2023-06-05,06:55,0,1,1
47,2023-06-05T06:55:00+10:00,2023-06-05,06:55,4,1,5
61,2023-06-05T06:55:00+10:00,2023-06-05,06:55,1,2,3
69,2023-06-05T06:55:00+10:00,2023-06-05,06:55,1,0,1
84,2023-06-05T06:55:00+10:00,2023-06-05,06:55,20,3,23
18,2023-06-05T06:55:00+10:00,2023-06-05,06:55,1,3,4
35,2023-06-05T06:55:00+10:00,2023-06-05,06:55,2,5,7
49,2023-06-05T06:55:00+10:00,2023-06-05,06:55,0,1,1
68,2023-06-05T06:55:00+10:00,2023-06-05,06:55,1,0,1
72,2023-06-05T06:55:00+10:00,2023-06-05,06:55,2,1,3
109,2023-06-05T06:55:00+10:00,2023-06-05,06:55,2,22,24
3,2023-06-05T06:54:00+10:00,2023-06-05,06:54,0,1,1
4,2023-06-05T06:54:00+10:00,2023-06-05,06:54,2,1,3
5,2023-06-05T06:54:00+10:00,2023-06-05,06:54,0,3,3
26,2023-06-05T06:54:00+10:00,2023-06-05,06:54,1,1,2
29,2023-06-05T06:54:00+10:00,2023-06-05,06:54,4,0,4
39,2023-06-05T06:54:00+10:00,2023-06-05,06:54,1,0,1
47,2023-06-05T06:54:00+10:00,2023-06-05,06:54,1,5,6
50,2023-06-05T06:54:00+10:00,2023-06-05,06:54,1,1,2
77,2023-06-05T06:54:00+10:00,2023-06-05,06:54,0,1,1
9,2023-06-05T06:54:00+10:00,2023-06-05,06:54,4,14,18
24,2023-06-05T06:54:00+10:00,2023-06-05,06:54,9,3,12
27,2023-06-05T06:54:00+10:00,2023-06-05,06:54,0,1,1
52,2023-06-05T06:54:00+10:00,2023-06-05,06:54,2,1,3
58,2023-06-05T06:54:00+10:00,2023-06-05,06:54,2,1,3
79,2023-06-05T06:54:00+10:00,2023-06-05,06:54,10,0,10
40,2023-06-05T06:54:00+10:00,2023-06-05,06:54,2,0,2
41,2023-06-05T06:54:00+10:00,2023-06-05,06:54,2,4,6
61,2023-06-05T06:54:00+10:00,2023-06-05,06:54,1,0,1
65,2023-06-05T06:54:00+10:00,2023-06-05,06:54,0,1,1
1,2023-06-05T06:54:00+10:00,2023-06-05,06:54,1,3,4
10,2023-06-05T06:54:00+10:00,2023-06-05,06:54,0,2,2
12,2023-06-05T06:54:00+10:00,2023-06-05,06:54,1,0,1
17,2023-06-05T06:54:00+10:00,2023-06-05,06:54,3,0,3
18,2023-06-05T06:54:00+10:00,2023-06-05,06:54,0,2,2
23,2023-06-05T06:54:00+10:00,2023-06-05,06:54,2,4,6
48,2023-06-05T06:54:00+10:00,2023-06-05,06:54,2,0,2
53,2023-06-05T06:54:00+10:00,2023-06-05,06:54,1,0,1
67,2023-06-05T06:54:00+10:00,2023-06-05,06:54,1,0,1
72,2023-06-05T06:54:00+10:00,2023-06-05,06:54,5,1,6
6,2023-06-05T06:54:00+10:00,2023-06-05,06:54,6,5,11
14,2023-06-05T06:54:00+10:00,2023-06-05,06:54,1,1,2
21,2023-06-05T06:54:00+10:00,2023-06-05,06:54,1,0,1
28,2023-06-05T06:54:00+10:00,2023-06-05,06:54,4,2,6
54,2023-06-05T06:54:00+10:00,2023-06-05,06:54,1,0,1
55,2023-06-05T06:54:00+10:00,2023-06-05,06:54,4,4,8
66,2023-06-05T06:54:00+10:00,2023-06-05,06:54,2,1,3
108,2023-06-05T06:54:00+10:00,2023-06-05,06:54,1,4,5
11,2023-06-05T06:54:00+10:00,2023-06-05,06:54,1,0,1
35,2023-06-05T06:54:00+10:00,2023-06-05,06:54,6,1,7
49,2023-06-05T06:54:00+10:00,2023-06-05,06:54,0,1,1
57,2023-06-05T06:54:00+10:00,2023-06-05,06:54,5,1,6
5,2023-06-05T06:53:00+10:00,2023-06-05,06:53,2,0,2
8,2023-06-05T06:53:00+10:00,2023-06-05,06:53,1,1,2
40,2023-06-05T06:53:00+10:00,2023-06-05,06:53,5,2,7
61,2023-06-05T06:53:00+10:00,2023-06-05,06:53,7,2,9
1,2023-06-05T06:53:00+10:00,2023-06-05,06:53,1,1,2
2,2023-06-05T06:53:00+10:00,2023-06-05,06:53,1,0,1
18,2023-06-05T06:53:00+10:00,2023-06-05,06:53,0,5,5
23,2023-06-05T06:53:00+10:00,2023-06-05,06:53,5,0,5
24,2023-06-05T06:53:00+10:00,2023-06-05,06:53,5,3,8
35,2023-06-05T06:53:00+10:00,2023-06-05,06:53,1,6,7
67,2023-06-05T06:53:00+10:00,2023-06-05,06:53,2,0,2
72,2023-06-05T06:53:00+10:00,2023-06-05,06:53,2,0,2
6,2023-06-05T06:53:00+10:00,2023-06-05,06:53,3,2,5
26,2023-06-05T06:53:00+10:00,2023-06-05,06:53,3,1,4
28,2023-06-05T06:53:00+10:00,2023-06-05,06:53,4,5,9
29,2023-06-05T06:53:00+10:00,2023-06-05,06:53,8,0,8
39,2023-06-05T06:53:00+10:00,2023-06-05,06:53,4,1,5
47,2023-06-05T06:53:00+10:00,2023-06-05,06:53,0,9,9
75,2023-06-05T06:53:00+10:00,2023-06-05,06:53,4,1,5
77,2023-06-05T06:53:00+10:00,2023-06-05,06:53,0,2,2
108,2023-06-05T06:53:00+10:00,2023-06-05,06:53,0,14,14
9,2023-06-05T06:53:00+10:00,2023-06-05,06:53,0,11,11
20,2023-06-05T06:53:00+10:00,2023-06-05,06:53,1,0,1
57,2023-06-05T06:53:00+10:00,2023-06-05,06:53,3,12,15
62,2023-06-05T06:53:00+10:00,2023-06-05,06:53,1,1,2
3,2023-06-05T06:53:00+10:00,2023-06-05,06:53,0,1,1
4,2023-06-05T06:53:00+10:00,2023-06-05,06:53,7,2,9
14,2023-06-05T06:53:00+10:00,2023-06-05,06:53,0,2,2
41,2023-06-05T06:53:00+10:00,2023-06-05,06:53,10,2,12
55,2023-06-05T06:53:00+10:00,2023-06-05,06:53,1,4,5
66,2023-06-05T06:53:00+10:00,2023-06-05,06:53,0,1,1
17,2023-06-05T06:53:00+10:00,2023-06-05,06:53,2,0,2
19,2023-06-05T06:53:00+10:00,2023-06-05,06:53,1,0,1
27,2023-06-05T06:53:00+10:00,2023-06-05,06:53,0,1,1
48,2023-06-05T06:53:00+10:00,2023-06-05,06:53,2,0,2
49,2023-06-05T06:53:00+10:00,2023-06-05,06:53,2,0,2
52,2023-06-05T06:53:00+10:00,2023-06-05,06:53,1,2,3
56,2023-06-05T06:53:00+10:00,2023-06-05,06:53,1,0,1
58,2023-06-05T06:53:00+10:00,2023-06-05,06:53,11,0,11
85,2023-06-05T06:53:00+10:00,2023-06-05,06:53,1,0,1
86,2023-06-05T06:53:00+10:00,2023-06-05,06:53,0,1,1
4,2023-06-05T06:52:00+10:00,2023-06-05,06:52,4,0,4
14,2023-06-05T06:52:00+10:00,2023-06-05,06:52,1,0,1
28,2023-06-05T06:52:00+10:00,2023-06-05,06:52,0,1,1
36,2023-06-05T06:52:00+10:00,2023-06-05,06:52,2,3,5
55,2023-06-05T06:52:00+10:00,2023-06-05,06:52,2,1,3
61,2023-06-05T06:52:00+10:00,2023-06-05,06:52,0,1,1
66,2023-06-05T06:52:00+10:00,2023-06-05,06:52,0,1,1
87,2023-06-05T06:52:00+10:00,2023-06-05,06:52,0,1,1
1,2023-06-05T06:52:00+10:00,2023-06-05,06:52,0,3,3
12,2023-06-05T06:52:00+10:00,2023-06-05,06:52,1,0,1
30,2023-06-05T06:52:00+10:00,2023-06-05,06:52,1,1,2
48,2023-06-05T06:52:00+10:00,2023-06-05,06:52,1,0,1
52,2023-06-05T06:52:00+10:00,2023-06-05,06:52,2,0,2
58,2023-06-05T06:52:00+10:00,2023-06-05,06:52,3,0,3
3,2023-06-05T06:52:00+10:00,2023-06-05,06:52,2,1,3
5,2023-06-05T06:52:00+10:00,2023-06-05,06:52,2,6,8
6,2023-06-05T06:52:00+10:00,2023-06-05,06:52,4,3,7
26,2023-06-05T06:52:00+10:00,2023-06-05,06:52,4,0,4
47,2023-06-05T06:52:00+10:00,2023-06-05,06:52,2,6,8
18,2023-06-05T06:52:00+10:00,2023-06-05,06:52,0,2,2
24,2023-06-05T06:52:00+10:00,2023-06-05,06:52,6,3,9
62,2023-06-05T06:52:00+10:00,2023-06-05,06:52,0,2,2
72,2023-06-05T06:52:00+10:00,2023-06-05,06:52,1,0,1
8,2023-06-05T06:52:00+10:00,2023-06-05,06:52,2,4,6
29,2023-06-05T06:52:00+10:00,2023-06-05,06:52,2,0,2
41,2023-06-05T06:52:00+10:00,2023-06-05,06:52,5,7,12
45,2023-06-05T06:52:00+10:00,2023-06-05,06:52,0,2,2
50,2023-06-05T06:52:00+10:00,2023-06-05,06:52,0,2,2
108,2023-06-05T06:52:00+10:00,2023-06-05,06:52,1,14,15
2,2023-06-05T06:52:00+10:00,2023-06-05,06:52,3,0,3
9,2023-06-05T06:52:00+10:00,2023-06-05,06:52,4,13,17
23,2023-06-05T06:52:00+10:00,2023-06-05,06:52,1,2,3
27,2023-06-05T06:52:00+10:00,2023-06-05,06:52,1,1,2
35,2023-06-05T06:52:00+10:00,2023-06-05,06:52,6,5,11
49,2023-06-05T06:52:00+10:00,2023-06-05,06:52,0,3,3
57,2023-06-05T06:52:00+10:00,2023-06-05,06:52,5,7,12
85,2023-06-05T06:52:00+10:00,2023-06-05,06:52,1,0,1
4,2023-06-05T06:51:00+10:00,2023-06-05,06:51,6,0,6
6,2023-06-05T06:51:00+10:00,2023-06-05,06:51,3,3,6
21,2023-06-05T06:51:00+10:00,2023-06-05,06:51,2,0,2
26,2023-06-05T06:51:00+10:00,2023-06-05,06:51,2,3,5
45,2023-06-05T06:51:00+10:00,2023-06-05,06:51,1,0,1
47,2023-06-05T06:51:00+10:00,2023-06-05,06:51,1,7,8
61,2023-06-05T06:51:00+10:00,2023-06-05,06:51,1,1,2
66,2023-06-05T06:51:00+10:00,2023-06-05,06:51,1,2,3
71,2023-06-05T06:51:00+10:00,2023-06-05,06:51,1,1,2
108,2023-06-05T06:51:00+10:00,2023-06-05,06:51,0,7,7
9,2023-06-05T06:51:00+10:00,2023-06-05,06:51,1,7,8
23,2023-06-05T06:51:00+10:00,2023-06-05,06:51,0,1,1
30,2023-06-05T06:51:00+10:00,2023-06-05,06:51,1,0,1
35,2023-06-05T06:51:00+10:00,2023-06-05,06:51,6,5,11
49,2023-06-05T06:51:00+10:00,2023-06-05,06:51,1,0,1
51,2023-06-05T06:51:00+10:00,2023-06-05,06:51,2,0,2
56,2023-06-05T06:51:00+10:00,2023-06-05,06:51,1,0,1
62,2023-06-05T06:51:00+10:00,2023-06-05,06:51,1,0,1
67,2023-06-05T06:51:00+10:00,2023-06-05,06:51,1,4,5
85,2023-06-05T06:51:00+10:00,2023-06-05,06:51,1,1,2
5,2023-06-05T06:51:00+10:00,2023-06-05,06:51,3,2,5
29,2023-06-05T06:51:00+10:00,2023-06-05,06:51,1,0,1
36,2023-06-05T06:51:00+10:00,2023-06-05,06:51,3,0,3
39,2023-06-05T06:51:00+10:00,2023-06-05,06:51,1,1,2
40,2023-06-05T06:51:00+10:00,2023-06-05,06:51,1,0,1
41,2023-06-05T06:51:00+10:00,2023-06-05,06:51,8,2,10
55,2023-06-05T06:51:00+10:00,2023-06-05,06:51,4,0,4
65,2023-06-05T06:51:00+10:00,2023-06-05,06:51,0,1,1
12,2023-06-05T06:51:00+10:00,2023-06-05,06:51,0,1,1
18,2023-06-05T06:51:00+10:00,2023-06-05,06:51,0,1,1
24,2023-06-05T06:51:00+10:00,2023-06-05,06:51,24,6,30
27,2023-06-05T06:51:00+10:00,2023-06-05,06:51,0,2,2
48,2023-06-05T06:51:00+10:00,2023-06-05,06:51,0,1,1
76,2023-06-05T06:51:00+10:00,2023-06-05,06:51,1,0,1
79,2023-06-05T06:51:00+10:00,2023-06-05,06:51,1,0,1
86,2023-06-05T06:51:00+10:00,2023-06-05,06:51,2,0,2
3,2023-06-05T06:51:00+10:00,2023-06-05,06:51,0,1,1
14,2023-06-05T06:51:00+10:00,2023-06-05,06:51,2,1,3
28,2023-06-05T06:51:00+10:00,2023-06-05,06:51,0,2,2
42,2023-06-05T06:51:00+10:00,2023-06-05,06:51,0,1,1
77,2023-06-05T06:51:00+10:00,2023-06-05,06:51,0,1,1
17,2023-06-05T06:51:00+10:00,2023-06-05,06:51,1,0,1
57,2023-06-05T06:51:00+10:00,2023-06-05,06:51,1,6,7
58,2023-06-05T06:51:00+10:00,2023-06-05,06:51,9,0,9
3,2023-06-05T06:50:00+10:00,2023-06-05,06:50,3,4,7
5,2023-06-05T06:50:00+10:00,2023-06-05,06:50,1,3,4
14,2023-06-05T06:50:00+10:00,2023-06-05,06:50,1,1,2
36,2023-06-05T06:50:00+10:00,2023-06-05,06:50,1,0,1
45,2023-06-05T06:50:00+10:00,2023-06-05,06:50,2,2,4
66,2023-06-05T06:50:00+10:00,2023-06-05,06:50,3,1,4
75,2023-06-05T06:50:00+10:00,2023-06-05,06:50,1,0,1
118,2023-06-05T06:50:00+10:00,2023-06-05,06:50,1,0,1
10,2023-06-05T06:50:00+10:00,2023-06-05,06:50,0,1,1
19,2023-06-05T06:50:00+10:00,2023-06-05,06:50,1,0,1
20,2023-06-05T06:50:00+10:00,2023-06-05,06:50,0,1,1
30,2023-06-05T06:50:00+10:00,2023-06-05,06:50,0,1,1
35,2023-06-05T06:50:00+10:00,2023-06-05,06:50,4,2,6
52,2023-06-05T06:50:00+10:00,2023-06-05,06:50,1,0,1
62,2023-06-05T06:50:00+10:00,2023-06-05,06:50,1,1,2
4,2023-06-05T06:50:00+10:00,2023-06-05,06:50,1,1,2
21,2023-06-05T06:50:00+10:00,2023-06-05,06:50,1,0,1
26,2023-06-05T06:50:00+10:00,2023-06-05,06:50,5,1,6
28,2023-06-05T06:50:00+10:00,2023-06-05,06:50,3,1,4
29,2023-06-05T06:50:00+10:00,2023-06-05,06:50,1,0,1
47,2023-06-05T06:50:00+10:00,2023-06-05,06:50,0,8,8
55,2023-06-05T06:50:00+10:00,2023-06-05,06:50,5,2,7
65,2023-06-05T06:50:00+10:00,2023-06-05,06:50,2,0,2
84,2023-06-05T06:50:00+10:00,2023-06-05,06:50,15,10,25
87,2023-06-05T06:50:00+10:00,2023-06-05,06:50,1,0,1
107,2023-06-05T06:50:00+10:00,2023-06-05,06:50,4,1,5
1,2023-06-05T06:50:00+10:00,2023-06-05,06:50,1,2,3
17,2023-06-05T06:50:00+10:00,2023-06-05,06:50,4,2,6
18,2023-06-05T06:50:00+10:00,2023-06-05,06:50,0,2,2
51,2023-06-05T06:50:00+10:00,2023-06-05,06:50,0,2,2
57,2023-06-05T06:50:00+10:00,2023-06-05,06:50,4,2,6
67,2023-06-05T06:50:00+10:00,2023-06-05,06:50,0,2,2
79,2023-06-05T06:50:00+10:00,2023-06-05,06:50,1,4,5
85,2023-06-05T06:50:00+10:00,2023-06-05,06:50,1,0,1
109,2023-06-05T06:50:00+10:00,2023-06-05,06:50,3,20,23
6,2023-06-05T06:50:00+10:00,2023-06-05,06:50,2,7,9
41,2023-06-05T06:50:00+10:00,2023-06-05,06:50,15,2,17
108,2023-06-05T06:50:00+10:00,2023-06-05,06:50,1,1,2
23,2023-06-05T06:50:00+10:00,2023-06-05,06:50,0,1,1
24,2023-06-05T06:50:00+10:00,2023-06-05,06:50,8,1,9
27,2023-06-05T06:50:00+10:00,2023-06-05,06:50,1,1,2
58,2023-06-05T06:50:00+10:00,2023-06-05,06:50,3,3,6
72,2023-06-05T06:50:00+10:00,2023-06-05,06:50,1,1,2
76,2023-06-05T06:50:00+10:00,2023-06-05,06:50,0,3,3
117,2023-06-05T06:50:00+10:00,2023-06-05,06:50,2,6,8
4,2023-06-05T06:49:00+10:00,2023-06-05,06:49,3,0,3
26,2023-06-05T06:49:00+10:00,2023-06-05,06:49,0,1,1
40,2023-06-05T06:49:00+10:00,2023-06-05,06:49,1,0,1
47,2023-06-05T06:49:00+10:00,2023-06-05,06:49,2,1,3
66,2023-06-05T06:49:00+10:00,2023-06-05,06:49,0,3,3
108,2023-06-05T06:49:00+10:00,2023-06-05,06:49,3,14,17
18,2023-06-05T06:49:00+10:00,2023-06-05,06:49,0,2,2
35,2023-06-05T06:49:00+10:00,2023-06-05,06:49,7,3,10
67,2023-06-05T06:49:00+10:00,2023-06-05,06:49,2,0,2
76,2023-06-05T06:49:00+10:00,2023-06-05,06:49,0,1,1
79,2023-06-05T06:49:00+10:00,2023-06-05,06:49,6,2,8
6,2023-06-05T06:49:00+10:00,2023-06-05,06:49,1,2,3
29,2023-06-05T06:49:00+10:00,2023-06-05,06:49,3,1,4
45,2023-06-05T06:49:00+10:00,2023-06-05,06:49,4,2,6
65,2023-06-05T06:49:00+10:00,2023-06-05,06:49,2,1,3
78,2023-06-05T06:49:00+10:00,2023-06-05,06:49,0,1,1
87,2023-06-05T06:49:00+10:00,2023-06-05,06:49,1,0,1
2,2023-06-05T06:49:00+10:00,2023-06-05,06:49,0,2,2
10,2023-06-05T06:49:00+10:00,2023-06-05,06:49,0,1,1
19,2023-06-05T06:49:00+10:00,2023-06-05,06:49,0,1,1
23,2023-06-05T06:49:00+10:00,2023-06-05,06:49,2,0,2
24,2023-06-05T06:49:00+10:00,2023-06-05,06:49,5,2,7
48,2023-06-05T06:49:00+10:00,2023-06-05,06:49,0,2,2
53,2023-06-05T06:49:00+10:00,2023-06-05,06:49,2,2,4
58,2023-06-05T06:49:00+10:00,2023-06-05,06:49,2,1,3
3,2023-06-05T06:49:00+10:00,2023-06-05,06:49,2,1,3
5,2023-06-05T06:49:00+10:00,2023-06-05,06:49,0,2,2
14,2023-06-05T06:49:00+10:00,2023-06-05,06:49,1,2,3
28,2023-06-05T06:49:00+10:00,2023-06-05,06:49,2,2,4
31,2023-06-05T06:49:00+10:00,2023-06-05,06:49,2,1,3
36,2023-06-05T06:49:00+10:00,2023-06-05,06:49,1,1,2
41,2023-06-05T06:49:00+10:00,2023-06-05,06:49,8,0,8
55,2023-06-05T06:49:00+10:00,2023-06-05,06:49,1,3,4
61,2023-06-05T06:49:00+10:00,2023-06-05,06:49,1,1,2
77,2023-06-05T06:49:00+10:00,2023-06-05,06:49,0,1,1
1,2023-06-05T06:49:00+10:00,2023-06-05,06:49,0,4,4
9,2023-06-05T06:49:00+10:00,2023-06-05,06:49,0,2,2
17,2023-06-05T06:49:00+10:00,2023-06-05,06:49,3,0,3
20,2023-06-05T06:49:00+10:00,2023-06-05,06:49,0,1,1
27,2023-06-05T06:49:00+10:00,2023-06-05,06:49,0,1,1
30,2023-06-05T06:49:00+10:00,2023-06-05,06:49,4,1,5
51,2023-06-05T06:49:00+10:00,2023-06-05,06:49,0,1,1
57,2023-06-05T06:49:00+10:00,2023-06-05,06:49,1,1,2
72,2023-06-05T06:49:00+10:00,2023-06-05,06:49,4,2,6
4,2023-06-05T06:48:00+10:00,2023-06-05,06:48,0,2,2
5,2023-06-05T06:48:00+10:00,2023-06-05,06:48,2,1,3
26,2023-06-05T06:48:00+10:00,2023-06-05,06:48,2,0,2
36,2023-06-05T06:48:00+10:00,2023-06-05,06:48,2,0,2
54,2023-06-05T06:48:00+10:00,2023-06-05,06:48,1,1,2
65,2023-06-05T06:48:00+10:00,2023-06-05,06:48,9,0,9
66,2023-06-05T06:48:00+10:00,2023-06-05,06:48,0,4,4
2,2023-06-05T06:48:00+10:00,2023-06-05,06:48,1,0,1
19,2023-06-05T06:48:00+10:00,2023-06-05,06:48,1,0,1
53,2023-06-05T06:48:00+10:00,2023-06-05,06:48,1,0,1
57,2023-06-05T06:48:00+10:00,2023-06-05,06:48,0,3,3
62,2023-06-05T06:48:00+10:00,2023-06-05,06:48,0,1,1
72,2023-06-05T06:48:00+10:00,2023-06-05,06:48,3,1,4
85,2023-06-05T06:48:00+10:00,2023-06-05,06:48,1,0,1
21,2023-06-05T06:48:00+10:00,2023-06-05,06:48,4,0,4
28,2023-06-05T06:48:00+10:00,2023-06-05,06:48,2,1,3
29,2023-06-05T06:48:00+10:00,2023-06-05,06:48,0,2,2
39,2023-06-05T06:48:00+10:00,2023-06-05,06:48,0,1,1
70,2023-06-05T06:48:00+10:00,2023-06-05,06:48,1,0,1
77,2023-06-05T06:48:00+10:00,2023-06-05,06:48,0,2,2
9,2023-06-05T06:48:00+10:00,2023-06-05,06:48,1,1,2
17,2023-06-05T06:48:00+10:00,2023-06-05,06:48,0,1,1
23,2023-06-05T06:48:00+10:00,2023-06-05,06:48,5,2,7
48,2023-06-05T06:48:00+10:00,2023-06-05,06:48,1,0,1
49,2023-06-05T06:48:00+10:00,2023-06-05,06:48,0,2,2
52,2023-06-05T06:48:00+10:00,2023-06-05,06:48,0,1,1
58,2023-06-05T06:48:00+10:00,2023-06-05,06:48,5,0,5
76,2023-06-05T06:48:00+10:00,2023-06-05,06:48,1,0,1
79,2023-06-05T06:48:00+10:00,2023-06-05,06:48,1,1,2
3,2023-06-05T06:48:00+10:00,2023-06-05,06:48,1,1,2
6,2023-06-05T06:48:00+10:00,2023-06-05,06:48,3,2,5
14,2023-06-05T06:48:00+10:00,2023-06-05,06:48,1,1,2
40,2023-06-05T06:48:00+10:00,2023-06-05,06:48,0,1,1
41,2023-06-05T06:48:00+10:00,2023-06-05,06:48,11,2,13
45,2023-06-05T06:48:00+10:00,2023-06-05,06:48,1,1,2
47,2023-06-05T06:48:00+10:00,2023-06-05,06:48,1,3,4
55,2023-06-05T06:48:00+10:00,2023-06-05,06:48,2,4,6
61,2023-06-05T06:48:00+10:00,2023-06-05,06:48,0,1,1
71,2023-06-05T06:48:00+10:00,2023-06-05,06:48,0,1,1
108,2023-06-05T06:48:00+10:00,2023-06-05,06:48,0,7,7
12,2023-06-05T06:48:00+10:00,2023-06-05,06:48,1,1,2
18,2023-06-05T06:48:00+10:00,2023-06-05,06:48,0,1,1
24,2023-06-05T06:48:00+10:00,2023-06-05,06:48,9,9,18
35,2023-06-05T06:48:00+10:00,2023-06-05,06:48,2,2,4
67,2023-06-05T06:48:00+10:00,2023-06-05,06:48,1,0,1
4,2023-06-05T06:47:00+10:00,2023-06-05,06:47,5,1,6
5,2023-06-05T06:47:00+10:00,2023-06-05,06:47,2,2,4
21,2023-06-05T06:47:00+10:00,2023-06-05,06:47,1,0,1
26,2023-06-05T06:47:00+10:00,2023-06-05,06:47,4,1,5
39,2023-06-05T06:47:00+10:00,2023-06-05,06:47,2,0,2
40,2023-06-05T06:47:00+10:00,2023-06-05,06:47,3,1,4
55,2023-06-05T06:47:00+10:00,2023-06-05,06:47,4,1,5
65,2023-06-05T06:47:00+10:00,2023-06-05,06:47,1,0,1
9,2023-06-05T06:47:00+10:00,2023-06-05,06:47,0,4,4
30,2023-06-05T06:47:00+10:00,2023-06-05,06:47,1,0,1
35,2023-06-05T06:47:00+10:00,2023-06-05,06:47,10,5,15
57,2023-06-05T06:47:00+10:00,2023-06-05,06:47,1,4,5
67,2023-06-05T06:47:00+10:00,2023-06-05,06:47,3,0,3
76,2023-06-05T06:47:00+10:00,2023-06-05,06:47,1,0,1
29,2023-06-05T06:47:00+10:00,2023-06-05,06:47,1,0,1
45,2023-06-05T06:47:00+10:00,2023-06-05,06:47,0,2,2
70,2023-06-05T06:47:00+10:00,2023-06-05,06:47,0,1,1
77,2023-06-05T06:47:00+10:00,2023-06-05,06:47,1,2,3
108,2023-06-05T06:47:00+10:00,2023-06-05,06:47,1,6,7
1,2023-06-05T06:47:00+10:00,2023-06-05,06:47,0,1,1
10,2023-06-05T06:47:00+10:00,2023-06-05,06:47,0,1,1
12,2023-06-05T06:47:00+10:00,2023-06-05,06:47,1,1,2
18,2023-06-05T06:47:00+10:00,2023-06-05,06:47,0,4,4
48,2023-06-05T06:47:00+10:00,2023-06-05,06:47,1,1,2
56,2023-06-05T06:47:00+10:00,2023-06-05,06:47,1,0,1
58,2023-06-05T06:47:00+10:00,2023-06-05,06:47,2,0,2
79,2023-06-05T06:47:00+10:00,2023-06-05,06:47,0,2,2
3,2023-06-05T06:47:00+10:00,2023-06-05,06:47,2,1,3
6,2023-06-05T06:47:00+10:00,2023-06-05,06:47,3,2,5
28,2023-06-05T06:47:00+10:00,2023-06-05,06:47,3,1,4
36,2023-06-05T06:47:00+10:00,2023-06-05,06:47,1,1,2
41,2023-06-05T06:47:00+10:00,2023-06-05,06:47,9,2,11
47,2023-06-05T06:47:00+10:00,2023-06-05,06:47,1,1,2
50,2023-06-05T06:47:00+10:00,2023-06-05,06:47,0,1,1
69,2023-06-05T06:47:00+10:00,2023-06-05,06:47,0,1,1
2,2023-06-05T06:47:00+10:00,2023-06-05,06:47,1,1,2
17,2023-06-05T06:47:00+10:00,2023-06-05,06:47,1,0,1
20,2023-06-05T06:47:00+10:00,2023-06-05,06:47,0,1,1
23,2023-06-05T06:47:00+10:00,2023-06-05,06:47,1,2,3
24,2023-06-05T06:47:00+10:00,2023-06-05,06:47,3,2,5
51,2023-06-05T06:47:00+10:00,2023-06-05,06:47,1,0,1
72,2023-06-05T06:47:00+10:00,2023-06-05,06:47,1,0,1
5,2023-06-05T06:46:00+10:00,2023-06-05,06:46,1,8,9
21,2023-06-05T06:46:00+10:00,2023-06-05,06:46,2,0,2
26,2023-06-05T06:46:00+10:00,2023-06-05,06:46,2,2,4
41,2023-06-05T06:46:00+10:00,2023-06-05,06:46,5,2,7
54,2023-06-05T06:46:00+10:00,2023-06-05,06:46,1,0,1
65,2023-06-05T06:46:00+10:00,2023-06-05,06:46,1,0,1
10,2023-06-05T06:46:00+10:00,2023-06-05,06:46,0,2,2
12,2023-06-05T06:46:00+10:00,2023-06-05,06:46,2,0,2
18,2023-06-05T06:46:00+10:00,2023-06-05,06:46,2,1,3
23,2023-06-05T06:46:00+10:00,2023-06-05,06:46,1,5,6
24,2023-06-05T06:46:00+10:00,2023-06-05,06:46,15,5,20
46,2023-06-05T06:46:00+10:00,2023-06-05,06:46,0,1,1
52,2023-06-05T06:46:00+10:00,2023-06-05,06:46,1,1,2
57,2023-06-05T06:46:00+10:00,2023-06-05,06:46,1,2,3
62,2023-06-05T06:46:00+10:00,2023-06-05,06:46,0,1,1
6,2023-06-05T06:46:00+10:00,2023-06-05,06:46,1,4,5
14,2023-06-05T06:46:00+10:00,2023-06-05,06:46,1,2,3
47,2023-06-05T06:46:00+10:00,2023-06-05,06:46,0,1,1
2,2023-06-05T06:46:00+10:00,2023-06-05,06:46,1,0,1
35,2023-06-05T06:46:00+10:00,2023-06-05,06:46,1,3,4
49,2023-06-05T06:46:00+10:00,2023-06-05,06:46,0,1,1
53,2023-06-05T06:46:00+10:00,2023-06-05,06:46,2,1,3
67,2023-06-05T06:46:00+10:00,2023-06-05,06:46,2,1,3
72,2023-06-05T06:46:00+10:00,2023-06-05,06:46,0,1,1
86,2023-06-05T06:46:00+10:00,2023-06-05,06:46,0,2,2
3,2023-06-05T06:46:00+10:00,2023-06-05,06:46,0,3,3
4,2023-06-05T06:46:00+10:00,2023-06-05,06:46,3,1,4
28,2023-06-05T06:46:00+10:00,2023-06-05,06:46,3,0,3
29,2023-06-05T06:46:00+10:00,2023-06-05,06:46,2,0,2
40,2023-06-05T06:46:00+10:00,2023-06-05,06:46,0,1,1
42,2023-06-05T06:46:00+10:00,2023-06-05,06:46,1,0,1
55,2023-06-05T06:46:00+10:00,2023-06-05,06:46,0,3,3
77,2023-06-05T06:46:00+10:00,2023-06-05,06:46,0,1,1
108,2023-06-05T06:46:00+10:00,2023-06-05,06:46,0,6,6
9,2023-06-05T06:46:00+10:00,2023-06-05,06:46,0,3,3
19,2023-06-05T06:46:00+10:00,2023-06-05,06:46,1,0,1
56,2023-06-05T06:46:00+10:00,2023-06-05,06:46,1,0,1
58,2023-06-05T06:46:00+10:00,2023-06-05,06:46,10,2,12
68,2023-06-05T06:46:00+10:00,2023-06-05,06:46,0,1,1
76,2023-06-05T06:46:00+10:00,2023-06-05,06:46,1,0,1
79,2023-06-05T06:46:00+10:00,2023-06-05,06:46,2,2,4
39,2023-06-05T06:45:00+10:00,2023-06-05,06:45,0,1,1
41,2023-06-05T06:45:00+10:00,2023-06-05,06:45,5,1,6
55,2023-06-05T06:45:00+10:00,2023-06-05,06:45,0,1,1
66,2023-06-05T06:45:00+10:00,2023-06-05,06:45,0,1,1
75,2023-06-05T06:45:00+10:00,2023-06-05,06:45,1,0,1
107,2023-06-05T06:45:00+10:00,2023-06-05,06:45,5,0,5
108,2023-06-05T06:45:00+10:00,2023-06-05,06:45,1,5,6
1,2023-06-05T06:45:00+10:00,2023-06-05,06:45,1,0,1
57,2023-06-05T06:45:00+10:00,2023-06-05,06:45,4,4,8
58,2023-06-05T06:45:00+10:00,2023-06-05,06:45,12,0,12
3,2023-06-05T06:45:00+10:00,2023-06-05,06:45,0,3,3
5,2023-06-05T06:45:00+10:00,2023-06-05,06:45,0,1,1
28,2023-06-05T06:45:00+10:00,2023-06-05,06:45,1,1,2
40,2023-06-05T06:45:00+10:00,2023-06-05,06:45,2,0,2
61,2023-06-05T06:45:00+10:00,2023-06-05,06:45,1,0,1
9,2023-06-05T06:45:00+10:00,2023-06-05,06:45,0,4,4
11,2023-06-05T06:45:00+10:00,2023-06-05,06:45,2,0,2
12,2023-06-05T06:45:00+10:00,2023-06-05,06:45,1,0,1
17,2023-06-05T06:45:00+10:00,2023-06-05,06:45,1,1,2
24,2023-06-05T06:45:00+10:00,2023-06-05,06:45,7,9,16
27,2023-06-05T06:45:00+10:00,2023-06-05,06:45,1,1,2
30,2023-06-05T06:45:00+10:00,2023-06-05,06:45,0,1,1
35,2023-06-05T06:45:00+10:00,2023-06-05,06:45,7,0,7
52,2023-06-05T06:45:00+10:00,2023-06-05,06:45,1,1,2
85,2023-06-05T06:45:00+10:00,2023-06-05,06:45,1,1,2
4,2023-06-05T06:45:00+10:00,2023-06-05,06:45,2,0,2
6,2023-06-05T06:45:00+10:00,2023-06-05,06:45,2,0,2
29,2023-06-05T06:45:00+10:00,2023-06-05,06:45,1,0,1
36,2023-06-05T06:45:00+10:00,2023-06-05,06:45,2,0,2
47,2023-06-05T06:45:00+10:00,2023-06-05,06:45,0,3,3
54,2023-06-05T06:45:00+10:00,2023-06-05,06:45,0,1,1
84,2023-06-05T06:45:00+10:00,2023-06-05,06:45,14,8,22
23,2023-06-05T06:45:00+10:00,2023-06-05,06:45,4,3,7
53,2023-06-05T06:45:00+10:00,2023-06-05,06:45,0,2,2
67,2023-06-05T06:45:00+10:00,2023-06-05,06:45,0,1,1
72,2023-06-05T06:45:00+10:00,2023-06-05,06:45,6,3,9
79,2023-06-05T06:45:00+10:00,2023-06-05,06:45,5,1,6
109,2023-06-05T06:45:00+10:00,2023-06-05,06:45,1,8,9
117,2023-06-05T06:45:00+10:00,2023-06-05,06:45,1,2,3
4,2023-06-05T06:44:00+10:00,2023-06-05,06:44,4,2,6
5,2023-06-05T06:44:00+10:00,2023-06-05,06:44,1,2,3
40,2023-06-05T06:44:00+10:00,2023-06-05,06:44,0,3,3
108,2023-06-05T06:44:00+10:00,2023-06-05,06:44,0,2,2
1,2023-06-05T06:44:00+10:00,2023-06-05,06:44,3,1,4
9,2023-06-05T06:44:00+10:00,2023-06-05,06:44,1,11,12
19,2023-06-05T06:44:00+10:00,2023-06-05,06:44,1,0,1
53,2023-06-05T06:44:00+10:00,2023-06-05,06:44,1,0,1
57,2023-06-05T06:44:00+10:00,2023-06-05,06:44,5,9,14
62,2023-06-05T06:44:00+10:00,2023-06-05,06:44,1,0,1
72,2023-06-05T06:44:00+10:00,2023-06-05,06:44,1,1,2
79,2023-06-05T06:44:00+10:00,2023-06-05,06:44,1,2,3
3,2023-06-05T06:44:00+10:00,2023-06-05,06:44,2,0,2
6,2023-06-05T06:44:00+10:00,2023-06-05,06:44,2,3,5
8,2023-06-05T06:44:00+10:00,2023-06-05,06:44,0,1,1
41,2023-06-05T06:44:00+10:00,2023-06-05,06:44,5,1,6
47,2023-06-05T06:44:00+10:00,2023-06-05,06:44,2,3,5
55,2023-06-05T06:44:00+10:00,2023-06-05,06:44,0,3,3
65,2023-06-05T06:44:00+10:00,2023-06-05,06:44,3,5,8
66,2023-06-05T06:44:00+10:00,2023-06-05,06:44,0,2,2
12,2023-06-05T06:44:00+10:00,2023-06-05,06:44,2,2,4
58,2023-06-05T06:44:00+10:00,2023-06-05,06:44,2,2,4
14,2023-06-05T06:44:00+10:00,2023-06-05,06:44,0,4,4
26,2023-06-05T06:44:00+10:00,2023-06-05,06:44,2,0,2
28,2023-06-05T06:44:00+10:00,2023-06-05,06:44,2,1,3
61,2023-06-05T06:44:00+10:00,2023-06-05,06:44,0,2,2
75,2023-06-05T06:44:00+10:00,2023-06-05,06:44,3,1,4
78,2023-06-05T06:44:00+10:00,2023-06-05,06:44,0,1,1
87,2023-06-05T06:44:00+10:00,2023-06-05,06:44,1,0,1
2,2023-06-05T06:44:00+10:00,2023-06-05,06:44,1,0,1
10,2023-06-05T06:44:00+10:00,2023-06-05,06:44,1,0,1
17,2023-06-05T06:44:00+10:00,2023-06-05,06:44,2,3,5
23,2023-06-05T06:44:00+10:00,2023-06-05,06:44,2,2,4
24,2023-06-05T06:44:00+10:00,2023-06-05,06:44,4,1,5
35,2023-06-05T06:44:00+10:00,2023-06-05,06:44,2,2,4
85,2023-06-05T06:44:00+10:00,2023-06-05,06:44,1,0,1
86,2023-06-05T06:44:00+10:00,2023-06-05,06:44,1,1,2
6,2023-06-05T06:43:00+10:00,2023-06-05,06:43,1,1,2
21,2023-06-05T06:43:00+10:00,2023-06-05,06:43,0,1,1
40,2023-06-05T06:43:00+10:00,2023-06-05,06:43,1,1,2
41,2023-06-05T06:43:00+10:00,2023-06-05,06:43,14,8,22
54,2023-06-05T06:43:00+10:00,2023-06-05,06:43,0,1,1
55,2023-06-05T06:43:00+10:00,2023-06-05,06:43,1,3,4
65,2023-06-05T06:43:00+10:00,2023-06-05,06:43,1,3,4
66,2023-06-05T06:43:00+10:00,2023-06-05,06:43,1,1,2
77,2023-06-05T06:43:00+10:00,2023-06-05,06:43,2,2,4
108,2023-06-05T06:43:00+10:00,2023-06-05,06:43,0,8,8
2,2023-06-05T06:43:00+10:00,2023-06-05,06:43,0,1,1
24,2023-06-05T06:43:00+10:00,2023-06-05,06:43,9,2,11
35,2023-06-05T06:43:00+10:00,2023-06-05,06:43,2,3,5
46,2023-06-05T06:43:00+10:00,2023-06-05,06:43,0,1,1
72,2023-06-05T06:43:00+10:00,2023-06-05,06:43,5,13,18
4,2023-06-05T06:43:00+10:00,2023-06-05,06:43,5,0,5
5,2023-06-05T06:43:00+10:00,2023-06-05,06:43,0,4,4
14,2023-06-05T06:43:00+10:00,2023-06-05,06:43,0,1,1
26,2023-06-05T06:43:00+10:00,2023-06-05,06:43,0,1,1
47,2023-06-05T06:43:00+10:00,2023-06-05,06:43,0,5,5
61,2023-06-05T06:43:00+10:00,2023-06-05,06:43,0,1,1
9,2023-06-05T06:43:00+10:00,2023-06-05,06:43,1,7,8
10,2023-06-05T06:43:00+10:00,2023-06-05,06:43,0,1,1
17,2023-06-05T06:43:00+10:00,2023-06-05,06:43,1,1,2
23,2023-06-05T06:43:00+10:00,2023-06-05,06:43,3,1,4
79,2023-06-05T06:43:00+10:00,2023-06-05,06:43,3,2,5
3,2023-06-05T06:43:00+10:00,2023-06-05,06:43,0,4,4
28,2023-06-05T06:43:00+10:00,2023-06-05,06:43,5,0,5
29,2023-06-05T06:43:00+10:00,2023-06-05,06:43,1,0,1
36,2023-06-05T06:43:00+10:00,2023-06-05,06:43,0,1,1
71,2023-06-05T06:43:00+10:00,2023-06-05,06:43,1,0,1
75,2023-06-05T06:43:00+10:00,2023-06-05,06:43,2,0,2
1,2023-06-05T06:43:00+10:00,2023-06-05,06:43,0,1,1
30,2023-06-05T06:43:00+10:00,2023-06-05,06:43,1,0,1
48,2023-06-05T06:43:00+10:00,2023-06-05,06:43,0,1,1
53,2023-06-05T06:43:00+10:00,2023-06-05,06:43,0,2,2
57,2023-06-05T06:43:00+10:00,2023-06-05,06:43,2,6,8
58,2023-06-05T06:43:00+10:00,2023-06-05,06:43,11,0,11
62,2023-06-05T06:43:00+10:00,2023-06-05,06:43,0,1,1
3,2023-06-05T06:42:00+10:00,2023-06-05,06:42,2,7,9
36,2023-06-05T06:42:00+10:00,2023-06-05,06:42,0,1,1
39,2023-06-05T06:42:00+10:00,2023-06-05,06:42,1,0,1
41,2023-06-05T06:42:00+10:00,2023-06-05,06:42,11,2,13
78,2023-06-05T06:42:00+10:00,2023-06-05,06:42,1,0,1
1,2023-06-05T06:42:00+10:00,2023-06-05,06:42,0,1,1
2,2023-06-05T06:42:00+10:00,2023-06-05,06:42,1,0,1
9,2023-06-05T06:42:00+10:00,2023-06-05,06:42,0,2,2
30,2023-06-05T06:42:00+10:00,2023-06-05,06:42,1,0,1
52,2023-06-05T06:42:00+10:00,2023-06-05,06:42,2,1,3
58,2023-06-05T06:42:00+10:00,2023-06-05,06:42,0,1,1
72,2023-06-05T06:42:00+10:00,2023-06-05,06:42,9,0,9
86,2023-06-05T06:42:00+10:00,2023-06-05,06:42,0,1,1
6,2023-06-05T06:42:00+10:00,2023-06-05,06:42,4,1,5
21,2023-06-05T06:42:00+10:00,2023-06-05,06:42,1,0,1
26,2023-06-05T06:42:00+10:00,2023-06-05,06:42,4,1,5
55,2023-06-05T06:42:00+10:00,2023-06-05,06:42,5,3,8
61,2023-06-05T06:42:00+10:00,2023-06-05,06:42,0,2,2
87,2023-06-05T06:42:00+10:00,2023-06-05,06:42,0,1,1
108,2023-06-05T06:42:00+10:00,2023-06-05,06:42,3,6,9
35,2023-06-05T06:42:00+10:00,2023-06-05,06:42,0,7,7
48,2023-06-05T06:42:00+10:00,2023-06-05,06:42,0,1,1
51,2023-06-05T06:42:00+10:00,2023-06-05,06:42,1,0,1
53,2023-06-05T06:42:00+10:00,2023-06-05,06:42,1,0,1
57,2023-06-05T06:42:00+10:00,2023-06-05,06:42,1,10,11
62,2023-06-05T06:42:00+10:00,2023-06-05,06:42,0,1,1
79,2023-06-05T06:42:00+10:00,2023-06-05,06:42,0,3,3
4,2023-06-05T06:42:00+10:00,2023-06-05,06:42,2,0,2
5,2023-06-05T06:42:00+10:00,2023-06-05,06:42,1,4,5
28,2023-06-05T06:42:00+10:00,2023-06-05,06:42,1,0,1
45,2023-06-05T06:42:00+10:00,2023-06-05,06:42,2,4,6
47,2023-06-05T06:42:00+10:00,2023-06-05,06:42,2,1,3
65,2023-06-05T06:42:00+10:00,2023-06-05,06:42,0,1,1
10,2023-06-05T06:42:00+10:00,2023-06-05,06:42,0,8,8
12,2023-06-05T06:42:00+10:00,2023-06-05,06:42,1,0,1
17,2023-06-05T06:42:00+10:00,2023-06-05,06:42,1,0,1
23,2023-06-05T06:42:00+10:00,2023-06-05,06:42,1,0,1
24,2023-06-05T06:42:00+10:00,2023-06-05,06:42,2,3,5
3,2023-06-05T06:41:00+10:00,2023-06-05,06:41,1,1,2
4,2023-06-05T06:41:00+10:00,2023-06-05,06:41,2,1,3
5,2023-06-05T06:41:00+10:00,2023-06-05,06:41,2,4,6
6,2023-06-05T06:41:00+10:00,2023-06-05,06:41,5,3,8
36,2023-06-05T06:41:00+10:00,2023-06-05,06:41,0,1,1
54,2023-06-05T06:41:00+10:00,2023-06-05,06:41,4,0,4
55,2023-06-05T06:41:00+10:00,2023-06-05,06:41,5,3,8
61,2023-06-05T06:41:00+10:00,2023-06-05,06:41,2,1,3
69,2023-06-05T06:41:00+10:00,2023-06-05,06:41,1,0,1
87,2023-06-05T06:41:00+10:00,2023-06-05,06:41,3,0,3
108,2023-06-05T06:41:00+10:00,2023-06-05,06:41,0,4,4
9,2023-06-05T06:41:00+10:00,2023-06-05,06:41,1,0,1
12,2023-06-05T06:41:00+10:00,2023-06-05,06:41,1,1,2
35,2023-06-05T06:41:00+10:00,2023-06-05,06:41,1,3,4
49,2023-06-05T06:41:00+10:00,2023-06-05,06:41,0,1,1
57,2023-06-05T06:41:00+10:00,2023-06-05,06:41,8,6,14
62,2023-06-05T06:41:00+10:00,2023-06-05,06:41,0,1,1
21,2023-06-05T06:41:00+10:00,2023-06-05,06:41,0,2,2
28,2023-06-05T06:41:00+10:00,2023-06-05,06:41,6,0,6
29,2023-06-05T06:41:00+10:00,2023-06-05,06:41,0,1,1
47,2023-06-05T06:41:00+10:00,2023-06-05,06:41,0,5,5
65,2023-06-05T06:41:00+10:00,2023-06-05,06:41,3,0,3
2,2023-06-05T06:41:00+10:00,2023-06-05,06:41,0,1,1
10,2023-06-05T06:41:00+10:00,2023-06-05,06:41,0,1,1
24,2023-06-05T06:41:00+10:00,2023-06-05,06:41,4,0,4
53,2023-06-05T06:41:00+10:00,2023-06-05,06:41,0,1,1
76,2023-06-05T06:41:00+10:00,2023-06-05,06:41,0,1,1
26,2023-06-05T06:41:00+10:00,2023-06-05,06:41,2,0,2
41,2023-06-05T06:41:00+10:00,2023-06-05,06:41,8,4,12
44,2023-06-05T06:41:00+10:00,2023-06-05,06:41,1,0,1
45,2023-06-05T06:41:00+10:00,2023-06-05,06:41,1,0,1
66,2023-06-05T06:41:00+10:00,2023-06-05,06:41,0,1,1
75,2023-06-05T06:41:00+10:00,2023-06-05,06:41,0,1,1
17,2023-06-05T06:41:00+10:00,2023-06-05,06:41,9,1,10
18,2023-06-05T06:41:00+10:00,2023-06-05,06:41,0,2,2
23,2023-06-05T06:41:00+10:00,2023-06-05,06:41,2,1,3
30,2023-06-05T06:41:00+10:00,2023-06-05,06:41,0,1,1
48,2023-06-05T06:41:00+10:00,2023-06-05,06:41,1,0,1
52,2023-06-05T06:41:00+10:00,2023-06-05,06:41,1,1,2
67,2023-06-05T06:41:00+10:00,2023-06-05,06:41,0,1,1
72,2023-06-05T06:41:00+10:00,2023-06-05,06:41,5,1,6
79,2023-06-05T06:41:00+10:00,2023-06-05,06:41,0,2,2
5,2023-06-05T06:40:00+10:00,2023-06-05,06:40,1,4,5
28,2023-06-05T06:40:00+10:00,2023-06-05,06:40,5,2,7
36,2023-06-05T06:40:00+10:00,2023-06-05,06:40,0,2,2
41,2023-06-05T06:40:00+10:00,2023-06-05,06:40,7,8,15
65,2023-06-05T06:40:00+10:00,2023-06-05,06:40,2,1,3
87,2023-06-05T06:40:00+10:00,2023-06-05,06:40,0,1,1
2,2023-06-05T06:40:00+10:00,2023-06-05,06:40,1,1,2
10,2023-06-05T06:40:00+10:00,2023-06-05,06:40,0,4,4
17,2023-06-05T06:40:00+10:00,2023-06-05,06:40,4,1,5
35,2023-06-05T06:40:00+10:00,2023-06-05,06:40,7,2,9
53,2023-06-05T06:40:00+10:00,2023-06-05,06:40,1,2,3
62,2023-06-05T06:40:00+10:00,2023-06-05,06:40,0,1,1
4,2023-06-05T06:40:00+10:00,2023-06-05,06:40,4,1,5
6,2023-06-05T06:40:00+10:00,2023-06-05,06:40,7,12,19
26,2023-06-05T06:40:00+10:00,2023-06-05,06:40,2,1,3
45,2023-06-05T06:40:00+10:00,2023-06-05,06:40,3,3,6
55,2023-06-05T06:40:00+10:00,2023-06-05,06:40,0,1,1
61,2023-06-05T06:40:00+10:00,2023-06-05,06:40,3,2,5
66,2023-06-05T06:40:00+10:00,2023-06-05,06:40,0,1,1
71,2023-06-05T06:40:00+10:00,2023-06-05,06:40,4,3,7
75,2023-06-05T06:40:00+10:00,2023-06-05,06:40,1,0,1
77,2023-06-05T06:40:00+10:00,2023-06-05,06:40,0,1,1
20,2023-06-05T06:40:00+10:00,2023-06-05,06:40,0,1,1
24,2023-06-05T06:40:00+10:00,2023-06-05,06:40,3,0,3
58,2023-06-05T06:40:00+10:00,2023-06-05,06:40,2,2,4
67,2023-06-05T06:40:00+10:00,2023-06-05,06:40,1,0,1
72,2023-06-05T06:40:00+10:00,2023-06-05,06:40,7,1,8
85,2023-06-05T06:40:00+10:00,2023-06-05,06:40,2,1,3
109,2023-06-05T06:40:00+10:00,2023-06-05,06:40,5,8,13
3,2023-06-05T06:40:00+10:00,2023-06-05,06:40,1,1,2
14,2023-06-05T06:40:00+10:00,2023-06-05,06:40,1,3,4
40,2023-06-05T06:40:00+10:00,2023-06-05,06:40,0,1,1
47,2023-06-05T06:40:00+10:00,2023-06-05,06:40,1,4,5
84,2023-06-05T06:40:00+10:00,2023-06-05,06:40,21,6,27
107,2023-06-05T06:40:00+10:00,2023-06-05,06:40,0,2,2
108,2023-06-05T06:40:00+10:00,2023-06-05,06:40,1,3,4
11,2023-06-05T06:40:00+10:00,2023-06-05,06:40,1,1,2
18,2023-06-05T06:40:00+10:00,2023-06-05,06:40,0,3,3
19,2023-06-05T06:40:00+10:00,2023-06-05,06:40,2,0,2
23,2023-06-05T06:40:00+10:00,2023-06-05,06:40,1,1,2
79,2023-06-05T06:40:00+10:00,2023-06-05,06:40,5,0,5
117,2023-06-05T06:40:00+10:00,2023-06-05,06:40,2,1,3
5,2023-06-05T06:39:00+10:00,2023-06-05,06:39,3,0,3
36,2023-06-05T06:39:00+10:00,2023-06-05,06:39,0,2,2
44,2023-06-05T06:39:00+10:00,2023-06-05,06:39,1,0,1
45,2023-06-05T06:39:00+10:00,2023-06-05,06:39,0,1,1
61,2023-06-05T06:39:00+10:00,2023-06-05,06:39,0,1,1
108,2023-06-05T06:39:00+10:00,2023-06-05,06:39,1,3,4
9,2023-06-05T06:39:00+10:00,2023-06-05,06:39,0,3,3
10,2023-06-05T06:39:00+10:00,2023-06-05,06:39,0,2,2
17,2023-06-05T06:39:00+10:00,2023-06-05,06:39,1,1,2
18,2023-06-05T06:39:00+10:00,2023-06-05,06:39,0,1,1
58,2023-06-05T06:39:00+10:00,2023-06-05,06:39,7,0,7
85,2023-06-05T06:39:00+10:00,2023-06-05,06:39,1,0,1
3,2023-06-05T06:39:00+10:00,2023-06-05,06:39,2,4,6
6,2023-06-05T06:39:00+10:00,2023-06-05,06:39,2,2,4
21,2023-06-05T06:39:00+10:00,2023-06-05,06:39,0,1,1
29,2023-06-05T06:39:00+10:00,2023-06-05,06:39,2,2,4
40,2023-06-05T06:39:00+10:00,2023-06-05,06:39,0,1,1
54,2023-06-05T06:39:00+10:00,2023-06-05,06:39,0,1,1
66,2023-06-05T06:39:00+10:00,2023-06-05,06:39,0,2,2
75,2023-06-05T06:39:00+10:00,2023-06-05,06:39,1,0,1
77,2023-06-05T06:39:00+10:00,2023-06-05,06:39,0,1,1
23,2023-06-05T06:39:00+10:00,2023-06-05,06:39,2,0,2
48,2023-06-05T06:39:00+10:00,2023-06-05,06:39,1,0,1
57,2023-06-05T06:39:00+10:00,2023-06-05,06:39,0,1,1
72,2023-06-05T06:39:00+10:00,2023-06-05,06:39,0,1,1
14,2023-06-05T06:39:00+10:00,2023-06-05,06:39,1,4,5
26,2023-06-05T06:39:00+10:00,2023-06-05,06:39,1,3,4
28,2023-06-05T06:39:00+10:00,2023-06-05,06:39,3,1,4
41,2023-06-05T06:39:00+10:00,2023-06-05,06:39,4,5,9
42,2023-06-05T06:39:00+10:00,2023-06-05,06:39,0,1,1
47,2023-06-05T06:39:00+10:00,2023-06-05,06:39,0,1,1
55,2023-06-05T06:39:00+10:00,2023-06-05,06:39,7,3,10
65,2023-06-05T06:39:00+10:00,2023-06-05,06:39,3,0,3
70,2023-06-05T06:39:00+10:00,2023-06-05,06:39,0,1,1
2,2023-06-05T06:39:00+10:00,2023-06-05,06:39,0,1,1
24,2023-06-05T06:39:00+10:00,2023-06-05,06:39,10,2,12
35,2023-06-05T06:39:00+10:00,2023-06-05,06:39,6,1,7
49,2023-06-05T06:39:00+10:00,2023-06-05,06:39,1,0,1
52,2023-06-05T06:39:00+10:00,2023-06-05,06:39,2,1,3
67,2023-06-05T06:39:00+10:00,2023-06-05,06:39,4,1,5
76,2023-06-05T06:39:00+10:00,2023-06-05,06:39,0,1,1
79,2023-06-05T06:39:00+10:00,2023-06-05,06:39,4,3,7
6,2023-06-05T06:38:00+10:00,2023-06-05,06:38,1,0,1
14,2023-06-05T06:38:00+10:00,2023-06-05,06:38,1,2,3
29,2023-06-05T06:38:00+10:00,2023-06-05,06:38,0,1,1
41,2023-06-05T06:38:00+10:00,2023-06-05,06:38,8,5,13
75,2023-06-05T06:38:00+10:00,2023-06-05,06:38,1,0,1
2,2023-06-05T06:38:00+10:00,2023-06-05,06:38,0,2,2
12,2023-06-05T06:38:00+10:00,2023-06-05,06:38,0,1,1
49,2023-06-05T06:38:00+10:00,2023-06-05,06:38,1,0,1
62,2023-06-05T06:38:00+10:00,2023-06-05,06:38,1,1,2
3,2023-06-05T06:38:00+10:00,2023-06-05,06:38,0,5,5
4,2023-06-05T06:38:00+10:00,2023-06-05,06:38,4,1,5
26,2023-06-05T06:38:00+10:00,2023-06-05,06:38,4,3,7
28,2023-06-05T06:38:00+10:00,2023-06-05,06:38,2,1,3
47,2023-06-05T06:38:00+10:00,2023-06-05,06:38,0,1,1
61,2023-06-05T06:38:00+10:00,2023-06-05,06:38,1,7,8
65,2023-06-05T06:38:00+10:00,2023-06-05,06:38,1,0,1
69,2023-06-05T06:38:00+10:00,2023-06-05,06:38,0,1,1
108,2023-06-05T06:38:00+10:00,2023-06-05,06:38,0,1,1
9,2023-06-05T06:38:00+10:00,2023-06-05,06:38,0,1,1
17,2023-06-05T06:38:00+10:00,2023-06-05,06:38,3,1,4
27,2023-06-05T06:38:00+10:00,2023-06-05,06:38,0,3,3
30,2023-06-05T06:38:00+10:00,2023-06-05,06:38,1,0,1
35,2023-06-05T06:38:00+10:00,2023-06-05,06:38,3,4,7
53,2023-06-05T06:38:00+10:00,2023-06-05,06:38,0,6,6
57,2023-06-05T06:38:00+10:00,2023-06-05,06:38,1,3,4
67,2023-06-05T06:38:00+10:00,2023-06-05,06:38,2,1,3
79,2023-06-05T06:38:00+10:00,2023-06-05,06:38,2,3,5
5,2023-06-05T06:38:00+10:00,2023-06-05,06:38,2,5,7
36,2023-06-05T06:38:00+10:00,2023-06-05,06:38,1,0,1
54,2023-06-05T06:38:00+10:00,2023-06-05,06:38,0,1,1
55,2023-06-05T06:38:00+10:00,2023-06-05,06:38,3,2,5
66,2023-06-05T06:38:00+10:00,2023-06-05,06:38,0,3,3
70,2023-06-05T06:38:00+10:00,2023-06-05,06:38,0,1,1
1,2023-06-05T06:38:00+10:00,2023-06-05,06:38,0,2,2
19,2023-06-05T06:38:00+10:00,2023-06-05,06:38,1,1,2
23,2023-06-05T06:38:00+10:00,2023-06-05,06:38,3,2,5
24,2023-06-05T06:38:00+10:00,2023-06-05,06:38,5,2,7
58,2023-06-05T06:38:00+10:00,2023-06-05,06:38,2,1,3
72,2023-06-05T06:38:00+10:00,2023-06-05,06:38,2,3,5
85,2023-06-05T06:38:00+10:00,2023-06-05,06:38,2,0,2
3,2023-06-05T06:37:00+10:00,2023-06-05,06:37,1,2,3
14,2023-06-05T06:37:00+10:00,2023-06-05,06:37,1,0,1
28,2023-06-05T06:37:00+10:00,2023-06-05,06:37,3,0,3
39,2023-06-05T06:37:00+10:00,2023-06-05,06:37,1,3,4
42,2023-06-05T06:37:00+10:00,2023-06-05,06:37,1,1,2
47,2023-06-05T06:37:00+10:00,2023-06-05,06:37,1,0,1
55,2023-06-05T06:37:00+10:00,2023-06-05,06:37,7,2,9
77,2023-06-05T06:37:00+10:00,2023-06-05,06:37,0,1,1
10,2023-06-05T06:37:00+10:00,2023-06-05,06:37,0,1,1
12,2023-06-05T06:37:00+10:00,2023-06-05,06:37,1,1,2
17,2023-06-05T06:37:00+10:00,2023-06-05,06:37,2,0,2
24,2023-06-05T06:37:00+10:00,2023-06-05,06:37,3,0,3
48,2023-06-05T06:37:00+10:00,2023-06-05,06:37,1,0,1
49,2023-06-05T06:37:00+10:00,2023-06-05,06:37,0,4,4
57,2023-06-05T06:37:00+10:00,2023-06-05,06:37,0,3,3
58,2023-06-05T06:37:00+10:00,2023-06-05,06:37,4,0,4
67,2023-06-05T06:37:00+10:00,2023-06-05,06:37,1,0,1
4,2023-06-05T06:37:00+10:00,2023-06-05,06:37,3,0,3
8,2023-06-05T06:37:00+10:00,2023-06-05,06:37,1,0,1
26,2023-06-05T06:37:00+10:00,2023-06-05,06:37,1,2,3
31,2023-06-05T06:37:00+10:00,2023-06-05,06:37,1,0,1
37,2023-06-05T06:37:00+10:00,2023-06-05,06:37,3,0,3
41,2023-06-05T06:37:00+10:00,2023-06-05,06:37,8,2,10
61,2023-06-05T06:37:00+10:00,2023-06-05,06:37,0,3,3
65,2023-06-05T06:37:00+10:00,2023-06-05,06:37,1,0,1
69,2023-06-05T06:37:00+10:00,2023-06-05,06:37,1,0,1
18,2023-06-05T06:37:00+10:00,2023-06-05,06:37,0,1,1
30,2023-06-05T06:37:00+10:00,2023-06-05,06:37,4,1,5
35,2023-06-05T06:37:00+10:00,2023-06-05,06:37,4,2,6
51,2023-06-05T06:37:00+10:00,2023-06-05,06:37,0,1,1
62,2023-06-05T06:37:00+10:00,2023-06-05,06:37,3,0,3
72,2023-06-05T06:37:00+10:00,2023-06-05,06:37,1,1,2
5,2023-06-05T06:37:00+10:00,2023-06-05,06:37,2,10,12
6,2023-06-05T06:37:00+10:00,2023-06-05,06:37,1,2,3
40,2023-06-05T06:37:00+10:00,2023-06-05,06:37,0,1,1
108,2023-06-05T06:37:00+10:00,2023-06-05,06:37,0,1,1
9,2023-06-05T06:37:00+10:00,2023-06-05,06:37,0,9,9
53,2023-06-05T06:37:00+10:00,2023-06-05,06:37,2,0,2
79,2023-06-05T06:37:00+10:00,2023-06-05,06:37,0,1,1
4,2023-06-05T06:36:00+10:00,2023-06-05,06:36,3,2,5
5,2023-06-05T06:36:00+10:00,2023-06-05,06:36,3,1,4
39,2023-06-05T06:36:00+10:00,2023-06-05,06:36,1,0,1
40,2023-06-05T06:36:00+10:00,2023-06-05,06:36,0,2,2
55,2023-06-05T06:36:00+10:00,2023-06-05,06:36,0,2,2
61,2023-06-05T06:36:00+10:00,2023-06-05,06:36,1,4,5
65,2023-06-05T06:36:00+10:00,2023-06-05,06:36,3,0,3
66,2023-06-05T06:36:00+10:00,2023-06-05,06:36,1,1,2
10,2023-06-05T06:36:00+10:00,2023-06-05,06:36,0,1,1
12,2023-06-05T06:36:00+10:00,2023-06-05,06:36,0,2,2
20,2023-06-05T06:36:00+10:00,2023-06-05,06:36,0,1,1
23,2023-06-05T06:36:00+10:00,2023-06-05,06:36,5,3,8
30,2023-06-05T06:36:00+10:00,2023-06-05,06:36,0,1,1
35,2023-06-05T06:36:00+10:00,2023-06-05,06:36,1,3,4
46,2023-06-05T06:36:00+10:00,2023-06-05,06:36,1,0,1
67,2023-06-05T06:36:00+10:00,2023-06-05,06:36,3,0,3
3,2023-06-05T06:36:00+10:00,2023-06-05,06:36,0,2,2
6,2023-06-05T06:36:00+10:00,2023-06-05,06:36,3,12,15
21,2023-06-05T06:36:00+10:00,2023-06-05,06:36,7,0,7
47,2023-06-05T06:36:00+10:00,2023-06-05,06:36,1,0,1
108,2023-06-05T06:36:00+10:00,2023-06-05,06:36,1,12,13
17,2023-06-05T06:36:00+10:00,2023-06-05,06:36,2,1,3
18,2023-06-05T06:36:00+10:00,2023-06-05,06:36,0,1,1
56,2023-06-05T06:36:00+10:00,2023-06-05,06:36,1,0,1
58,2023-06-05T06:36:00+10:00,2023-06-05,06:36,2,1,3
28,2023-06-05T06:36:00+10:00,2023-06-05,06:36,4,1,5
29,2023-06-05T06:36:00+10:00,2023-06-05,06:36,1,0,1
41,2023-06-05T06:36:00+10:00,2023-06-05,06:36,4,1,5
69,2023-06-05T06:36:00+10:00,2023-06-05,06:36,1,0,1
71,2023-06-05T06:36:00+10:00,2023-06-05,06:36,3,0,3
77,2023-06-05T06:36:00+10:00,2023-06-05,06:36,2,1,3
1,2023-06-05T06:36:00+10:00,2023-06-05,06:36,0,1,1
9,2023-06-05T06:36:00+10:00,2023-06-05,06:36,0,6,6
19,2023-06-05T06:36:00+10:00,2023-06-05,06:36,1,1,2
24,2023-06-05T06:36:00+10:00,2023-06-05,06:36,12,0,12
52,2023-06-05T06:36:00+10:00,2023-06-05,06:36,3,1,4
57,2023-06-05T06:36:00+10:00,2023-06-05,06:36,8,24,32
62,2023-06-05T06:36:00+10:00,2023-06-05,06:36,1,0,1
72,2023-06-05T06:36:00+10:00,2023-06-05,06:36,3,3,6
79,2023-06-05T06:36:00+10:00,2023-06-05,06:36,4,2,6
5,2023-06-05T06:35:00+10:00,2023-06-05,06:35,2,3,5
26,2023-06-05T06:35:00+10:00,2023-06-05,06:35,2,0,2
28,2023-06-05T06:35:00+10:00,2023-06-05,06:35,3,0,3
29,2023-06-05T06:35:00+10:00,2023-06-05,06:35,0,1,1
40,2023-06-05T06:35:00+10:00,2023-06-05,06:35,0,2,2
77,2023-06-05T06:35:00+10:00,2023-06-05,06:35,1,0,1
108,2023-06-05T06:35:00+10:00,2023-06-05,06:35,1,6,7
12,2023-06-05T06:35:00+10:00,2023-06-05,06:35,1,0,1
19,2023-06-05T06:35:00+10:00,2023-06-05,06:35,1,0,1
23,2023-06-05T06:35:00+10:00,2023-06-05,06:35,0,3,3
79,2023-06-05T06:35:00+10:00,2023-06-05,06:35,10,2,12
109,2023-06-05T06:35:00+10:00,2023-06-05,06:35,1,5,6
117,2023-06-05T06:35:00+10:00,2023-06-05,06:35,1,1,2
4,2023-06-05T06:35:00+10:00,2023-06-05,06:35,3,1,4
42,2023-06-05T06:35:00+10:00,2023-06-05,06:35,0,2,2
47,2023-06-05T06:35:00+10:00,2023-06-05,06:35,0,3,3
61,2023-06-05T06:35:00+10:00,2023-06-05,06:35,1,0,1
107,2023-06-05T06:35:00+10:00,2023-06-05,06:35,1,5,6
58,2023-06-05T06:35:00+10:00,2023-06-05,06:35,3,0,3
3,2023-06-05T06:35:00+10:00,2023-06-05,06:35,0,1,1
6,2023-06-05T06:35:00+10:00,2023-06-05,06:35,4,2,6
8,2023-06-05T06:35:00+10:00,2023-06-05,06:35,0,1,1
41,2023-06-05T06:35:00+10:00,2023-06-05,06:35,15,3,18
70,2023-06-05T06:35:00+10:00,2023-06-05,06:35,1,0,1
71,2023-06-05T06:35:00+10:00,2023-06-05,06:35,0,1,1
84,2023-06-05T06:35:00+10:00,2023-06-05,06:35,25,7,32
118,2023-06-05T06:35:00+10:00,2023-06-05,06:35,1,0,1
9,2023-06-05T06:35:00+10:00,2023-06-05,06:35,1,8,9
11,2023-06-05T06:35:00+10:00,2023-06-05,06:35,1,0,1
20,2023-06-05T06:35:00+10:00,2023-06-05,06:35,0,1,1
24,2023-06-05T06:35:00+10:00,2023-06-05,06:35,6,1,7
35,2023-06-05T06:35:00+10:00,2023-06-05,06:35,1,4,5
48,2023-06-05T06:35:00+10:00,2023-06-05,06:35,0,1,1
57,2023-06-05T06:35:00+10:00,2023-06-05,06:35,2,7,9
72,2023-06-05T06:35:00+10:00,2023-06-05,06:35,4,4,8
6,2023-06-05T06:34:00+10:00,2023-06-05,06:34,2,3,5
14,2023-06-05T06:34:00+10:00,2023-06-05,06:34,1,0,1
26,2023-06-05T06:34:00+10:00,2023-06-05,06:34,2,2,4
66,2023-06-05T06:34:00+10:00,2023-06-05,06:34,1,3,4
70,2023-06-05T06:34:00+10:00,2023-06-05,06:34,0,1,1
9,2023-06-05T06:34:00+10:00,2023-06-05,06:34,1,1,2
20,2023-06-05T06:34:00+10:00,2023-06-05,06:34,0,1,1
35,2023-06-05T06:34:00+10:00,2023-06-05,06:34,5,1,6
52,2023-06-05T06:34:00+10:00,2023-06-05,06:34,0,1,1
53,2023-06-05T06:34:00+10:00,2023-06-05,06:34,2,1,3
67,2023-06-05T06:34:00+10:00,2023-06-05,06:34,2,0,2
5,2023-06-05T06:34:00+10:00,2023-06-05,06:34,0,6,6
41,2023-06-05T06:34:00+10:00,2023-06-05,06:34,2,1,3
55,2023-06-05T06:34:00+10:00,2023-06-05,06:34,5,1,6
61,2023-06-05T06:34:00+10:00,2023-06-05,06:34,2,1,3
108,2023-06-05T06:34:00+10:00,2023-06-05,06:34,1,10,11
17,2023-06-05T06:34:00+10:00,2023-06-05,06:34,1,1,2
24,2023-06-05T06:34:00+10:00,2023-06-05,06:34,9,1,10
46,2023-06-05T06:34:00+10:00,2023-06-05,06:34,0,1,1
49,2023-06-05T06:34:00+10:00,2023-06-05,06:34,1,0,1
57,2023-06-05T06:34:00+10:00,2023-06-05,06:34,2,7,9
58,2023-06-05T06:34:00+10:00,2023-06-05,06:34,11,1,12
79,2023-06-05T06:34:00+10:00,2023-06-05,06:34,0,2,2
85,2023-06-05T06:34:00+10:00,2023-06-05,06:34,1,0,1
3,2023-06-05T06:34:00+10:00,2023-06-05,06:34,0,5,5
21,2023-06-05T06:34:00+10:00,2023-06-05,06:34,2,0,2
28,2023-06-05T06:34:00+10:00,2023-06-05,06:34,0,1,1
36,2023-06-05T06:34:00+10:00,2023-06-05,06:34,2,0,2
40,2023-06-05T06:34:00+10:00,2023-06-05,06:34,0,1,1
45,2023-06-05T06:34:00+10:00,2023-06-05,06:34,0,2,2
69,2023-06-05T06:34:00+10:00,2023-06-05,06:34,1,0,1
77,2023-06-05T06:34:00+10:00,2023-06-05,06:34,1,0,1
23,2023-06-05T06:34:00+10:00,2023-06-05,06:34,0,1,1
5,2023-06-05T06:33:00+10:00,2023-06-05,06:33,0,2,2
39,2023-06-05T06:33:00+10:00,2023-06-05,06:33,2,0,2
47,2023-06-05T06:33:00+10:00,2023-06-05,06:33,1,4,5
54,2023-06-05T06:33:00+10:00,2023-06-05,06:33,3,0,3
55,2023-06-05T06:33:00+10:00,2023-06-05,06:33,4,2,6
61,2023-06-05T06:33:00+10:00,2023-06-05,06:33,1,1,2
65,2023-06-05T06:33:00+10:00,2023-06-05,06:33,1,0,1
77,2023-06-05T06:33:00+10:00,2023-06-05,06:33,1,0,1
20,2023-06-05T06:33:00+10:00,2023-06-05,06:33,0,2,2
57,2023-06-05T06:33:00+10:00,2023-06-05,06:33,4,11,15
62,2023-06-05T06:33:00+10:00,2023-06-05,06:33,1,1,2
79,2023-06-05T06:33:00+10:00,2023-06-05,06:33,1,0,1
4,2023-06-05T06:33:00+10:00,2023-06-05,06:33,1,1,2
6,2023-06-05T06:33:00+10:00,2023-06-05,06:33,2,5,7
14,2023-06-05T06:33:00+10:00,2023-06-05,06:33,0,1,1
21,2023-06-05T06:33:00+10:00,2023-06-05,06:33,2,0,2
28,2023-06-05T06:33:00+10:00,2023-06-05,06:33,2,2,4
36,2023-06-05T06:33:00+10:00,2023-06-05,06:33,3,1,4
40,2023-06-05T06:33:00+10:00,2023-06-05,06:33,2,0,2
108,2023-06-05T06:33:00+10:00,2023-06-05,06:33,1,6,7
1,2023-06-05T06:33:00+10:00,2023-06-05,06:33,0,1,1
11,2023-06-05T06:33:00+10:00,2023-06-05,06:33,1,1,2
23,2023-06-05T06:33:00+10:00,2023-06-05,06:33,1,0,1
24,2023-06-05T06:33:00+10:00,2023-06-05,06:33,8,3,11
51,2023-06-05T06:33:00+10:00,2023-06-05,06:33,1,0,1
67,2023-06-05T06:33:00+10:00,2023-06-05,06:33,0,1,1
72,2023-06-05T06:33:00+10:00,2023-06-05,06:33,1,0,1
3,2023-06-05T06:33:00+10:00,2023-06-05,06:33,0,1,1
26,2023-06-05T06:33:00+10:00,2023-06-05,06:33,2,1,3
31,2023-06-05T06:33:00+10:00,2023-06-05,06:33,0,1,1
41,2023-06-05T06:33:00+10:00,2023-06-05,06:33,3,4,7
45,2023-06-05T06:33:00+10:00,2023-06-05,06:33,0,1,1
2,2023-06-05T06:33:00+10:00,2023-06-05,06:33,1,0,1
9,2023-06-05T06:33:00+10:00,2023-06-05,06:33,0,1,1
35,2023-06-05T06:33:00+10:00,2023-06-05,06:33,3,5,8
52,2023-06-05T06:33:00+10:00,2023-06-05,06:33,2,0,2
53,2023-06-05T06:33:00+10:00,2023-06-05,06:33,3,1,4
58,2023-06-05T06:33:00+10:00,2023-06-05,06:33,5,0,5
29,2023-06-05T06:32:00+10:00,2023-06-05,06:32,1,1,2
40,2023-06-05T06:32:00+10:00,2023-06-05,06:32,1,0,1
41,2023-06-05T06:32:00+10:00,2023-06-05,06:32,5,3,8
45,2023-06-05T06:32:00+10:00,2023-06-05,06:32,1,0,1
47,2023-06-05T06:32:00+10:00,2023-06-05,06:32,0,1,1
55,2023-06-05T06:32:00+10:00,2023-06-05,06:32,2,1,3
65,2023-06-05T06:32:00+10:00,2023-06-05,06:32,1,0,1
77,2023-06-05T06:32:00+10:00,2023-06-05,06:32,1,1,2
1,2023-06-05T06:32:00+10:00,2023-06-05,06:32,0,1,1
52,2023-06-05T06:32:00+10:00,2023-06-05,06:32,2,0,2
58,2023-06-05T06:32:00+10:00,2023-06-05,06:32,9,0,9
72,2023-06-05T06:32:00+10:00,2023-06-05,06:32,0,1,1
85,2023-06-05T06:32:00+10:00,2023-06-05,06:32,2,1,3
4,2023-06-05T06:32:00+10:00,2023-06-05,06:32,2,2,4
6,2023-06-05T06:32:00+10:00,2023-06-05,06:32,1,2,3
8,2023-06-05T06:32:00+10:00,2023-06-05,06:32,1,0,1
21,2023-06-05T06:32:00+10:00,2023-06-05,06:32,0,1,1
26,2023-06-05T06:32:00+10:00,2023-06-05,06:32,1,0,1
42,2023-06-05T06:32:00+10:00,2023-06-05,06:32,0,1,1
12,2023-06-05T06:32:00+10:00,2023-06-05,06:32,1,0,1
17,2023-06-05T06:32:00+10:00,2023-06-05,06:32,2,0,2
18,2023-06-05T06:32:00+10:00,2023-06-05,06:32,0,2,2
27,2023-06-05T06:32:00+10:00,2023-06-05,06:32,0,1,1
35,2023-06-05T06:32:00+10:00,2023-06-05,06:32,2,1,3
68,2023-06-05T06:32:00+10:00,2023-06-05,06:32,1,1,2
3,2023-06-05T06:32:00+10:00,2023-06-05,06:32,1,0,1
5,2023-06-05T06:32:00+10:00,2023-06-05,06:32,0,5,5
28,2023-06-05T06:32:00+10:00,2023-06-05,06:32,3,0,3
36,2023-06-05T06:32:00+10:00,2023-06-05,06:32,1,0,1
66,2023-06-05T06:32:00+10:00,2023-06-05,06:32,0,1,1
71,2023-06-05T06:32:00+10:00,2023-06-05,06:32,0,1,1
75,2023-06-05T06:32:00+10:00,2023-06-05,06:32,0,2,2
108,2023-06-05T06:32:00+10:00,2023-06-05,06:32,1,6,7
2,2023-06-05T06:32:00+10:00,2023-06-05,06:32,1,0,1
10,2023-06-05T06:32:00+10:00,2023-06-05,06:32,3,1,4
23,2023-06-05T06:32:00+10:00,2023-06-05,06:32,0,2,2
24,2023-06-05T06:32:00+10:00,2023-06-05,06:32,3,8,11
46,2023-06-05T06:32:00+10:00,2023-06-05,06:32,0,1,1
51,2023-06-05T06:32:00+10:00,2023-06-05,06:32,0,4,4
53,2023-06-05T06:32:00+10:00,2023-06-05,06:32,1,3,4
57,2023-06-05T06:32:00+10:00,2023-06-05,06:32,3,0,3
62,2023-06-05T06:32:00+10:00,2023-06-05,06:32,0,1,1
79,2023-06-05T06:32:00+10:00,2023-06-05,06:32,1,0,1
4,2023-06-05T06:31:00+10:00,2023-06-05,06:31,1,0,1
45,2023-06-05T06:31:00+10:00,2023-06-05,06:31,1,3,4
55,2023-06-05T06:31:00+10:00,2023-06-05,06:31,0,1,1
61,2023-06-05T06:31:00+10:00,2023-06-05,06:31,1,1,2
108,2023-06-05T06:31:00+10:00,2023-06-05,06:31,2,2,4
17,2023-06-05T06:31:00+10:00,2023-06-05,06:31,1,1,2
19,2023-06-05T06:31:00+10:00,2023-06-05,06:31,0,1,1
53,2023-06-05T06:31:00+10:00,2023-06-05,06:31,1,0,1
62,2023-06-05T06:31:00+10:00,2023-06-05,06:31,2,0,2
5,2023-06-05T06:31:00+10:00,2023-06-05,06:31,2,0,2
6,2023-06-05T06:31:00+10:00,2023-06-05,06:31,2,1,3
14,2023-06-05T06:31:00+10:00,2023-06-05,06:31,1,1,2
26,2023-06-05T06:31:00+10:00,2023-06-05,06:31,1,0,1
28,2023-06-05T06:31:00+10:00,2023-06-05,06:31,1,0,1
36,2023-06-05T06:31:00+10:00,2023-06-05,06:31,1,0,1
39,2023-06-05T06:31:00+10:00,2023-06-05,06:31,1,0,1
40,2023-06-05T06:31:00+10:00,2023-06-05,06:31,0,1,1
54,2023-06-05T06:31:00+10:00,2023-06-05,06:31,1,1,2
66,2023-06-05T06:31:00+10:00,2023-06-05,06:31,1,3,4
2,2023-06-05T06:31:00+10:00,2023-06-05,06:31,1,0,1
18,2023-06-05T06:31:00+10:00,2023-06-05,06:31,0,2,2
24,2023-06-05T06:31:00+10:00,2023-06-05,06:31,7,1,8
35,2023-06-05T06:31:00+10:00,2023-06-05,06:31,3,1,4
51,2023-06-05T06:31:00+10:00,2023-06-05,06:31,1,0,1
57,2023-06-05T06:31:00+10:00,2023-06-05,06:31,4,5,9
67,2023-06-05T06:31:00+10:00,2023-06-05,06:31,2,0,2
8,2023-06-05T06:31:00+10:00,2023-06-05,06:31,0,1,1
41,2023-06-05T06:31:00+10:00,2023-06-05,06:31,2,5,7
47,2023-06-05T06:31:00+10:00,2023-06-05,06:31,1,3,4
70,2023-06-05T06:31:00+10:00,2023-06-05,06:31,0,1,1
77,2023-06-05T06:31:00+10:00,2023-06-05,06:31,0,1,1
1,2023-06-05T06:31:00+10:00,2023-06-05,06:31,2,0,2
9,2023-06-05T06:31:00+10:00,2023-06-05,06:31,0,3,3
10,2023-06-05T06:31:00+10:00,2023-06-05,06:31,0,1,1
12,2023-06-05T06:31:00+10:00,2023-06-05,06:31,0,1,1
23,2023-06-05T06:31:00+10:00,2023-06-05,06:31,2,1,3
58,2023-06-05T06:31:00+10:00,2023-06-05,06:31,13,0,13
72,2023-06-05T06:31:00+10:00,2023-06-05,06:31,1,1,2
26,2023-06-05T06:30:00+10:00,2023-06-05,06:30,1,0,1
29,2023-06-05T06:30:00+10:00,2023-06-05,06:30,0,1,1
36,2023-06-05T06:30:00+10:00,2023-06-05,06:30,1,0,1
45,2023-06-05T06:30:00+10:00,2023-06-05,06:30,1,1,2
55,2023-06-05T06:30:00+10:00,2023-06-05,06:30,0,2,2
61,2023-06-05T06:30:00+10:00,2023-06-05,06:30,0,1,1
75,2023-06-05T06:30:00+10:00,2023-06-05,06:30,1,1,2
10,2023-06-05T06:30:00+10:00,2023-06-05,06:30,0,1,1
17,2023-06-05T06:30:00+10:00,2023-06-05,06:30,3,0,3
20,2023-06-05T06:30:00+10:00,2023-06-05,06:30,2,0,2
24,2023-06-05T06:30:00+10:00,2023-06-05,06:30,7,0,7
27,2023-06-05T06:30:00+10:00,2023-06-05,06:30,1,0,1
46,2023-06-05T06:30:00+10:00,2023-06-05,06:30,0,2,2
53,2023-06-05T06:30:00+10:00,2023-06-05,06:30,1,1,2
57,2023-06-05T06:30:00+10:00,2023-06-05,06:30,3,9,12
58,2023-06-05T06:30:00+10:00,2023-06-05,06:30,5,0,5
117,2023-06-05T06:30:00+10:00,2023-06-05,06:30,5,3,8
6,2023-06-05T06:30:00+10:00,2023-06-05,06:30,2,2,4
41,2023-06-05T06:30:00+10:00,2023-06-05,06:30,6,3,9
84,2023-06-05T06:30:00+10:00,2023-06-05,06:30,12,6,18
108,2023-06-05T06:30:00+10:00,2023-06-05,06:30,2,3,5
118,2023-06-05T06:30:00+10:00,2023-06-05,06:30,1,1,2
12,2023-06-05T06:30:00+10:00,2023-06-05,06:30,0,2,2
23,2023-06-05T06:30:00+10:00,2023-06-05,06:30,2,0,2
35,2023-06-05T06:30:00+10:00,2023-06-05,06:30,4,4,8
56,2023-06-05T06:30:00+10:00,2023-06-05,06:30,1,0,1
3,2023-06-05T06:30:00+10:00,2023-06-05,06:30,0,1,1
4,2023-06-05T06:30:00+10:00,2023-06-05,06:30,2,0,2
14,2023-06-05T06:30:00+10:00,2023-06-05,06:30,0,2,2
65,2023-06-05T06:30:00+10:00,2023-06-05,06:30,1,0,1
107,2023-06-05T06:30:00+10:00,2023-06-05,06:30,1,1,2
1,2023-06-05T06:30:00+10:00,2023-06-05,06:30,2,1,3
9,2023-06-05T06:30:00+10:00,2023-06-05,06:30,0,2,2
18,2023-06-05T06:30:00+10:00,2023-06-05,06:30,0,2,2
49,2023-06-05T06:30:00+10:00,2023-06-05,06:30,1,0,1
62,2023-06-05T06:30:00+10:00,2023-06-05,06:30,1,2,3
67,2023-06-05T06:30:00+10:00,2023-06-05,06:30,4,0,4
79,2023-06-05T06:30:00+10:00,2023-06-05,06:30,2,2,4
109,2023-06-05T06:30:00+10:00,2023-06-05,06:30,0,9,9
4,2023-06-05T06:29:00+10:00,2023-06-05,06:29,1,0,1
6,2023-06-05T06:29:00+10:00,2023-06-05,06:29,3,3,6
41,2023-06-05T06:29:00+10:00,2023-06-05,06:29,7,1,8
45,2023-06-05T06:29:00+10:00,2023-06-05,06:29,0,1,1
66,2023-06-05T06:29:00+10:00,2023-06-05,06:29,0,2,2
77,2023-06-05T06:29:00+10:00,2023-06-05,06:29,0,1,1
9,2023-06-05T06:29:00+10:00,2023-06-05,06:29,0,2,2
10,2023-06-05T06:29:00+10:00,2023-06-05,06:29,1,0,1
12,2023-06-05T06:29:00+10:00,2023-06-05,06:29,1,0,1
35,2023-06-05T06:29:00+10:00,2023-06-05,06:29,1,2,3
51,2023-06-05T06:29:00+10:00,2023-06-05,06:29,0,1,1
58,2023-06-05T06:29:00+10:00,2023-06-05,06:29,3,1,4
62,2023-06-05T06:29:00+10:00,2023-06-05,06:29,1,1,2
79,2023-06-05T06:29:00+10:00,2023-06-05,06:29,0,1,1
21,2023-06-05T06:29:00+10:00,2023-06-05,06:29,0,1,1
26,2023-06-05T06:29:00+10:00,2023-06-05,06:29,3,2,5
65,2023-06-05T06:29:00+10:00,2023-06-05,06:29,5,0,5
108,2023-06-05T06:29:00+10:00,2023-06-05,06:29,0,2,2
1,2023-06-05T06:29:00+10:00,2023-06-05,06:29,1,0,1
30,2023-06-05T06:29:00+10:00,2023-06-05,06:29,0,1,1
72,2023-06-05T06:29:00+10:00,2023-06-05,06:29,2,1,3
3,2023-06-05T06:29:00+10:00,2023-06-05,06:29,1,1,2
5,2023-06-05T06:29:00+10:00,2023-06-05,06:29,1,4,5
28,2023-06-05T06:29:00+10:00,2023-06-05,06:29,2,2,4
39,2023-06-05T06:29:00+10:00,2023-06-05,06:29,5,0,5
40,2023-06-05T06:29:00+10:00,2023-06-05,06:29,1,0,1
47,2023-06-05T06:29:00+10:00,2023-06-05,06:29,3,0,3
50,2023-06-05T06:29:00+10:00,2023-06-05,06:29,0,1,1
54,2023-06-05T06:29:00+10:00,2023-06-05,06:29,0,2,2
55,2023-06-05T06:29:00+10:00,2023-06-05,06:29,5,1,6
61,2023-06-05T06:29:00+10:00,2023-06-05,06:29,0,1,1
87,2023-06-05T06:29:00+10:00,2023-06-05,06:29,1,0,1
17,2023-06-05T06:29:00+10:00,2023-06-05,06:29,1,0,1
23,2023-06-05T06:29:00+10:00,2023-06-05,06:29,2,0,2
24,2023-06-05T06:29:00+10:00,2023-06-05,06:29,3,0,3
49,2023-06-05T06:29:00+10:00,2023-06-05,06:29,1,0,1
57,2023-06-05T06:29:00+10:00,2023-06-05,06:29,3,1,4
67,2023-06-05T06:29:00+10:00,2023-06-05,06:29,1,3,4
76,2023-06-05T06:29:00+10:00,2023-06-05,06:29,1,0,1
85,2023-06-05T06:29:00+10:00,2023-06-05,06:29,3,0,3
5,2023-06-05T06:28:00+10:00,2023-06-05,06:28,3,1,4
29,2023-06-05T06:28:00+10:00,2023-06-05,06:28,1,0,1
36,2023-06-05T06:28:00+10:00,2023-06-05,06:28,1,0,1
45,2023-06-05T06:28:00+10:00,2023-06-05,06:28,0,1,1
55,2023-06-05T06:28:00+10:00,2023-06-05,06:28,0,1,1
75,2023-06-05T06:28:00+10:00,2023-06-05,06:28,1,0,1
10,2023-06-05T06:28:00+10:00,2023-06-05,06:28,1,0,1
17,2023-06-05T06:28:00+10:00,2023-06-05,06:28,2,0,2
20,2023-06-05T06:28:00+10:00,2023-06-05,06:28,0,1,1
30,2023-06-05T06:28:00+10:00,2023-06-05,06:28,0,1,1
35,2023-06-05T06:28:00+10:00,2023-06-05,06:28,3,3,6
49,2023-06-05T06:28:00+10:00,2023-06-05,06:28,0,1,1
53,2023-06-05T06:28:00+10:00,2023-06-05,06:28,1,0,1
67,2023-06-05T06:28:00+10:00,2023-06-05,06:28,2,3,5
72,2023-06-05T06:28:00+10:00,2023-06-05,06:28,1,2,3
3,2023-06-05T06:28:00+10:00,2023-06-05,06:28,0,1,1
6,2023-06-05T06:28:00+10:00,2023-06-05,06:28,1,2,3
8,2023-06-05T06:28:00+10:00,2023-06-05,06:28,1,2,3
40,2023-06-05T06:28:00+10:00,2023-06-05,06:28,0,1,1
61,2023-06-05T06:28:00+10:00,2023-06-05,06:28,2,1,3
77,2023-06-05T06:28:00+10:00,2023-06-05,06:28,1,1,2
108,2023-06-05T06:28:00+10:00,2023-06-05,06:28,1,6,7
9,2023-06-05T06:28:00+10:00,2023-06-05,06:28,1,0,1
23,2023-06-05T06:28:00+10:00,2023-06-05,06:28,1,2,3
24,2023-06-05T06:28:00+10:00,2023-06-05,06:28,2,1,3
48,2023-06-05T06:28:00+10:00,2023-06-05,06:28,1,0,1
52,2023-06-05T06:28:00+10:00,2023-06-05,06:28,1,0,1
57,2023-06-05T06:28:00+10:00,2023-06-05,06:28,1,2,3
14,2023-06-05T06:28:00+10:00,2023-06-05,06:28,1,1,2
28,2023-06-05T06:28:00+10:00,2023-06-05,06:28,2,3,5
41,2023-06-05T06:28:00+10:00,2023-06-05,06:28,5,6,11
42,2023-06-05T06:28:00+10:00,2023-06-05,06:28,0,1,1
47,2023-06-05T06:28:00+10:00,2023-06-05,06:28,0,1,1
50,2023-06-05T06:28:00+10:00,2023-06-05,06:28,1,0,1
65,2023-06-05T06:28:00+10:00,2023-06-05,06:28,1,0,1
66,2023-06-05T06:28:00+10:00,2023-06-05,06:28,2,1,3
51,2023-06-05T06:28:00+10:00,2023-06-05,06:28,2,0,2
58,2023-06-05T06:28:00+10:00,2023-06-05,06:28,1,4,5
4,2023-06-05T06:27:00+10:00,2023-06-05,06:27,0,1,1
5,2023-06-05T06:27:00+10:00,2023-06-05,06:27,0,2,2
36,2023-06-05T06:27:00+10:00,2023-06-05,06:27,1,0,1
66,2023-06-05T06:27:00+10:00,2023-06-05,06:27,1,0,1
69,2023-06-05T06:27:00+10:00,2023-06-05,06:27,1,0,1
23,2023-06-05T06:27:00+10:00,2023-06-05,06:27,1,0,1
24,2023-06-05T06:27:00+10:00,2023-06-05,06:27,3,0,3
58,2023-06-05T06:27:00+10:00,2023-06-05,06:27,2,0,2
72,2023-06-05T06:27:00+10:00,2023-06-05,06:27,2,3,5
21,2023-06-05T06:27:00+10:00,2023-06-05,06:27,3,0,3
26,2023-06-05T06:27:00+10:00,2023-06-05,06:27,1,0,1
28,2023-06-05T06:27:00+10:00,2023-06-05,06:27,5,1,6
39,2023-06-05T06:27:00+10:00,2023-06-05,06:27,1,0,1
41,2023-06-05T06:27:00+10:00,2023-06-05,06:27,2,2,4
47,2023-06-05T06:27:00+10:00,2023-06-05,06:27,1,0,1
108,2023-06-05T06:27:00+10:00,2023-06-05,06:27,0,1,1
1,2023-06-05T06:27:00+10:00,2023-06-05,06:27,2,1,3
17,2023-06-05T06:27:00+10:00,2023-06-05,06:27,1,3,4
49,2023-06-05T06:27:00+10:00,2023-06-05,06:27,3,0,3
51,2023-06-05T06:27:00+10:00,2023-06-05,06:27,3,0,3
52,2023-06-05T06:27:00+10:00,2023-06-05,06:27,0,1,1
62,2023-06-05T06:27:00+10:00,2023-06-05,06:27,0,1,1
85,2023-06-05T06:27:00+10:00,2023-06-05,06:27,1,0,1
3,2023-06-05T06:27:00+10:00,2023-06-05,06:27,0,1,1
6,2023-06-05T06:27:00+10:00,2023-06-05,06:27,4,4,8
14,2023-06-05T06:27:00+10:00,2023-06-05,06:27,1,1,2
45,2023-06-05T06:27:00+10:00,2023-06-05,06:27,0,1,1
55,2023-06-05T06:27:00+10:00,2023-06-05,06:27,2,1,3
61,2023-06-05T06:27:00+10:00,2023-06-05,06:27,0,2,2
87,2023-06-05T06:27:00+10:00,2023-06-05,06:27,1,0,1
9,2023-06-05T06:27:00+10:00,2023-06-05,06:27,0,1,1
18,2023-06-05T06:27:00+10:00,2023-06-05,06:27,0,1,1
35,2023-06-05T06:27:00+10:00,2023-06-05,06:27,3,2,5
48,2023-06-05T06:27:00+10:00,2023-06-05,06:27,0,1,1
67,2023-06-05T06:27:00+10:00,2023-06-05,06:27,2,1,3
79,2023-06-05T06:27:00+10:00,2023-06-05,06:27,3,1,4
3,2023-06-05T06:26:00+10:00,2023-06-05,06:26,1,0,1
65,2023-06-05T06:26:00+10:00,2023-06-05,06:26,0,1,1
75,2023-06-05T06:26:00+10:00,2023-06-05,06:26,1,0,1
12,2023-06-05T06:26:00+10:00,2023-06-05,06:26,1,0,1
23,2023-06-05T06:26:00+10:00,2023-06-05,06:26,3,0,3
52,2023-06-05T06:26:00+10:00,2023-06-05,06:26,1,0,1
56,2023-06-05T06:26:00+10:00,2023-06-05,06:26,2,0,2
57,2023-06-05T06:26:00+10:00,2023-06-05,06:26,2,5,7
58,2023-06-05T06:26:00+10:00,2023-06-05,06:26,7,0,7
4,2023-06-05T06:26:00+10:00,2023-06-05,06:26,1,0,1
5,2023-06-05T06:26:00+10:00,2023-06-05,06:26,0,2,2
6,2023-06-05T06:26:00+10:00,2023-06-05,06:26,2,1,3
28,2023-06-05T06:26:00+10:00,2023-06-05,06:26,2,0,2
29,2023-06-05T06:26:00+10:00,2023-06-05,06:26,1,1,2
31,2023-06-05T06:26:00+10:00,2023-06-05,06:26,1,0,1
55,2023-06-05T06:26:00+10:00,2023-06-05,06:26,2,4,6
77,2023-06-05T06:26:00+10:00,2023-06-05,06:26,0,1,1
108,2023-06-05T06:26:00+10:00,2023-06-05,06:26,0,5,5
9,2023-06-05T06:26:00+10:00,2023-06-05,06:26,1,5,6
17,2023-06-05T06:26:00+10:00,2023-06-05,06:26,5,2,7
18,2023-06-05T06:26:00+10:00,2023-06-05,06:26,0,1,1
24,2023-06-05T06:26:00+10:00,2023-06-05,06:26,4,1,5
35,2023-06-05T06:26:00+10:00,2023-06-05,06:26,4,4,8
53,2023-06-05T06:26:00+10:00,2023-06-05,06:26,1,1,2
72,2023-06-05T06:26:00+10:00,2023-06-05,06:26,1,1,2
79,2023-06-05T06:26:00+10:00,2023-06-05,06:26,1,0,1
14,2023-06-05T06:26:00+10:00,2023-06-05,06:26,2,0,2
26,2023-06-05T06:26:00+10:00,2023-06-05,06:26,4,0,4
39,2023-06-05T06:26:00+10:00,2023-06-05,06:26,1,0,1
41,2023-06-05T06:26:00+10:00,2023-06-05,06:26,4,5,9
45,2023-06-05T06:26:00+10:00,2023-06-05,06:26,2,0,2
61,2023-06-05T06:26:00+10:00,2023-06-05,06:26,1,1,2
10,2023-06-05T06:26:00+10:00,2023-06-05,06:26,0,1,1
49,2023-06-05T06:26:00+10:00,2023-06-05,06:26,2,3,5
67,2023-06-05T06:26:00+10:00,2023-06-05,06:26,3,2,5
29,2023-06-05T06:25:00+10:00,2023-06-05,06:25,1,0,1
41,2023-06-05T06:25:00+10:00,2023-06-05,06:25,10,2,12
45,2023-06-05T06:25:00+10:00,2023-06-05,06:25,2,0,2
61,2023-06-05T06:25:00+10:00,2023-06-05,06:25,0,1,1
65,2023-06-05T06:25:00+10:00,2023-06-05,06:25,1,0,1
66,2023-06-05T06:25:00+10:00,2023-06-05,06:25,0,1,1
77,2023-06-05T06:25:00+10:00,2023-06-05,06:25,0,2,2
11,2023-06-05T06:25:00+10:00,2023-06-05,06:25,1,0,1
17,2023-06-05T06:25:00+10:00,2023-06-05,06:25,2,0,2
51,2023-06-05T06:25:00+10:00,2023-06-05,06:25,2,0,2
58,2023-06-05T06:25:00+10:00,2023-06-05,06:25,0,4,4
62,2023-06-05T06:25:00+10:00,2023-06-05,06:25,2,1,3
72,2023-06-05T06:25:00+10:00,2023-06-05,06:25,0,1,1
109,2023-06-05T06:25:00+10:00,2023-06-05,06:25,5,3,8
5,2023-06-05T06:25:00+10:00,2023-06-05,06:25,2,2,4
6,2023-06-05T06:25:00+10:00,2023-06-05,06:25,2,2,4
14,2023-06-05T06:25:00+10:00,2023-06-05,06:25,1,0,1
28,2023-06-05T06:25:00+10:00,2023-06-05,06:25,4,1,5
36,2023-06-05T06:25:00+10:00,2023-06-05,06:25,1,1,2
55,2023-06-05T06:25:00+10:00,2023-06-05,06:25,2,4,6
107,2023-06-05T06:25:00+10:00,2023-06-05,06:25,0,2,2
108,2023-06-05T06:25:00+10:00,2023-06-05,06:25,0,1,1
9,2023-06-05T06:25:00+10:00,2023-06-05,06:25,1,5,6
23,2023-06-05T06:25:00+10:00,2023-06-05,06:25,1,0,1
24,2023-06-05T06:25:00+10:00,2023-06-05,06:25,6,1,7
35,2023-06-05T06:25:00+10:00,2023-06-05,06:25,3,2,5
48,2023-06-05T06:25:00+10:00,2023-06-05,06:25,1,0,1
52,2023-06-05T06:25:00+10:00,2023-06-05,06:25,3,0,3
67,2023-06-05T06:25:00+10:00,2023-06-05,06:25,1,0,1
79,2023-06-05T06:25:00+10:00,2023-06-05,06:25,1,2,3
3,2023-06-05T06:25:00+10:00,2023-06-05,06:25,1,0,1
4,2023-06-05T06:25:00+10:00,2023-06-05,06:25,9,1,10
47,2023-06-05T06:25:00+10:00,2023-06-05,06:25,1,2,3
84,2023-06-05T06:25:00+10:00,2023-06-05,06:25,7,5,12
87,2023-06-05T06:25:00+10:00,2023-06-05,06:25,3,0,3
1,2023-06-05T06:25:00+10:00,2023-06-05,06:25,2,0,2
10,2023-06-05T06:25:00+10:00,2023-06-05,06:25,0,2,2
18,2023-06-05T06:25:00+10:00,2023-06-05,06:25,0,2,2
49,2023-06-05T06:25:00+10:00,2023-06-05,06:25,1,0,1
57,2023-06-05T06:25:00+10:00,2023-06-05,06:25,2,5,7
85,2023-06-05T06:25:00+10:00,2023-06-05,06:25,1,0,1
117,2023-06-05T06:25:00+10:00,2023-06-05,06:25,0,2,2
3,2023-06-05T06:24:00+10:00,2023-06-05,06:24,0,3,3
4,2023-06-05T06:24:00+10:00,2023-06-05,06:24,1,0,1
6,2023-06-05T06:24:00+10:00,2023-06-05,06:24,3,7,10
14,2023-06-05T06:24:00+10:00,2023-06-05,06:24,0,1,1
36,2023-06-05T06:24:00+10:00,2023-06-05,06:24,1,0,1
39,2023-06-05T06:24:00+10:00,2023-06-05,06:24,0,1,1
41,2023-06-05T06:24:00+10:00,2023-06-05,06:24,3,4,7
70,2023-06-05T06:24:00+10:00,2023-06-05,06:24,1,0,1
77,2023-06-05T06:24:00+10:00,2023-06-05,06:24,0,1,1
10,2023-06-05T06:24:00+10:00,2023-06-05,06:24,0,1,1
17,2023-06-05T06:24:00+10:00,2023-06-05,06:24,4,1,5
20,2023-06-05T06:24:00+10:00,2023-06-05,06:24,0,1,1
23,2023-06-05T06:24:00+10:00,2023-06-05,06:24,1,0,1
24,2023-06-05T06:24:00+10:00,2023-06-05,06:24,2,0,2
62,2023-06-05T06:24:00+10:00,2023-06-05,06:24,1,0,1
67,2023-06-05T06:24:00+10:00,2023-06-05,06:24,1,3,4
5,2023-06-05T06:24:00+10:00,2023-06-05,06:24,2,7,9
21,2023-06-05T06:24:00+10:00,2023-06-05,06:24,0,2,2
26,2023-06-05T06:24:00+10:00,2023-06-05,06:24,1,1,2
28,2023-06-05T06:24:00+10:00,2023-06-05,06:24,2,0,2
47,2023-06-05T06:24:00+10:00,2023-06-05,06:24,2,2,4
55,2023-06-05T06:24:00+10:00,2023-06-05,06:24,0,2,2
65,2023-06-05T06:24:00+10:00,2023-06-05,06:24,1,1,2
66,2023-06-05T06:24:00+10:00,2023-06-05,06:24,1,3,4
87,2023-06-05T06:24:00+10:00,2023-06-05,06:24,0,1,1
108,2023-06-05T06:24:00+10:00,2023-06-05,06:24,0,8,8
53,2023-06-05T06:24:00+10:00,2023-06-05,06:24,1,0,1
29,2023-06-05T06:24:00+10:00,2023-06-05,06:24,1,0,1
61,2023-06-05T06:24:00+10:00,2023-06-05,06:24,2,0,2
2,2023-06-05T06:24:00+10:00,2023-06-05,06:24,0,1,1
9,2023-06-05T06:24:00+10:00,2023-06-05,06:24,0,6,6
12,2023-06-05T06:24:00+10:00,2023-06-05,06:24,1,0,1
18,2023-06-05T06:24:00+10:00,2023-06-05,06:24,0,6,6
27,2023-06-05T06:24:00+10:00,2023-06-05,06:24,1,0,1
35,2023-06-05T06:24:00+10:00,2023-06-05,06:24,1,2,3
49,2023-06-05T06:24:00+10:00,2023-06-05,06:24,1,0,1
52,2023-06-05T06:24:00+10:00,2023-06-05,06:24,1,0,1
57,2023-06-05T06:24:00+10:00,2023-06-05,06:24,4,8,12
85,2023-06-05T06:24:00+10:00,2023-06-05,06:24,0,1,1
40,2023-06-05T06:23:00+10:00,2023-06-05,06:23,1,0,1
41,2023-06-05T06:23:00+10:00,2023-06-05,06:23,9,0,9
45,2023-06-05T06:23:00+10:00,2023-06-05,06:23,0,1,1
1,2023-06-05T06:23:00+10:00,2023-06-05,06:23,1,0,1
10,2023-06-05T06:23:00+10:00,2023-06-05,06:23,0,1,1
56,2023-06-05T06:23:00+10:00,2023-06-05,06:23,1,1,2
79,2023-06-05T06:23:00+10:00,2023-06-05,06:23,5,0,5
3,2023-06-05T06:23:00+10:00,2023-06-05,06:23,2,4,6
4,2023-06-05T06:23:00+10:00,2023-06-05,06:23,3,0,3
21,2023-06-05T06:23:00+10:00,2023-06-05,06:23,0,1,1
26,2023-06-05T06:23:00+10:00,2023-06-05,06:23,1,1,2
28,2023-06-05T06:23:00+10:00,2023-06-05,06:23,3,1,4
55,2023-06-05T06:23:00+10:00,2023-06-05,06:23,5,4,9
65,2023-06-05T06:23:00+10:00,2023-06-05,06:23,3,4,7
108,2023-06-05T06:23:00+10:00,2023-06-05,06:23,2,6,8
2,2023-06-05T06:23:00+10:00,2023-06-05,06:23,0,1,1
12,2023-06-05T06:23:00+10:00,2023-06-05,06:23,0,1,1
17,2023-06-05T06:23:00+10:00,2023-06-05,06:23,0,3,3
18,2023-06-05T06:23:00+10:00,2023-06-05,06:23,0,1,1
23,2023-06-05T06:23:00+10:00,2023-06-05,06:23,1,0,1
24,2023-06-05T06:23:00+10:00,2023-06-05,06:23,6,9,15
27,2023-06-05T06:23:00+10:00,2023-06-05,06:23,1,0,1
46,2023-06-05T06:23:00+10:00,2023-06-05,06:23,1,0,1
48,2023-06-05T06:23:00+10:00,2023-06-05,06:23,1,0,1
53,2023-06-05T06:23:00+10:00,2023-06-05,06:23,1,1,2
57,2023-06-05T06:23:00+10:00,2023-06-05,06:23,1,1,2
58,2023-06-05T06:23:00+10:00,2023-06-05,06:23,3,0,3
72,2023-06-05T06:23:00+10:00,2023-06-05,06:23,2,2,4
5,2023-06-05T06:23:00+10:00,2023-06-05,06:23,0,3,3
6,2023-06-05T06:23:00+10:00,2023-06-05,06:23,4,2,6
14,2023-06-05T06:23:00+10:00,2023-06-05,06:23,1,0,1
47,2023-06-05T06:23:00+10:00,2023-06-05,06:23,0,1,1
61,2023-06-05T06:23:00+10:00,2023-06-05,06:23,0,2,2
66,2023-06-05T06:23:00+10:00,2023-06-05,06:23,0,1,1
69,2023-06-05T06:23:00+10:00,2023-06-05,06:23,1,0,1
87,2023-06-05T06:23:00+10:00,2023-06-05,06:23,0,1,1
9,2023-06-05T06:23:00+10:00,2023-06-05,06:23,0,1,1
35,2023-06-05T06:23:00+10:00,2023-06-05,06:23,3,1,4
49,2023-06-05T06:23:00+10:00,2023-06-05,06:23,2,0,2
62,2023-06-05T06:23:00+10:00,2023-06-05,06:23,3,0,3
67,2023-06-05T06:23:00+10:00,2023-06-05,06:23,1,2,3
4,2023-06-05T06:22:00+10:00,2023-06-05,06:22,2,1,3
5,2023-06-05T06:22:00+10:00,2023-06-05,06:22,0,3,3
8,2023-06-05T06:22:00+10:00,2023-06-05,06:22,1,0,1
14,2023-06-05T06:22:00+10:00,2023-06-05,06:22,1,4,5
41,2023-06-05T06:22:00+10:00,2023-06-05,06:22,11,4,15
55,2023-06-05T06:22:00+10:00,2023-06-05,06:22,8,3,11
66,2023-06-05T06:22:00+10:00,2023-06-05,06:22,0,3,3
108,2023-06-05T06:22:00+10:00,2023-06-05,06:22,0,5,5
9,2023-06-05T06:22:00+10:00,2023-06-05,06:22,1,0,1
17,2023-06-05T06:22:00+10:00,2023-06-05,06:22,1,0,1
18,2023-06-05T06:22:00+10:00,2023-06-05,06:22,0,3,3
23,2023-06-05T06:22:00+10:00,2023-06-05,06:22,1,1,2
24,2023-06-05T06:22:00+10:00,2023-06-05,06:22,4,3,7
27,2023-06-05T06:22:00+10:00,2023-06-05,06:22,0,1,1
30,2023-06-05T06:22:00+10:00,2023-06-05,06:22,1,0,1
53,2023-06-05T06:22:00+10:00,2023-06-05,06:22,0,2,2
58,2023-06-05T06:22:00+10:00,2023-06-05,06:22,6,1,7
62,2023-06-05T06:22:00+10:00,2023-06-05,06:22,1,1,2
67,2023-06-05T06:22:00+10:00,2023-06-05,06:22,1,3,4
76,2023-06-05T06:22:00+10:00,2023-06-05,06:22,0,1,1
3,2023-06-05T06:22:00+10:00,2023-06-05,06:22,0,3,3
6,2023-06-05T06:22:00+10:00,2023-06-05,06:22,2,2,4
40,2023-06-05T06:22:00+10:00,2023-06-05,06:22,0,1,1
45,2023-06-05T06:22:00+10:00,2023-06-05,06:22,1,2,3
61,2023-06-05T06:22:00+10:00,2023-06-05,06:22,0,1,1
77,2023-06-05T06:22:00+10:00,2023-06-05,06:22,0,1,1
2,2023-06-05T06:22:00+10:00,2023-06-05,06:22,1,0,1
46,2023-06-05T06:22:00+10:00,2023-06-05,06:22,0,1,1
86,2023-06-05T06:22:00+10:00,2023-06-05,06:22,1,0,1
28,2023-06-05T06:22:00+10:00,2023-06-05,06:22,6,0,6
42,2023-06-05T06:22:00+10:00,2023-06-05,06:22,1,1,2
47,2023-06-05T06:22:00+10:00,2023-06-05,06:22,0,2,2
35,2023-06-05T06:22:00+10:00,2023-06-05,06:22,3,3,6
48,2023-06-05T06:22:00+10:00,2023-06-05,06:22,1,0,1
79,2023-06-05T06:22:00+10:00,2023-06-05,06:22,2,0,2
21,2023-06-05T06:21:00+10:00,2023-06-05,06:21,1,3,4
42,2023-06-05T06:21:00+10:00,2023-06-05,06:21,1,0,1
47,2023-06-05T06:21:00+10:00,2023-06-05,06:21,0,2,2
65,2023-06-05T06:21:00+10:00,2023-06-05,06:21,4,0,4
75,2023-06-05T06:21:00+10:00,2023-06-05,06:21,0,2,2
2,2023-06-05T06:21:00+10:00,2023-06-05,06:21,1,2,3
10,2023-06-05T06:21:00+10:00,2023-06-05,06:21,1,1,2
23,2023-06-05T06:21:00+10:00,2023-06-05,06:21,0,1,1
24,2023-06-05T06:21:00+10:00,2023-06-05,06:21,10,2,12
35,2023-06-05T06:21:00+10:00,2023-06-05,06:21,3,2,5
52,2023-06-05T06:21:00+10:00,2023-06-05,06:21,4,0,4
56,2023-06-05T06:21:00+10:00,2023-06-05,06:21,2,0,2
57,2023-06-05T06:21:00+10:00,2023-06-05,06:21,0,2,2
85,2023-06-05T06:21:00+10:00,2023-06-05,06:21,1,0,1
6,2023-06-05T06:21:00+10:00,2023-06-05,06:21,3,0,3
28,2023-06-05T06:21:00+10:00,2023-06-05,06:21,1,1,2
55,2023-06-05T06:21:00+10:00,2023-06-05,06:21,5,4,9
69,2023-06-05T06:21:00+10:00,2023-06-05,06:21,0,1,1
108,2023-06-05T06:21:00+10:00,2023-06-05,06:21,0,1,1
9,2023-06-05T06:21:00+10:00,2023-06-05,06:21,0,3,3
17,2023-06-05T06:21:00+10:00,2023-06-05,06:21,1,1,2
18,2023-06-05T06:21:00+10:00,2023-06-05,06:21,0,3,3
58,2023-06-05T06:21:00+10:00,2023-06-05,06:21,3,0,3
67,2023-06-05T06:21:00+10:00,2023-06-05,06:21,2,1,3
72,2023-06-05T06:21:00+10:00,2023-06-05,06:21,2,4,6
4,2023-06-05T06:21:00+10:00,2023-06-05,06:21,1,0,1
5,2023-06-05T06:21:00+10:00,2023-06-05,06:21,1,2,3
14,2023-06-05T06:21:00+10:00,2023-06-05,06:21,1,1,2
41,2023-06-05T06:21:00+10:00,2023-06-05,06:21,4,2,6
45,2023-06-05T06:21:00+10:00,2023-06-05,06:21,0,2,2
54,2023-06-05T06:21:00+10:00,2023-06-05,06:21,0,1,1
30,2023-06-05T06:21:00+10:00,2023-06-05,06:21,1,0,1
48,2023-06-05T06:21:00+10:00,2023-06-05,06:21,0,1,1
49,2023-06-05T06:21:00+10:00,2023-06-05,06:21,1,0,1
62,2023-06-05T06:21:00+10:00,2023-06-05,06:21,1,0,1
79,2023-06-05T06:21:00+10:00,2023-06-05,06:21,2,1,3
3,2023-06-05T06:20:00+10:00,2023-06-05,06:20,0,1,1
4,2023-06-05T06:20:00+10:00,2023-06-05,06:20,1,0,1
6,2023-06-05T06:20:00+10:00,2023-06-05,06:20,0,1,1
14,2023-06-05T06:20:00+10:00,2023-06-05,06:20,3,0,3
41,2023-06-05T06:20:00+10:00,2023-06-05,06:20,17,2,19
47,2023-06-05T06:20:00+10:00,2023-06-05,06:20,1,0,1
61,2023-06-05T06:20:00+10:00,2023-06-05,06:20,2,0,2
77,2023-06-05T06:20:00+10:00,2023-06-05,06:20,0,1,1
84,2023-06-05T06:20:00+10:00,2023-06-05,06:20,8,10,18
108,2023-06-05T06:20:00+10:00,2023-06-05,06:20,0,5,5
9,2023-06-05T06:20:00+10:00,2023-06-05,06:20,1,2,3
11,2023-06-05T06:20:00+10:00,2023-06-05,06:20,1,0,1
17,2023-06-05T06:20:00+10:00,2023-06-05,06:20,1,0,1
24,2023-06-05T06:20:00+10:00,2023-06-05,06:20,5,0,5
35,2023-06-05T06:20:00+10:00,2023-06-05,06:20,2,2,4
48,2023-06-05T06:20:00+10:00,2023-06-05,06:20,0,1,1
57,2023-06-05T06:20:00+10:00,2023-06-05,06:20,2,0,2
67,2023-06-05T06:20:00+10:00,2023-06-05,06:20,4,0,4
117,2023-06-05T06:20:00+10:00,2023-06-05,06:20,6,5,11
5,2023-06-05T06:20:00+10:00,2023-06-05,06:20,1,6,7
28,2023-06-05T06:20:00+10:00,2023-06-05,06:20,2,0,2
29,2023-06-05T06:20:00+10:00,2023-06-05,06:20,0,1,1
45,2023-06-05T06:20:00+10:00,2023-06-05,06:20,0,1,1
55,2023-06-05T06:20:00+10:00,2023-06-05,06:20,2,1,3
66,2023-06-05T06:20:00+10:00,2023-06-05,06:20,2,0,2
12,2023-06-05T06:20:00+10:00,2023-06-05,06:20,0,1,1
18,2023-06-05T06:20:00+10:00,2023-06-05,06:20,0,1,1
52,2023-06-05T06:20:00+10:00,2023-06-05,06:20,0,1,1
58,2023-06-05T06:20:00+10:00,2023-06-05,06:20,4,0,4
62,2023-06-05T06:20:00+10:00,2023-06-05,06:20,3,0,3
72,2023-06-05T06:20:00+10:00,2023-06-05,06:20,1,2,3
79,2023-06-05T06:20:00+10:00,2023-06-05,06:20,0,6,6
109,2023-06-05T06:20:00+10:00,2023-06-05,06:20,0,3,3
21,2023-06-05T06:20:00+10:00,2023-06-05,06:20,0,3,3
31,2023-06-05T06:20:00+10:00,2023-06-05,06:20,0,1,1
42,2023-06-05T06:20:00+10:00,2023-06-05,06:20,1,1,2
65,2023-06-05T06:20:00+10:00,2023-06-05,06:20,2,0,2
107,2023-06-05T06:20:00+10:00,2023-06-05,06:20,2,2,4
10,2023-06-05T06:20:00+10:00,2023-06-05,06:20,0,1,1
23,2023-06-05T06:20:00+10:00,2023-06-05,06:20,4,2,6
6,2023-06-05T06:19:00+10:00,2023-06-05,06:19,1,2,3
41,2023-06-05T06:19:00+10:00,2023-06-05,06:19,2,0,2
47,2023-06-05T06:19:00+10:00,2023-06-05,06:19,1,0,1
61,2023-06-05T06:19:00+10:00,2023-06-05,06:19,0,1,1
17,2023-06-05T06:19:00+10:00,2023-06-05,06:19,3,2,5
18,2023-06-05T06:19:00+10:00,2023-06-05,06:19,1,3,4
23,2023-06-05T06:19:00+10:00,2023-06-05,06:19,3,2,5
51,2023-06-05T06:19:00+10:00,2023-06-05,06:19,1,0,1
52,2023-06-05T06:19:00+10:00,2023-06-05,06:19,2,0,2
53,2023-06-05T06:19:00+10:00,2023-06-05,06:19,3,1,4
57,2023-06-05T06:19:00+10:00,2023-06-05,06:19,1,0,1
58,2023-06-05T06:19:00+10:00,2023-06-05,06:19,12,0,12
72,2023-06-05T06:19:00+10:00,2023-06-05,06:19,1,0,1
28,2023-06-05T06:19:00+10:00,2023-06-05,06:19,1,0,1
29,2023-06-05T06:19:00+10:00,2023-06-05,06:19,1,0,1
40,2023-06-05T06:19:00+10:00,2023-06-05,06:19,0,1,1
77,2023-06-05T06:19:00+10:00,2023-06-05,06:19,1,0,1
108,2023-06-05T06:19:00+10:00,2023-06-05,06:19,0,2,2
2,2023-06-05T06:19:00+10:00,2023-06-05,06:19,1,0,1
9,2023-06-05T06:19:00+10:00,2023-06-05,06:19,3,3,6
12,2023-06-05T06:19:00+10:00,2023-06-05,06:19,2,0,2
35,2023-06-05T06:19:00+10:00,2023-06-05,06:19,2,2,4
67,2023-06-05T06:19:00+10:00,2023-06-05,06:19,7,1,8
86,2023-06-05T06:19:00+10:00,2023-06-05,06:19,0,1,1
5,2023-06-05T06:19:00+10:00,2023-06-05,06:19,2,5,7
14,2023-06-05T06:19:00+10:00,2023-06-05,06:19,1,1,2
26,2023-06-05T06:19:00+10:00,2023-06-05,06:19,2,0,2
36,2023-06-05T06:19:00+10:00,2023-06-05,06:19,0,1,1
45,2023-06-05T06:19:00+10:00,2023-06-05,06:19,0,2,2
55,2023-06-05T06:19:00+10:00,2023-06-05,06:19,0,4,4
87,2023-06-05T06:19:00+10:00,2023-06-05,06:19,1,0,1
20,2023-06-05T06:19:00+10:00,2023-06-05,06:19,1,0,1
24,2023-06-05T06:19:00+10:00,2023-06-05,06:19,27,0,27
79,2023-06-05T06:19:00+10:00,2023-06-05,06:19,3,3,6
6,2023-06-05T06:18:00+10:00,2023-06-05,06:18,3,3,6
14,2023-06-05T06:18:00+10:00,2023-06-05,06:18,0,1,1
44,2023-06-05T06:18:00+10:00,2023-06-05,06:18,1,0,1
50,2023-06-05T06:18:00+10:00,2023-06-05,06:18,1,0,1
55,2023-06-05T06:18:00+10:00,2023-06-05,06:18,0,3,3
12,2023-06-05T06:18:00+10:00,2023-06-05,06:18,0,1,1
23,2023-06-05T06:18:00+10:00,2023-06-05,06:18,1,0,1
35,2023-06-05T06:18:00+10:00,2023-06-05,06:18,5,0,5
57,2023-06-05T06:18:00+10:00,2023-06-05,06:18,1,1,2
58,2023-06-05T06:18:00+10:00,2023-06-05,06:18,4,3,7
62,2023-06-05T06:18:00+10:00,2023-06-05,06:18,0,2,2
68,2023-06-05T06:18:00+10:00,2023-06-05,06:18,1,0,1
72,2023-06-05T06:18:00+10:00,2023-06-05,06:18,1,2,3
3,2023-06-05T06:18:00+10:00,2023-06-05,06:18,1,0,1
5,2023-06-05T06:18:00+10:00,2023-06-05,06:18,2,3,5
21,2023-06-05T06:18:00+10:00,2023-06-05,06:18,0,2,2
26,2023-06-05T06:18:00+10:00,2023-06-05,06:18,1,0,1
61,2023-06-05T06:18:00+10:00,2023-06-05,06:18,0,1,1
66,2023-06-05T06:18:00+10:00,2023-06-05,06:18,1,1,2
1,2023-06-05T06:18:00+10:00,2023-06-05,06:18,1,0,1
10,2023-06-05T06:18:00+10:00,2023-06-05,06:18,1,1,2
79,2023-06-05T06:18:00+10:00,2023-06-05,06:18,10,1,11
41,2023-06-05T06:18:00+10:00,2023-06-05,06:18,1,2,3
47,2023-06-05T06:18:00+10:00,2023-06-05,06:18,0,1,1
9,2023-06-05T06:18:00+10:00,2023-06-05,06:18,3,3,6
17,2023-06-05T06:18:00+10:00,2023-06-05,06:18,1,0,1
24,2023-06-05T06:18:00+10:00,2023-06-05,06:18,9,8,17
53,2023-06-05T06:18:00+10:00,2023-06-05,06:18,1,2,3
67,2023-06-05T06:18:00+10:00,2023-06-05,06:18,0,1,1
6,2023-06-05T06:17:00+10:00,2023-06-05,06:17,2,4,6
61,2023-06-05T06:17:00+10:00,2023-06-05,06:17,0,1,1
65,2023-06-05T06:17:00+10:00,2023-06-05,06:17,0,1,1
9,2023-06-05T06:17:00+10:00,2023-06-05,06:17,2,0,2
23,2023-06-05T06:17:00+10:00,2023-06-05,06:17,1,0,1
24,2023-06-05T06:17:00+10:00,2023-06-05,06:17,2,1,3
51,2023-06-05T06:17:00+10:00,2023-06-05,06:17,2,0,2
53,2023-06-05T06:17:00+10:00,2023-06-05,06:17,0,1,1
57,2023-06-05T06:17:00+10:00,2023-06-05,06:17,1,4,5
62,2023-06-05T06:17:00+10:00,2023-06-05,06:17,2,1,3
79,2023-06-05T06:17:00+10:00,2023-06-05,06:17,2,1,3
8,2023-06-05T06:17:00+10:00,2023-06-05,06:17,1,0,1
39,2023-06-05T06:17:00+10:00,2023-06-05,06:17,1,0,1
41,2023-06-05T06:17:00+10:00,2023-06-05,06:17,1,1,2
47,2023-06-05T06:17:00+10:00,2023-06-05,06:17,0,2,2
71,2023-06-05T06:17:00+10:00,2023-06-05,06:17,0,2,2
2,2023-06-05T06:17:00+10:00,2023-06-05,06:17,0,1,1
10,2023-06-05T06:17:00+10:00,2023-06-05,06:17,1,0,1
19,2023-06-05T06:17:00+10:00,2023-06-05,06:17,1,0,1
52,2023-06-05T06:17:00+10:00,2023-06-05,06:17,2,0,2
3,2023-06-05T06:17:00+10:00,2023-06-05,06:17,0,2,2
5,2023-06-05T06:17:00+10:00,2023-06-05,06:17,1,1,2
26,2023-06-05T06:17:00+10:00,2023-06-05,06:17,1,0,1
40,2023-06-05T06:17:00+10:00,2023-06-05,06:17,0,1,1
66,2023-06-05T06:17:00+10:00,2023-06-05,06:17,1,1,2
69,2023-06-05T06:17:00+10:00,2023-06-05,06:17,1,1,2
70,2023-06-05T06:17:00+10:00,2023-06-05,06:17,1,0,1
1,2023-06-05T06:17:00+10:00,2023-06-05,06:17,1,0,1
12,2023-06-05T06:17:00+10:00,2023-06-05,06:17,0,2,2
35,2023-06-05T06:17:00+10:00,2023-06-05,06:17,2,1,3
46,2023-06-05T06:17:00+10:00,2023-06-05,06:17,1,0,1
58,2023-06-05T06:17:00+10:00,2023-06-05,06:17,4,4,8
67,2023-06-05T06:17:00+10:00,2023-06-05,06:17,1,0,1
72,2023-06-05T06:17:00+10:00,2023-06-05,06:17,1,2,3
86,2023-06-05T06:17:00+10:00,2023-06-05,06:17,0,1,1
6,2023-06-05T06:16:00+10:00,2023-06-05,06:16,2,4,6
29,2023-06-05T06:16:00+10:00,2023-06-05,06:16,1,0,1
45,2023-06-05T06:16:00+10:00,2023-06-05,06:16,0,2,2
50,2023-06-05T06:16:00+10:00,2023-06-05,06:16,0,1,1
55,2023-06-05T06:16:00+10:00,2023-06-05,06:16,6,6,12
65,2023-06-05T06:16:00+10:00,2023-06-05,06:16,1,0,1
77,2023-06-05T06:16:00+10:00,2023-06-05,06:16,1,1,2
108,2023-06-05T06:16:00+10:00,2023-06-05,06:16,0,1,1
9,2023-06-05T06:16:00+10:00,2023-06-05,06:16,1,0,1
35,2023-06-05T06:16:00+10:00,2023-06-05,06:16,1,2,3
56,2023-06-05T06:16:00+10:00,2023-06-05,06:16,1,1,2
57,2023-06-05T06:16:00+10:00,2023-06-05,06:16,4,1,5
67,2023-06-05T06:16:00+10:00,2023-06-05,06:16,0,2,2
85,2023-06-05T06:16:00+10:00,2023-06-05,06:16,0,1,1
4,2023-06-05T06:16:00+10:00,2023-06-05,06:16,3,0,3
5,2023-06-05T06:16:00+10:00,2023-06-05,06:16,1,0,1
14,2023-06-05T06:16:00+10:00,2023-06-05,06:16,1,0,1
47,2023-06-05T06:16:00+10:00,2023-06-05,06:16,1,0,1
54,2023-06-05T06:16:00+10:00,2023-06-05,06:16,1,0,1
61,2023-06-05T06:16:00+10:00,2023-06-05,06:16,1,2,3
87,2023-06-05T06:16:00+10:00,2023-06-05,06:16,0,1,1
17,2023-06-05T06:16:00+10:00,2023-06-05,06:16,1,0,1
19,2023-06-05T06:16:00+10:00,2023-06-05,06:16,0,3,3
23,2023-06-05T06:16:00+10:00,2023-06-05,06:16,1,1,2
30,2023-06-05T06:16:00+10:00,2023-06-05,06:16,0,2,2
51,2023-06-05T06:16:00+10:00,2023-06-05,06:16,0,1,1
58,2023-06-05T06:16:00+10:00,2023-06-05,06:16,2,0,2
3,2023-06-05T06:16:00+10:00,2023-06-05,06:16,1,0,1
36,2023-06-05T06:16:00+10:00,2023-06-05,06:16,0,1,1
40,2023-06-05T06:16:00+10:00,2023-06-05,06:16,1,1,2
66,2023-06-05T06:16:00+10:00,2023-06-05,06:16,0,1,1
69,2023-06-05T06:16:00+10:00,2023-06-05,06:16,0,1,1
1,2023-06-05T06:16:00+10:00,2023-06-05,06:16,0,3,3
24,2023-06-05T06:16:00+10:00,2023-06-05,06:16,7,1,8
49,2023-06-05T06:16:00+10:00,2023-06-05,06:16,0,3,3
62,2023-06-05T06:16:00+10:00,2023-06-05,06:16,2,0,2
79,2023-06-05T06:16:00+10:00,2023-06-05,06:16,1,0,1
6,2023-06-05T06:15:00+10:00,2023-06-05,06:15,3,1,4
28,2023-06-05T06:15:00+10:00,2023-06-05,06:15,2,3,5
45,2023-06-05T06:15:00+10:00,2023-06-05,06:15,0,2,2
65,2023-06-05T06:15:00+10:00,2023-06-05,06:15,1,0,1
69,2023-06-05T06:15:00+10:00,2023-06-05,06:15,1,0,1
75,2023-06-05T06:15:00+10:00,2023-06-05,06:15,0,1,1
77,2023-06-05T06:15:00+10:00,2023-06-05,06:15,0,1,1
84,2023-06-05T06:15:00+10:00,2023-06-05,06:15,13,5,18
107,2023-06-05T06:15:00+10:00,2023-06-05,06:15,0,2,2
9,2023-06-05T06:15:00+10:00,2023-06-05,06:15,1,4,5
23,2023-06-05T06:15:00+10:00,2023-06-05,06:15,0,2,2
48,2023-06-05T06:15:00+10:00,2023-06-05,06:15,2,0,2
51,2023-06-05T06:15:00+10:00,2023-06-05,06:15,0,2,2
62,2023-06-05T06:15:00+10:00,2023-06-05,06:15,3,0,3
72,2023-06-05T06:15:00+10:00,2023-06-05,06:15,1,2,3
5,2023-06-05T06:15:00+10:00,2023-06-05,06:15,1,1,2
8,2023-06-05T06:15:00+10:00,2023-06-05,06:15,1,1,2
14,2023-06-05T06:15:00+10:00,2023-06-05,06:15,0,1,1
26,2023-06-05T06:15:00+10:00,2023-06-05,06:15,0,2,2
40,2023-06-05T06:15:00+10:00,2023-06-05,06:15,1,1,2
41,2023-06-05T06:15:00+10:00,2023-06-05,06:15,1,5,6
47,2023-06-05T06:15:00+10:00,2023-06-05,06:15,0,1,1
70,2023-06-05T06:15:00+10:00,2023-06-05,06:15,1,0,1
87,2023-06-05T06:15:00+10:00,2023-06-05,06:15,1,1,2
1,2023-06-05T06:15:00+10:00,2023-06-05,06:15,0,1,1
11,2023-06-05T06:15:00+10:00,2023-06-05,06:15,0,2,2
24,2023-06-05T06:15:00+10:00,2023-06-05,06:15,6,1,7
35,2023-06-05T06:15:00+10:00,2023-06-05,06:15,1,0,1
3,2023-06-05T06:15:00+10:00,2023-06-05,06:15,1,0,1
4,2023-06-05T06:15:00+10:00,2023-06-05,06:15,1,0,1
55,2023-06-05T06:15:00+10:00,2023-06-05,06:15,0,2,2
61,2023-06-05T06:15:00+10:00,2023-06-05,06:15,2,0,2
108,2023-06-05T06:15:00+10:00,2023-06-05,06:15,0,7,7
18,2023-06-05T06:15:00+10:00,2023-06-05,06:15,0,2,2
30,2023-06-05T06:15:00+10:00,2023-06-05,06:15,1,1,2
58,2023-06-05T06:15:00+10:00,2023-06-05,06:15,0,1,1
109,2023-06-05T06:15:00+10:00,2023-06-05,06:15,0,5,5
117,2023-06-05T06:15:00+10:00,2023-06-05,06:15,2,1,3
14,2023-06-05T06:14:00+10:00,2023-06-05,06:14,1,0,1
39,2023-06-05T06:14:00+10:00,2023-06-05,06:14,1,0,1
55,2023-06-05T06:14:00+10:00,2023-06-05,06:14,3,1,4
61,2023-06-05T06:14:00+10:00,2023-06-05,06:14,2,0,2
66,2023-06-05T06:14:00+10:00,2023-06-05,06:14,0,2,2
10,2023-06-05T06:14:00+10:00,2023-06-05,06:14,0,1,1
12,2023-06-05T06:14:00+10:00,2023-06-05,06:14,1,0,1
30,2023-06-05T06:14:00+10:00,2023-06-05,06:14,1,0,1
35,2023-06-05T06:14:00+10:00,2023-06-05,06:14,3,1,4
57,2023-06-05T06:14:00+10:00,2023-06-05,06:14,2,8,10
67,2023-06-05T06:14:00+10:00,2023-06-05,06:14,2,4,6
72,2023-06-05T06:14:00+10:00,2023-06-05,06:14,2,2,4
3,2023-06-05T06:14:00+10:00,2023-06-05,06:14,0,1,1
5,2023-06-05T06:14:00+10:00,2023-06-05,06:14,3,2,5
26,2023-06-05T06:14:00+10:00,2023-06-05,06:14,2,0,2
41,2023-06-05T06:14:00+10:00,2023-06-05,06:14,0,5,5
108,2023-06-05T06:14:00+10:00,2023-06-05,06:14,0,3,3
1,2023-06-05T06:14:00+10:00,2023-06-05,06:14,0,1,1
9,2023-06-05T06:14:00+10:00,2023-06-05,06:14,0,1,1
48,2023-06-05T06:14:00+10:00,2023-06-05,06:14,1,0,1
58,2023-06-05T06:14:00+10:00,2023-06-05,06:14,0,5,5
79,2023-06-05T06:14:00+10:00,2023-06-05,06:14,0,1,1
6,2023-06-05T06:14:00+10:00,2023-06-05,06:14,2,1,3
28,2023-06-05T06:14:00+10:00,2023-06-05,06:14,0,1,1
54,2023-06-05T06:14:00+10:00,2023-06-05,06:14,1,0,1
65,2023-06-05T06:14:00+10:00,2023-06-05,06:14,0,1,1
17,2023-06-05T06:14:00+10:00,2023-06-05,06:14,3,0,3
23,2023-06-05T06:14:00+10:00,2023-06-05,06:14,0,1,1
24,2023-06-05T06:14:00+10:00,2023-06-05,06:14,1,1,2
62,2023-06-05T06:14:00+10:00,2023-06-05,06:14,1,2,3
6,2023-06-05T06:13:00+10:00,2023-06-05,06:13,3,1,4
29,2023-06-05T06:13:00+10:00,2023-06-05,06:13,0,1,1
61,2023-06-05T06:13:00+10:00,2023-06-05,06:13,1,1,2
65,2023-06-05T06:13:00+10:00,2023-06-05,06:13,1,0,1
66,2023-06-05T06:13:00+10:00,2023-06-05,06:13,0,1,1
71,2023-06-05T06:13:00+10:00,2023-06-05,06:13,0,1,1
108,2023-06-05T06:13:00+10:00,2023-06-05,06:13,1,3,4
30,2023-06-05T06:13:00+10:00,2023-06-05,06:13,0,1,1
35,2023-06-05T06:13:00+10:00,2023-06-05,06:13,2,0,2
51,2023-06-05T06:13:00+10:00,2023-06-05,06:13,0,3,3
79,2023-06-05T06:13:00+10:00,2023-06-05,06:13,0,1,1
8,2023-06-05T06:13:00+10:00,2023-06-05,06:13,1,1,2
14,2023-06-05T06:13:00+10:00,2023-06-05,06:13,0,3,3
36,2023-06-05T06:13:00+10:00,2023-06-05,06:13,1,0,1
55,2023-06-05T06:13:00+10:00,2023-06-05,06:13,3,1,4
9,2023-06-05T06:13:00+10:00,2023-06-05,06:13,0,3,3
17,2023-06-05T06:13:00+10:00,2023-06-05,06:13,1,1,2
24,2023-06-05T06:13:00+10:00,2023-06-05,06:13,3,1,4
48,2023-06-05T06:13:00+10:00,2023-06-05,06:13,0,1,1
72,2023-06-05T06:13:00+10:00,2023-06-05,06:13,3,5,8
86,2023-06-05T06:13:00+10:00,2023-06-05,06:13,1,0,1
3,2023-06-05T06:13:00+10:00,2023-06-05,06:13,1,1,2
5,2023-06-05T06:13:00+10:00,2023-06-05,06:13,2,3,5
21,2023-06-05T06:13:00+10:00,2023-06-05,06:13,4,0,4
26,2023-06-05T06:13:00+10:00,2023-06-05,06:13,1,1,2
41,2023-06-05T06:13:00+10:00,2023-06-05,06:13,1,3,4
47,2023-06-05T06:13:00+10:00,2023-06-05,06:13,0,10,10
23,2023-06-05T06:13:00+10:00,2023-06-05,06:13,1,1,2
58,2023-06-05T06:13:00+10:00,2023-06-05,06:13,1,0,1
62,2023-06-05T06:13:00+10:00,2023-06-05,06:13,1,0,1
67,2023-06-05T06:13:00+10:00,2023-06-05,06:13,2,2,4
5,2023-06-05T06:12:00+10:00,2023-06-05,06:12,0,1,1
21,2023-06-05T06:12:00+10:00,2023-06-05,06:12,0,1,1
61,2023-06-05T06:12:00+10:00,2023-06-05,06:12,2,1,3
87,2023-06-05T06:12:00+10:00,2023-06-05,06:12,2,0,2
9,2023-06-05T06:12:00+10:00,2023-06-05,06:12,0,2,2
10,2023-06-05T06:12:00+10:00,2023-06-05,06:12,1,0,1
19,2023-06-05T06:12:00+10:00,2023-06-05,06:12,0,1,1
23,2023-06-05T06:12:00+10:00,2023-06-05,06:12,1,0,1
27,2023-06-05T06:12:00+10:00,2023-06-05,06:12,0,2,2
48,2023-06-05T06:12:00+10:00,2023-06-05,06:12,1,0,1
52,2023-06-05T06:12:00+10:00,2023-06-05,06:12,0,1,1
67,2023-06-05T06:12:00+10:00,2023-06-05,06:12,4,1,5
4,2023-06-05T06:12:00+10:00,2023-06-05,06:12,0,1,1
29,2023-06-05T06:12:00+10:00,2023-06-05,06:12,0,1,1
47,2023-06-05T06:12:00+10:00,2023-06-05,06:12,0,3,3
66,2023-06-05T06:12:00+10:00,2023-06-05,06:12,0,1,1
77,2023-06-05T06:12:00+10:00,2023-06-05,06:12,0,1,1
108,2023-06-05T06:12:00+10:00,2023-06-05,06:12,0,5,5
24,2023-06-05T06:12:00+10:00,2023-06-05,06:12,5,1,6
57,2023-06-05T06:12:00+10:00,2023-06-05,06:12,0,2,2
85,2023-06-05T06:12:00+10:00,2023-06-05,06:12,1,0,1
6,2023-06-05T06:12:00+10:00,2023-06-05,06:12,2,0,2
28,2023-06-05T06:12:00+10:00,2023-06-05,06:12,0,2,2
40,2023-06-05T06:12:00+10:00,2023-06-05,06:12,0,1,1
41,2023-06-05T06:12:00+10:00,2023-06-05,06:12,1,1,2
42,2023-06-05T06:12:00+10:00,2023-06-05,06:12,0,1,1
55,2023-06-05T06:12:00+10:00,2023-06-05,06:12,1,1,2
17,2023-06-05T06:12:00+10:00,2023-06-05,06:12,1,0,1
35,2023-06-05T06:12:00+10:00,2023-06-05,06:12,2,0,2
62,2023-06-05T06:12:00+10:00,2023-06-05,06:12,2,0,2
72,2023-06-05T06:12:00+10:00,2023-06-05,06:12,2,4,6
4,2023-06-05T06:11:00+10:00,2023-06-05,06:11,0,4,4
5,2023-06-05T06:11:00+10:00,2023-06-05,06:11,0,1,1
6,2023-06-05T06:11:00+10:00,2023-06-05,06:11,2,0,2
8,2023-06-05T06:11:00+10:00,2023-06-05,06:11,0,1,1
21,2023-06-05T06:11:00+10:00,2023-06-05,06:11,0,1,1
36,2023-06-05T06:11:00+10:00,2023-06-05,06:11,2,0,2
41,2023-06-05T06:11:00+10:00,2023-06-05,06:11,4,4,8
45,2023-06-05T06:11:00+10:00,2023-06-05,06:11,0,2,2
77,2023-06-05T06:11:00+10:00,2023-06-05,06:11,0,1,1
17,2023-06-05T06:11:00+10:00,2023-06-05,06:11,7,2,9
24,2023-06-05T06:11:00+10:00,2023-06-05,06:11,1,5,6
35,2023-06-05T06:11:00+10:00,2023-06-05,06:11,2,0,2
48,2023-06-05T06:11:00+10:00,2023-06-05,06:11,1,0,1
72,2023-06-05T06:11:00+10:00,2023-06-05,06:11,0,2,2
14,2023-06-05T06:11:00+10:00,2023-06-05,06:11,2,0,2
47,2023-06-05T06:11:00+10:00,2023-06-05,06:11,1,1,2
50,2023-06-05T06:11:00+10:00,2023-06-05,06:11,0,1,1
54,2023-06-05T06:11:00+10:00,2023-06-05,06:11,2,0,2
55,2023-06-05T06:11:00+10:00,2023-06-05,06:11,2,2,4
61,2023-06-05T06:11:00+10:00,2023-06-05,06:11,2,2,4
66,2023-06-05T06:11:00+10:00,2023-06-05,06:11,0,1,1
71,2023-06-05T06:11:00+10:00,2023-06-05,06:11,2,0,2
108,2023-06-05T06:11:00+10:00,2023-06-05,06:11,0,1,1
19,2023-06-05T06:11:00+10:00,2023-06-05,06:11,2,0,2
23,2023-06-05T06:11:00+10:00,2023-06-05,06:11,2,0,2
52,2023-06-05T06:11:00+10:00,2023-06-05,06:11,0,1,1
62,2023-06-05T06:11:00+10:00,2023-06-05,06:11,1,0,1
79,2023-06-05T06:11:00+10:00,2023-06-05,06:11,1,2,3
29,2023-06-05T06:11:00+10:00,2023-06-05,06:11,3,0,3
40,2023-06-05T06:11:00+10:00,2023-06-05,06:11,1,1,2
9,2023-06-05T06:11:00+10:00,2023-06-05,06:11,0,1,1
49,2023-06-05T06:11:00+10:00,2023-06-05,06:11,2,0,2
57,2023-06-05T06:11:00+10:00,2023-06-05,06:11,1,1,2
58,2023-06-05T06:11:00+10:00,2023-06-05,06:11,1,0,1
67,2023-06-05T06:11:00+10:00,2023-06-05,06:11,1,1,2
85,2023-06-05T06:11:00+10:00,2023-06-05,06:11,0,1,1
5,2023-06-05T06:10:00+10:00,2023-06-05,06:10,0,1,1
28,2023-06-05T06:10:00+10:00,2023-06-05,06:10,0,1,1
41,2023-06-05T06:10:00+10:00,2023-06-05,06:10,3,3,6
69,2023-06-05T06:10:00+10:00,2023-06-05,06:10,5,0,5
107,2023-06-05T06:10:00+10:00,2023-06-05,06:10,0,1,1
9,2023-06-05T06:10:00+10:00,2023-06-05,06:10,1,0,1
17,2023-06-05T06:10:00+10:00,2023-06-05,06:10,1,4,5
23,2023-06-05T06:10:00+10:00,2023-06-05,06:10,0,1,1
48,2023-06-05T06:10:00+10:00,2023-06-05,06:10,1,0,1
58,2023-06-05T06:10:00+10:00,2023-06-05,06:10,0,1,1
72,2023-06-05T06:10:00+10:00,2023-06-05,06:10,3,5,8
117,2023-06-05T06:10:00+10:00,2023-06-05,06:10,1,2,3
6,2023-06-05T06:10:00+10:00,2023-06-05,06:10,3,0,3
21,2023-06-05T06:10:00+10:00,2023-06-05,06:10,0,1,1
26,2023-06-05T06:10:00+10:00,2023-06-05,06:10,1,0,1
40,2023-06-05T06:10:00+10:00,2023-06-05,06:10,1,3,4
55,2023-06-05T06:10:00+10:00,2023-06-05,06:10,3,5,8
84,2023-06-05T06:10:00+10:00,2023-06-05,06:10,5,6,11
12,2023-06-05T06:10:00+10:00,2023-06-05,06:10,3,1,4
18,2023-06-05T06:10:00+10:00,2023-06-05,06:10,0,3,3
19,2023-06-05T06:10:00+10:00,2023-06-05,06:10,1,0,1
27,2023-06-05T06:10:00+10:00,2023-06-05,06:10,0,1,1
35,2023-06-05T06:10:00+10:00,2023-06-05,06:10,3,2,5
62,2023-06-05T06:10:00+10:00,2023-06-05,06:10,1,0,1
67,2023-06-05T06:10:00+10:00,2023-06-05,06:10,0,2,2
3,2023-06-05T06:10:00+10:00,2023-06-05,06:10,2,1,3
29,2023-06-05T06:10:00+10:00,2023-06-05,06:10,1,0,1
45,2023-06-05T06:10:00+10:00,2023-06-05,06:10,1,1,2
66,2023-06-05T06:10:00+10:00,2023-06-05,06:10,1,1,2
10,2023-06-05T06:10:00+10:00,2023-06-05,06:10,2,1,3
24,2023-06-05T06:10:00+10:00,2023-06-05,06:10,1,3,4
46,2023-06-05T06:10:00+10:00,2023-06-05,06:10,1,1,2
51,2023-06-05T06:10:00+10:00,2023-06-05,06:10,1,0,1
79,2023-06-05T06:10:00+10:00,2023-06-05,06:10,2,1,3
109,2023-06-05T06:10:00+10:00,2023-06-05,06:10,0,7,7
21,2023-06-05T06:09:00+10:00,2023-06-05,06:09,0,1,1
29,2023-06-05T06:09:00+10:00,2023-06-05,06:09,0,1,1
36,2023-06-05T06:09:00+10:00,2023-06-05,06:09,1,0,1
39,2023-06-05T06:09:00+10:00,2023-06-05,06:09,1,0,1
45,2023-06-05T06:09:00+10:00,2023-06-05,06:09,0,1,1
61,2023-06-05T06:09:00+10:00,2023-06-05,06:09,1,2,3
69,2023-06-05T06:09:00+10:00,2023-06-05,06:09,2,2,4
20,2023-06-05T06:09:00+10:00,2023-06-05,06:09,0,1,1
6,2023-06-05T06:09:00+10:00,2023-06-05,06:09,3,0,3
26,2023-06-05T06:09:00+10:00,2023-06-05,06:09,0,4,4
28,2023-06-05T06:09:00+10:00,2023-06-05,06:09,0,1,1
47,2023-06-05T06:09:00+10:00,2023-06-05,06:09,1,3,4
65,2023-06-05T06:09:00+10:00,2023-06-05,06:09,1,0,1
9,2023-06-05T06:09:00+10:00,2023-06-05,06:09,0,2,2
24,2023-06-05T06:09:00+10:00,2023-06-05,06:09,4,2,6
52,2023-06-05T06:09:00+10:00,2023-06-05,06:09,0,1,1
57,2023-06-05T06:09:00+10:00,2023-06-05,06:09,0,1,1
58,2023-06-05T06:09:00+10:00,2023-06-05,06:09,1,0,1
72,2023-06-05T06:09:00+10:00,2023-06-05,06:09,2,0,2
3,2023-06-05T06:09:00+10:00,2023-06-05,06:09,0,2,2
5,2023-06-05T06:09:00+10:00,2023-06-05,06:09,1,1,2
41,2023-06-05T06:09:00+10:00,2023-06-05,06:09,2,2,4
55,2023-06-05T06:09:00+10:00,2023-06-05,06:09,2,4,6
75,2023-06-05T06:09:00+10:00,2023-06-05,06:09,2,0,2
87,2023-06-05T06:09:00+10:00,2023-06-05,06:09,1,0,1
108,2023-06-05T06:09:00+10:00,2023-06-05,06:09,1,0,1
35,2023-06-05T06:09:00+10:00,2023-06-05,06:09,1,1,2
62,2023-06-05T06:09:00+10:00,2023-06-05,06:09,1,0,1
67,2023-06-05T06:09:00+10:00,2023-06-05,06:09,0,1,1
26,2023-06-05T06:08:00+10:00,2023-06-05,06:08,1,1,2
61,2023-06-05T06:08:00+10:00,2023-06-05,06:08,0,1,1
57,2023-06-05T06:08:00+10:00,2023-06-05,06:08,1,1,2
58,2023-06-05T06:08:00+10:00,2023-06-05,06:08,2,0,2
79,2023-06-05T06:08:00+10:00,2023-06-05,06:08,2,3,5
4,2023-06-05T06:08:00+10:00,2023-06-05,06:08,2,1,3
6,2023-06-05T06:08:00+10:00,2023-06-05,06:08,2,4,6
40,2023-06-05T06:08:00+10:00,2023-06-05,06:08,0,1,1
47,2023-06-05T06:08:00+10:00,2023-06-05,06:08,1,0,1
71,2023-06-05T06:08:00+10:00,2023-06-05,06:08,1,0,1
108,2023-06-05T06:08:00+10:00,2023-06-05,06:08,1,2,3
10,2023-06-05T06:08:00+10:00,2023-06-05,06:08,0,2,2
35,2023-06-05T06:08:00+10:00,2023-06-05,06:08,7,2,9
53,2023-06-05T06:08:00+10:00,2023-06-05,06:08,0,2,2
5,2023-06-05T06:08:00+10:00,2023-06-05,06:08,0,1,1
29,2023-06-05T06:08:00+10:00,2023-06-05,06:08,1,0,1
36,2023-06-05T06:08:00+10:00,2023-06-05,06:08,2,0,2
41,2023-06-05T06:08:00+10:00,2023-06-05,06:08,2,4,6
55,2023-06-05T06:08:00+10:00,2023-06-05,06:08,0,1,1
23,2023-06-05T06:08:00+10:00,2023-06-05,06:08,0,1,1
24,2023-06-05T06:08:00+10:00,2023-06-05,06:08,6,0,6
30,2023-06-05T06:08:00+10:00,2023-06-05,06:08,1,0,1
62,2023-06-05T06:08:00+10:00,2023-06-05,06:08,1,0,1
72,2023-06-05T06:08:00+10:00,2023-06-05,06:08,2,1,3
3,2023-06-05T06:07:00+10:00,2023-06-05,06:07,0,2,2
5,2023-06-05T06:07:00+10:00,2023-06-05,06:07,4,2,6
6,2023-06-05T06:07:00+10:00,2023-06-05,06:07,0,1,1
29,2023-06-05T06:07:00+10:00,2023-06-05,06:07,0,1,1
66,2023-06-05T06:07:00+10:00,2023-06-05,06:07,2,0,2
9,2023-06-05T06:07:00+10:00,2023-06-05,06:07,0,5,5
12,2023-06-05T06:07:00+10:00,2023-06-05,06:07,1,0,1
27,2023-06-05T06:07:00+10:00,2023-06-05,06:07,2,0,2
35,2023-06-05T06:07:00+10:00,2023-06-05,06:07,4,1,5
58,2023-06-05T06:07:00+10:00,2023-06-05,06:07,4,0,4
72,2023-06-05T06:07:00+10:00,2023-06-05,06:07,0,1,1
76,2023-06-05T06:07:00+10:00,2023-06-05,06:07,1,0,1
85,2023-06-05T06:07:00+10:00,2023-06-05,06:07,0,1,1
39,2023-06-05T06:07:00+10:00,2023-06-05,06:07,1,0,1
40,2023-06-05T06:07:00+10:00,2023-06-05,06:07,0,1,1
47,2023-06-05T06:07:00+10:00,2023-06-05,06:07,0,2,2
55,2023-06-05T06:07:00+10:00,2023-06-05,06:07,0,3,3
65,2023-06-05T06:07:00+10:00,2023-06-05,06:07,0,1,1
87,2023-06-05T06:07:00+10:00,2023-06-05,06:07,1,2,3
108,2023-06-05T06:07:00+10:00,2023-06-05,06:07,0,1,1
17,2023-06-05T06:07:00+10:00,2023-06-05,06:07,1,0,1
46,2023-06-05T06:07:00+10:00,2023-06-05,06:07,0,2,2
57,2023-06-05T06:07:00+10:00,2023-06-05,06:07,1,0,1
67,2023-06-05T06:07:00+10:00,2023-06-05,06:07,1,2,3
4,2023-06-05T06:07:00+10:00,2023-06-05,06:07,1,0,1
8,2023-06-05T06:07:00+10:00,2023-06-05,06:07,0,1,1
14,2023-06-05T06:07:00+10:00,2023-06-05,06:07,1,4,5
26,2023-06-05T06:07:00+10:00,2023-06-05,06:07,0,2,2
28,2023-06-05T06:07:00+10:00,2023-06-05,06:07,1,1,2
41,2023-06-05T06:07:00+10:00,2023-06-05,06:07,0,3,3
24,2023-06-05T06:07:00+10:00,2023-06-05,06:07,12,3,15
30,2023-06-05T06:07:00+10:00,2023-06-05,06:07,1,0,1
21,2023-06-05T06:06:00+10:00,2023-06-05,06:06,0,2,2
28,2023-06-05T06:06:00+10:00,2023-06-05,06:06,2,0,2
41,2023-06-05T06:06:00+10:00,2023-06-05,06:06,3,0,3
47,2023-06-05T06:06:00+10:00,2023-06-05,06:06,1,1,2
9,2023-06-05T06:06:00+10:00,2023-06-05,06:06,0,4,4
12,2023-06-05T06:06:00+10:00,2023-06-05,06:06,0,1,1
19,2023-06-05T06:06:00+10:00,2023-06-05,06:06,0,1,1
35,2023-06-05T06:06:00+10:00,2023-06-05,06:06,1,1,2
57,2023-06-05T06:06:00+10:00,2023-06-05,06:06,0,4,4
86,2023-06-05T06:06:00+10:00,2023-06-05,06:06,2,0,2
4,2023-06-05T06:06:00+10:00,2023-06-05,06:06,3,0,3
36,2023-06-05T06:06:00+10:00,2023-06-05,06:06,1,0,1
61,2023-06-05T06:06:00+10:00,2023-06-05,06:06,1,1,2
65,2023-06-05T06:06:00+10:00,2023-06-05,06:06,1,2,3
2,2023-06-05T06:06:00+10:00,2023-06-05,06:06,0,1,1
17,2023-06-05T06:06:00+10:00,2023-06-05,06:06,1,0,1
24,2023-06-05T06:06:00+10:00,2023-06-05,06:06,7,1,8
58,2023-06-05T06:06:00+10:00,2023-06-05,06:06,7,0,7
72,2023-06-05T06:06:00+10:00,2023-06-05,06:06,1,1,2
79,2023-06-05T06:06:00+10:00,2023-06-05,06:06,0,1,1
85,2023-06-05T06:06:00+10:00,2023-06-05,06:06,1,1,2
3,2023-06-05T06:06:00+10:00,2023-06-05,06:06,2,0,2
5,2023-06-05T06:06:00+10:00,2023-06-05,06:06,1,0,1
14,2023-06-05T06:06:00+10:00,2023-06-05,06:06,0,2,2
26,2023-06-05T06:06:00+10:00,2023-06-05,06:06,2,0,2
87,2023-06-05T06:06:00+10:00,2023-06-05,06:06,1,0,1
108,2023-06-05T06:06:00+10:00,2023-06-05,06:06,0,1,1
10,2023-06-05T06:06:00+10:00,2023-06-05,06:06,0,2,2
20,2023-06-05T06:06:00+10:00,2023-06-05,06:06,0,1,1
23,2023-06-05T06:06:00+10:00,2023-06-05,06:06,3,1,4
30,2023-06-05T06:06:00+10:00,2023-06-05,06:06,0,1,1
48,2023-06-05T06:06:00+10:00,2023-06-05,06:06,1,0,1
5,2023-06-05T06:05:00+10:00,2023-06-05,06:05,1,1,2
14,2023-06-05T06:05:00+10:00,2023-06-05,06:05,0,1,1
26,2023-06-05T06:05:00+10:00,2023-06-05,06:05,1,1,2
28,2023-06-05T06:05:00+10:00,2023-06-05,06:05,2,0,2
29,2023-06-05T06:05:00+10:00,2023-06-05,06:05,1,0,1
107,2023-06-05T06:05:00+10:00,2023-06-05,06:05,1,2,3
108,2023-06-05T06:05:00+10:00,2023-06-05,06:05,1,3,4
23,2023-06-05T06:05:00+10:00,2023-06-05,06:05,1,2,3
58,2023-06-05T06:05:00+10:00,2023-06-05,06:05,6,0,6
41,2023-06-05T06:05:00+10:00,2023-06-05,06:05,7,1,8
45,2023-06-05T06:05:00+10:00,2023-06-05,06:05,0,4,4
47,2023-06-05T06:05:00+10:00,2023-06-05,06:05,0,1,1
54,2023-06-05T06:05:00+10:00,2023-06-05,06:05,2,0,2
84,2023-06-05T06:05:00+10:00,2023-06-05,06:05,4,5,9
118,2023-06-05T06:05:00+10:00,2023-06-05,06:05,0,1,1
17,2023-06-05T06:05:00+10:00,2023-06-05,06:05,1,0,1
18,2023-06-05T06:05:00+10:00,2023-06-05,06:05,0,2,2
24,2023-06-05T06:05:00+10:00,2023-06-05,06:05,6,1,7
35,2023-06-05T06:05:00+10:00,2023-06-05,06:05,1,5,6
48,2023-06-05T06:05:00+10:00,2023-06-05,06:05,1,2,3
52,2023-06-05T06:05:00+10:00,2023-06-05,06:05,3,0,3
67,2023-06-05T06:05:00+10:00,2023-06-05,06:05,1,0,1
79,2023-06-05T06:05:00+10:00,2023-06-05,06:05,1,2,3
4,2023-06-05T06:05:00+10:00,2023-06-05,06:05,1,0,1
6,2023-06-05T06:05:00+10:00,2023-06-05,06:05,0,2,2
61,2023-06-05T06:05:00+10:00,2023-06-05,06:05,1,1,2
65,2023-06-05T06:05:00+10:00,2023-06-05,06:05,2,0,2
30,2023-06-05T06:05:00+10:00,2023-06-05,06:05,0,1,1
57,2023-06-05T06:05:00+10:00,2023-06-05,06:05,1,3,4
62,2023-06-05T06:05:00+10:00,2023-06-05,06:05,1,0,1
72,2023-06-05T06:05:00+10:00,2023-06-05,06:05,2,0,2
86,2023-06-05T06:05:00+10:00,2023-06-05,06:05,1,0,1
109,2023-06-05T06:05:00+10:00,2023-06-05,06:05,1,3,4
117,2023-06-05T06:05:00+10:00,2023-06-05,06:05,1,2,3
3,2023-06-05T06:04:00+10:00,2023-06-05,06:04,1,3,4
5,2023-06-05T06:04:00+10:00,2023-06-05,06:04,2,7,9
36,2023-06-05T06:04:00+10:00,2023-06-05,06:04,0,3,3
40,2023-06-05T06:04:00+10:00,2023-06-05,06:04,0,1,1
41,2023-06-05T06:04:00+10:00,2023-06-05,06:04,5,0,5
65,2023-06-05T06:04:00+10:00,2023-06-05,06:04,2,0,2
66,2023-06-05T06:04:00+10:00,2023-06-05,06:04,1,2,3
17,2023-06-05T06:04:00+10:00,2023-06-05,06:04,3,0,3
52,2023-06-05T06:04:00+10:00,2023-06-05,06:04,1,0,1
58,2023-06-05T06:04:00+10:00,2023-06-05,06:04,3,0,3
62,2023-06-05T06:04:00+10:00,2023-06-05,06:04,1,0,1
72,2023-06-05T06:04:00+10:00,2023-06-05,06:04,0,1,1
4,2023-06-05T06:04:00+10:00,2023-06-05,06:04,1,0,1
6,2023-06-05T06:04:00+10:00,2023-06-05,06:04,3,5,8
45,2023-06-05T06:04:00+10:00,2023-06-05,06:04,5,0,5
75,2023-06-05T06:04:00+10:00,2023-06-05,06:04,0,1,1
77,2023-06-05T06:04:00+10:00,2023-06-05,06:04,0,1,1
108,2023-06-05T06:04:00+10:00,2023-06-05,06:04,0,1,1
1,2023-06-05T06:04:00+10:00,2023-06-05,06:04,1,1,2
18,2023-06-05T06:04:00+10:00,2023-06-05,06:04,0,1,1
30,2023-06-05T06:04:00+10:00,2023-06-05,06:04,0,1,1
35,2023-06-05T06:04:00+10:00,2023-06-05,06:04,0,2,2
46,2023-06-05T06:04:00+10:00,2023-06-05,06:04,1,0,1
49,2023-06-05T06:04:00+10:00,2023-06-05,06:04,0,1,1
57,2023-06-05T06:04:00+10:00,2023-06-05,06:04,4,2,6
14,2023-06-05T06:04:00+10:00,2023-06-05,06:04,0,1,1
28,2023-06-05T06:04:00+10:00,2023-06-05,06:04,2,0,2
29,2023-06-05T06:04:00+10:00,2023-06-05,06:04,2,0,2
47,2023-06-05T06:04:00+10:00,2023-06-05,06:04,0,1,1
55,2023-06-05T06:04:00+10:00,2023-06-05,06:04,0,2,2
61,2023-06-05T06:04:00+10:00,2023-06-05,06:04,2,0,2
9,2023-06-05T06:04:00+10:00,2023-06-05,06:04,0,1,1
20,2023-06-05T06:04:00+10:00,2023-06-05,06:04,0,2,2
24,2023-06-05T06:04:00+10:00,2023-06-05,06:04,9,1,10
67,2023-06-05T06:04:00+10:00,2023-06-05,06:04,1,2,3
79,2023-06-05T06:04:00+10:00,2023-06-05,06:04,1,0,1
14,2023-06-05T06:03:00+10:00,2023-06-05,06:03,0,2,2
26,2023-06-05T06:03:00+10:00,2023-06-05,06:03,0,1,1
28,2023-06-05T06:03:00+10:00,2023-06-05,06:03,1,0,1
40,2023-06-05T06:03:00+10:00,2023-06-05,06:03,1,1,2
55,2023-06-05T06:03:00+10:00,2023-06-05,06:03,2,3,5
87,2023-06-05T06:03:00+10:00,2023-06-05,06:03,0,1,1
24,2023-06-05T06:03:00+10:00,2023-06-05,06:03,3,4,7
49,2023-06-05T06:03:00+10:00,2023-06-05,06:03,0,1,1
51,2023-06-05T06:03:00+10:00,2023-06-05,06:03,2,0,2
52,2023-06-05T06:03:00+10:00,2023-06-05,06:03,1,0,1
58,2023-06-05T06:03:00+10:00,2023-06-05,06:03,3,1,4
3,2023-06-05T06:03:00+10:00,2023-06-05,06:03,1,0,1
5,2023-06-05T06:03:00+10:00,2023-06-05,06:03,1,0,1
6,2023-06-05T06:03:00+10:00,2023-06-05,06:03,2,12,14
29,2023-06-05T06:03:00+10:00,2023-06-05,06:03,2,1,3
41,2023-06-05T06:03:00+10:00,2023-06-05,06:03,4,1,5
61,2023-06-05T06:03:00+10:00,2023-06-05,06:03,0,1,1
66,2023-06-05T06:03:00+10:00,2023-06-05,06:03,0,2,2
69,2023-06-05T06:03:00+10:00,2023-06-05,06:03,1,0,1
108,2023-06-05T06:03:00+10:00,2023-06-05,06:03,0,3,3
1,2023-06-05T06:03:00+10:00,2023-06-05,06:03,0,1,1
53,2023-06-05T06:03:00+10:00,2023-06-05,06:03,0,1,1
4,2023-06-05T06:03:00+10:00,2023-06-05,06:03,3,1,4
36,2023-06-05T06:03:00+10:00,2023-06-05,06:03,1,0,1
47,2023-06-05T06:03:00+10:00,2023-06-05,06:03,0,1,1
9,2023-06-05T06:03:00+10:00,2023-06-05,06:03,1,1,2
23,2023-06-05T06:03:00+10:00,2023-06-05,06:03,0,1,1
35,2023-06-05T06:03:00+10:00,2023-06-05,06:03,0,1,1
57,2023-06-05T06:03:00+10:00,2023-06-05,06:03,2,1,3
62,2023-06-05T06:03:00+10:00,2023-06-05,06:03,2,0,2
67,2023-06-05T06:03:00+10:00,2023-06-05,06:03,1,0,1
72,2023-06-05T06:03:00+10:00,2023-06-05,06:03,0,1,1
79,2023-06-05T06:03:00+10:00,2023-06-05,06:03,1,1,2
4,2023-06-05T06:02:00+10:00,2023-06-05,06:02,4,0,4
21,2023-06-05T06:02:00+10:00,2023-06-05,06:02,0,1,1
39,2023-06-05T06:02:00+10:00,2023-06-05,06:02,1,0,1
40,2023-06-05T06:02:00+10:00,2023-06-05,06:02,0,1,1
55,2023-06-05T06:02:00+10:00,2023-06-05,06:02,3,1,4
61,2023-06-05T06:02:00+10:00,2023-06-05,06:02,2,0,2
77,2023-06-05T06:02:00+10:00,2023-06-05,06:02,0,1,1
87,2023-06-05T06:02:00+10:00,2023-06-05,06:02,0,1,1
108,2023-06-05T06:02:00+10:00,2023-06-05,06:02,0,2,2
10,2023-06-05T06:02:00+10:00,2023-06-05,06:02,0,1,1
19,2023-06-05T06:02:00+10:00,2023-06-05,06:02,0,2,2
30,2023-06-05T06:02:00+10:00,2023-06-05,06:02,0,9,9
49,2023-06-05T06:02:00+10:00,2023-06-05,06:02,1,0,1
57,2023-06-05T06:02:00+10:00,2023-06-05,06:02,1,2,3
5,2023-06-05T06:02:00+10:00,2023-06-05,06:02,0,2,2
6,2023-06-05T06:02:00+10:00,2023-06-05,06:02,1,3,4
14,2023-06-05T06:02:00+10:00,2023-06-05,06:02,0,1,1
29,2023-06-05T06:02:00+10:00,2023-06-05,06:02,0,1,1
1,2023-06-05T06:02:00+10:00,2023-06-05,06:02,0,1,1
9,2023-06-05T06:02:00+10:00,2023-06-05,06:02,1,0,1
17,2023-06-05T06:02:00+10:00,2023-06-05,06:02,1,0,1
23,2023-06-05T06:02:00+10:00,2023-06-05,06:02,1,1,2
58,2023-06-05T06:02:00+10:00,2023-06-05,06:02,1,0,1
67,2023-06-05T06:02:00+10:00,2023-06-05,06:02,0,1,1
72,2023-06-05T06:02:00+10:00,2023-06-05,06:02,1,1,2
79,2023-06-05T06:02:00+10:00,2023-06-05,06:02,5,0,5
41,2023-06-05T06:02:00+10:00,2023-06-05,06:02,4,2,6
65,2023-06-05T06:02:00+10:00,2023-06-05,06:02,0,2,2
66,2023-06-05T06:02:00+10:00,2023-06-05,06:02,0,2,2
70,2023-06-05T06:02:00+10:00,2023-06-05,06:02,1,0,1
75,2023-06-05T06:02:00+10:00,2023-06-05,06:02,0,2,2
24,2023-06-05T06:02:00+10:00,2023-06-05,06:02,0,6,6
35,2023-06-05T06:02:00+10:00,2023-06-05,06:02,2,2,4
51,2023-06-05T06:02:00+10:00,2023-06-05,06:02,0,2,2
53,2023-06-05T06:02:00+10:00,2023-06-05,06:02,0,1,1
62,2023-06-05T06:02:00+10:00,2023-06-05,06:02,2,0,2
3,2023-06-05T06:01:00+10:00,2023-06-05,06:01,0,2,2
5,2023-06-05T06:01:00+10:00,2023-06-05,06:01,0,3,3
6,2023-06-05T06:01:00+10:00,2023-06-05,06:01,1,2,3
70,2023-06-05T06:01:00+10:00,2023-06-05,06:01,0,1,1
75,2023-06-05T06:01:00+10:00,2023-06-05,06:01,0,1,1
23,2023-06-05T06:01:00+10:00,2023-06-05,06:01,2,0,2
46,2023-06-05T06:01:00+10:00,2023-06-05,06:01,0,1,1
57,2023-06-05T06:01:00+10:00,2023-06-05,06:01,2,0,2
67,2023-06-05T06:01:00+10:00,2023-06-05,06:01,0,3,3
79,2023-06-05T06:01:00+10:00,2023-06-05,06:01,0,2,2
8,2023-06-05T06:01:00+10:00,2023-06-05,06:01,0,1,1
28,2023-06-05T06:01:00+10:00,2023-06-05,06:01,1,2,3
29,2023-06-05T06:01:00+10:00,2023-06-05,06:01,0,1,1
41,2023-06-05T06:01:00+10:00,2023-06-05,06:01,14,0,14
66,2023-06-05T06:01:00+10:00,2023-06-05,06:01,0,1,1
18,2023-06-05T06:01:00+10:00,2023-06-05,06:01,0,5,5
24,2023-06-05T06:01:00+10:00,2023-06-05,06:01,2,0,2
21,2023-06-05T06:01:00+10:00,2023-06-05,06:01,0,1,1
26,2023-06-05T06:01:00+10:00,2023-06-05,06:01,1,0,1
55,2023-06-05T06:01:00+10:00,2023-06-05,06:01,0,2,2
77,2023-06-05T06:01:00+10:00,2023-06-05,06:01,0,1,1
108,2023-06-05T06:01:00+10:00,2023-06-05,06:01,0,1,1
9,2023-06-05T06:01:00+10:00,2023-06-05,06:01,1,1,2
17,2023-06-05T06:01:00+10:00,2023-06-05,06:01,2,0,2
19,2023-06-05T06:01:00+10:00,2023-06-05,06:01,1,0,1
30,2023-06-05T06:01:00+10:00,2023-06-05,06:01,1,1,2
58,2023-06-05T06:01:00+10:00,2023-06-05,06:01,5,0,5
62,2023-06-05T06:01:00+10:00,2023-06-05,06:01,1,0,1
72,2023-06-05T06:01:00+10:00,2023-06-05,06:01,5,1,6
37,2023-06-05T06:00:00+10:00,2023-06-05,06:00,1,0,1
41,2023-06-05T06:00:00+10:00,2023-06-05,06:00,5,4,9
45,2023-06-05T06:00:00+10:00,2023-06-05,06:00,4,2,6
71,2023-06-05T06:00:00+10:00,2023-06-05,06:00,0,1,1
118,2023-06-05T06:00:00+10:00,2023-06-05,06:00,1,2,3
17,2023-06-05T06:00:00+10:00,2023-06-05,06:00,1,0,1
49,2023-06-05T06:00:00+10:00,2023-06-05,06:00,2,0,2
67,2023-06-05T06:00:00+10:00,2023-06-05,06:00,1,0,1
79,2023-06-05T06:00:00+10:00,2023-06-05,06:00,0,3,3
109,2023-06-05T06:00:00+10:00,2023-06-05,06:00,1,4,5
117,2023-06-05T06:00:00+10:00,2023-06-05,06:00,1,1,2
5,2023-06-05T06:00:00+10:00,2023-06-05,06:00,1,3,4
6,2023-06-05T06:00:00+10:00,2023-06-05,06:00,2,3,5
26,2023-06-05T06:00:00+10:00,2023-06-05,06:00,1,0,1
36,2023-06-05T06:00:00+10:00,2023-06-05,06:00,0,1,1
40,2023-06-05T06:00:00+10:00,2023-06-05,06:00,2,2,4
55,2023-06-05T06:00:00+10:00,2023-06-05,06:00,2,1,3
65,2023-06-05T06:00:00+10:00,2023-06-05,06:00,1,0,1
84,2023-06-05T06:00:00+10:00,2023-06-05,06:00,8,6,14
107,2023-06-05T06:00:00+10:00,2023-06-05,06:00,1,1,2
2,2023-06-05T06:00:00+10:00,2023-06-05,06:00,0,1,1
18,2023-06-05T06:00:00+10:00,2023-06-05,06:00,0,2,2
24,2023-06-05T06:00:00+10:00,2023-06-05,06:00,2,1,3
35,2023-06-05T06:00:00+10:00,2023-06-05,06:00,3,3,6
52,2023-06-05T06:00:00+10:00,2023-06-05,06:00,1,0,1
58,2023-06-05T06:00:00+10:00,2023-06-05,06:00,1,5,6
62,2023-06-05T06:00:00+10:00,2023-06-05,06:00,1,0,1
72,2023-06-05T06:00:00+10:00,2023-06-05,06:00,0,2,2
28,2023-06-05T06:00:00+10:00,2023-06-05,06:00,1,0,1
87,2023-06-05T06:00:00+10:00,2023-06-05,06:00,0,1,1
9,2023-06-05T06:00:00+10:00,2023-06-05,06:00,1,1,2
57,2023-06-05T06:00:00+10:00,2023-06-05,06:00,0,1,1
29,2023-06-05T05:59:00+10:00,2023-06-05,05:59,2,0,2
40,2023-06-05T05:59:00+10:00,2023-06-05,05:59,0,1,1
9,2023-06-05T05:59:00+10:00,2023-06-05,05:59,1,1,2
19,2023-06-05T05:59:00+10:00,2023-06-05,05:59,1,0,1
24,2023-06-05T05:59:00+10:00,2023-06-05,05:59,3,0,3
48,2023-06-05T05:59:00+10:00,2023-06-05,05:59,1,0,1
52,2023-06-05T05:59:00+10:00,2023-06-05,05:59,0,1,1
56,2023-06-05T05:59:00+10:00,2023-06-05,05:59,1,0,1
26,2023-06-05T05:59:00+10:00,2023-06-05,05:59,1,0,1
28,2023-06-05T05:59:00+10:00,2023-06-05,05:59,0,1,1
41,2023-06-05T05:59:00+10:00,2023-06-05,05:59,6,3,9
44,2023-06-05T05:59:00+10:00,2023-06-05,05:59,1,0,1
108,2023-06-05T05:59:00+10:00,2023-06-05,05:59,1,2,3
10,2023-06-05T05:59:00+10:00,2023-06-05,05:59,1,0,1
35,2023-06-05T05:59:00+10:00,2023-06-05,05:59,1,1,2
57,2023-06-05T05:59:00+10:00,2023-06-05,05:59,2,1,3
67,2023-06-05T05:59:00+10:00,2023-06-05,05:59,1,0,1
3,2023-06-05T05:59:00+10:00,2023-06-05,05:59,0,2,2
5,2023-06-05T05:59:00+10:00,2023-06-05,05:59,1,2,3
6,2023-06-05T05:59:00+10:00,2023-06-05,05:59,2,0,2
14,2023-06-05T05:59:00+10:00,2023-06-05,05:59,1,1,2
39,2023-06-05T05:59:00+10:00,2023-06-05,05:59,2,0,2
47,2023-06-05T05:59:00+10:00,2023-06-05,05:59,2,2,4
55,2023-06-05T05:59:00+10:00,2023-06-05,05:59,2,1,3
61,2023-06-05T05:59:00+10:00,2023-06-05,05:59,0,1,1
1,2023-06-05T05:59:00+10:00,2023-06-05,05:59,0,1,1
46,2023-06-05T05:59:00+10:00,2023-06-05,05:59,0,1,1
62,2023-06-05T05:59:00+10:00,2023-06-05,05:59,1,1,2
79,2023-06-05T05:59:00+10:00,2023-06-05,05:59,2,3,5
26,2023-06-05T05:58:00+10:00,2023-06-05,05:58,2,1,3
39,2023-06-05T05:58:00+10:00,2023-06-05,05:58,1,0,1
41,2023-06-05T05:58:00+10:00,2023-06-05,05:58,1,0,1
66,2023-06-05T05:58:00+10:00,2023-06-05,05:58,2,1,3
75,2023-06-05T05:58:00+10:00,2023-06-05,05:58,1,0,1
78,2023-06-05T05:58:00+10:00,2023-06-05,05:58,1,0,1
108,2023-06-05T05:58:00+10:00,2023-06-05,05:58,0,7,7
10,2023-06-05T05:58:00+10:00,2023-06-05,05:58,1,0,1
57,2023-06-05T05:58:00+10:00,2023-06-05,05:58,1,0,1
72,2023-06-05T05:58:00+10:00,2023-06-05,05:58,0,1,1
79,2023-06-05T05:58:00+10:00,2023-06-05,05:58,8,0,8
86,2023-06-05T05:58:00+10:00,2023-06-05,05:58,1,0,1
29,2023-06-05T05:58:00+10:00,2023-06-05,05:58,1,0,1
55,2023-06-05T05:58:00+10:00,2023-06-05,05:58,0,1,1
87,2023-06-05T05:58:00+10:00,2023-06-05,05:58,0,1,1
9,2023-06-05T05:58:00+10:00,2023-06-05,05:58,0,1,1
52,2023-06-05T05:58:00+10:00,2023-06-05,05:58,1,0,1
5,2023-06-05T05:58:00+10:00,2023-06-05,05:58,0,2,2
6,2023-06-05T05:58:00+10:00,2023-06-05,05:58,1,3,4
47,2023-06-05T05:58:00+10:00,2023-06-05,05:58,2,0,2
17,2023-06-05T05:58:00+10:00,2023-06-05,05:58,2,0,2
20,2023-06-05T05:58:00+10:00,2023-06-05,05:58,0,1,1
23,2023-06-05T05:58:00+10:00,2023-06-05,05:58,2,0,2
24,2023-06-05T05:58:00+10:00,2023-06-05,05:58,4,0,4
35,2023-06-05T05:58:00+10:00,2023-06-05,05:58,2,5,7
58,2023-06-05T05:58:00+10:00,2023-06-05,05:58,2,1,3
62,2023-06-05T05:58:00+10:00,2023-06-05,05:58,1,0,1
42,2023-06-05T05:57:00+10:00,2023-06-05,05:57,1,2,3
71,2023-06-05T05:57:00+10:00,2023-06-05,05:57,1,0,1
75,2023-06-05T05:57:00+10:00,2023-06-05,05:57,1,2,3
10,2023-06-05T05:57:00+10:00,2023-06-05,05:57,1,0,1
17,2023-06-05T05:57:00+10:00,2023-06-05,05:57,1,2,3
52,2023-06-05T05:57:00+10:00,2023-06-05,05:57,0,1,1
6,2023-06-05T05:57:00+10:00,2023-06-05,05:57,1,1,2
39,2023-06-05T05:57:00+10:00,2023-06-05,05:57,0,2,2
47,2023-06-05T05:57:00+10:00,2023-06-05,05:57,0,4,4
66,2023-06-05T05:57:00+10:00,2023-06-05,05:57,0,2,2
9,2023-06-05T05:57:00+10:00,2023-06-05,05:57,0,5,5
19,2023-06-05T05:57:00+10:00,2023-06-05,05:57,1,0,1
24,2023-06-05T05:57:00+10:00,2023-06-05,05:57,2,0,2
46,2023-06-05T05:57:00+10:00,2023-06-05,05:57,0,1,1
57,2023-06-05T05:57:00+10:00,2023-06-05,05:57,0,2,2
67,2023-06-05T05:57:00+10:00,2023-06-05,05:57,0,1,1
3,2023-06-05T05:57:00+10:00,2023-06-05,05:57,0,1,1
4,2023-06-05T05:57:00+10:00,2023-06-05,05:57,1,0,1
14,2023-06-05T05:57:00+10:00,2023-06-05,05:57,1,0,1
28,2023-06-05T05:57:00+10:00,2023-06-05,05:57,1,1,2
41,2023-06-05T05:57:00+10:00,2023-06-05,05:57,0,2,2
55,2023-06-05T05:57:00+10:00,2023-06-05,05:57,0,2,2
77,2023-06-05T05:57:00+10:00,2023-06-05,05:57,0,1,1
23,2023-06-05T05:57:00+10:00,2023-06-05,05:57,1,0,1
30,2023-06-05T05:57:00+10:00,2023-06-05,05:57,0,1,1
35,2023-06-05T05:57:00+10:00,2023-06-05,05:57,1,1,2
56,2023-06-05T05:57:00+10:00,2023-06-05,05:57,0,1,1
58,2023-06-05T05:57:00+10:00,2023-06-05,05:57,1,1,2
72,2023-06-05T05:57:00+10:00,2023-06-05,05:57,3,5,8
85,2023-06-05T05:57:00+10:00,2023-06-05,05:57,1,0,1
5,2023-06-05T05:56:00+10:00,2023-06-05,05:56,0,1,1
40,2023-06-05T05:56:00+10:00,2023-06-05,05:56,1,0,1
41,2023-06-05T05:56:00+10:00,2023-06-05,05:56,3,1,4
45,2023-06-05T05:56:00+10:00,2023-06-05,05:56,0,1,1
61,2023-06-05T05:56:00+10:00,2023-06-05,05:56,1,1,2
9,2023-06-05T05:56:00+10:00,2023-06-05,05:56,1,3,4
23,2023-06-05T05:56:00+10:00,2023-06-05,05:56,2,0,2
27,2023-06-05T05:56:00+10:00,2023-06-05,05:56,1,0,1
86,2023-06-05T05:56:00+10:00,2023-06-05,05:56,1,0,1
6,2023-06-05T05:56:00+10:00,2023-06-05,05:56,1,2,3
28,2023-06-05T05:56:00+10:00,2023-06-05,05:56,0,1,1
29,2023-06-05T05:56:00+10:00,2023-06-05,05:56,1,0,1
42,2023-06-05T05:56:00+10:00,2023-06-05,05:56,2,0,2
47,2023-06-05T05:56:00+10:00,2023-06-05,05:56,0,4,4
55,2023-06-05T05:56:00+10:00,2023-06-05,05:56,2,0,2
108,2023-06-05T05:56:00+10:00,2023-06-05,05:56,0,8,8
35,2023-06-05T05:56:00+10:00,2023-06-05,05:56,0,1,1
57,2023-06-05T05:56:00+10:00,2023-06-05,05:56,1,0,1
14,2023-06-05T05:56:00+10:00,2023-06-05,05:56,1,2,3
26,2023-06-05T05:56:00+10:00,2023-06-05,05:56,0,1,1
39,2023-06-05T05:56:00+10:00,2023-06-05,05:56,3,1,4
54,2023-06-05T05:56:00+10:00,2023-06-05,05:56,0,4,4
24,2023-06-05T05:56:00+10:00,2023-06-05,05:56,2,1,3
48,2023-06-05T05:56:00+10:00,2023-06-05,05:56,1,0,1
53,2023-06-05T05:56:00+10:00,2023-06-05,05:56,2,3,5
58,2023-06-05T05:56:00+10:00,2023-06-05,05:56,2,1,3
72,2023-06-05T05:56:00+10:00,2023-06-05,05:56,1,3,4
79,2023-06-05T05:56:00+10:00,2023-06-05,05:56,1,3,4
3,2023-06-05T05:55:00+10:00,2023-06-05,05:55,1,0,1
6,2023-06-05T05:55:00+10:00,2023-06-05,05:55,2,0,2
1,2023-06-05T05:55:00+10:00,2023-06-05,05:55,1,0,1
49,2023-06-05T05:55:00+10:00,2023-06-05,05:55,2,0,2
57,2023-06-05T05:55:00+10:00,2023-06-05,05:55,4,9,13
62,2023-06-05T05:55:00+10:00,2023-06-05,05:55,0,1,1
67,2023-06-05T05:55:00+10:00,2023-06-05,05:55,0,2,2
72,2023-06-05T05:55:00+10:00,2023-06-05,05:55,3,2,5
79,2023-06-05T05:55:00+10:00,2023-06-05,05:55,0,2,2
86,2023-06-05T05:55:00+10:00,2023-06-05,05:55,0,1,1
117,2023-06-05T05:55:00+10:00,2023-06-05,05:55,0,2,2
41,2023-06-05T05:55:00+10:00,2023-06-05,05:55,0,2,2
65,2023-06-05T05:55:00+10:00,2023-06-05,05:55,0,1,1
75,2023-06-05T05:55:00+10:00,2023-06-05,05:55,0,1,1
84,2023-06-05T05:55:00+10:00,2023-06-05,05:55,2,1,3
108,2023-06-05T05:55:00+10:00,2023-06-05,05:55,2,3,5
17,2023-06-05T05:55:00+10:00,2023-06-05,05:55,2,1,3
35,2023-06-05T05:55:00+10:00,2023-06-05,05:55,2,1,3
109,2023-06-05T05:55:00+10:00,2023-06-05,05:55,1,1,2
4,2023-06-05T05:55:00+10:00,2023-06-05,05:55,2,0,2
5,2023-06-05T05:55:00+10:00,2023-06-05,05:55,0,1,1
26,2023-06-05T05:55:00+10:00,2023-06-05,05:55,2,0,2
42,2023-06-05T05:55:00+10:00,2023-06-05,05:55,0,1,1
45,2023-06-05T05:55:00+10:00,2023-06-05,05:55,0,1,1
47,2023-06-05T05:55:00+10:00,2023-06-05,05:55,2,0,2
9,2023-06-05T05:55:00+10:00,2023-06-05,05:55,0,3,3
24,2023-06-05T05:55:00+10:00,2023-06-05,05:55,2,4,6
46,2023-06-05T05:55:00+10:00,2023-06-05,05:55,0,2,2
56,2023-06-05T05:55:00+10:00,2023-06-05,05:55,1,1,2
58,2023-06-05T05:55:00+10:00,2023-06-05,05:55,0,2,2
26,2023-06-05T05:54:00+10:00,2023-06-05,05:54,0,2,2
45,2023-06-05T05:54:00+10:00,2023-06-05,05:54,0,6,6
47,2023-06-05T05:54:00+10:00,2023-06-05,05:54,0,1,1
55,2023-06-05T05:54:00+10:00,2023-06-05,05:54,4,3,7
65,2023-06-05T05:54:00+10:00,2023-06-05,05:54,3,1,4
108,2023-06-05T05:54:00+10:00,2023-06-05,05:54,0,2,2
23,2023-06-05T05:54:00+10:00,2023-06-05,05:54,1,0,1
27,2023-06-05T05:54:00+10:00,2023-06-05,05:54,0,1,1
67,2023-06-05T05:54:00+10:00,2023-06-05,05:54,1,1,2
72,2023-06-05T05:54:00+10:00,2023-06-05,05:54,0,2,2
3,2023-06-05T05:54:00+10:00,2023-06-05,05:54,2,0,2
5,2023-06-05T05:54:00+10:00,2023-06-05,05:54,1,1,2
36,2023-06-05T05:54:00+10:00,2023-06-05,05:54,0,1,1
41,2023-06-05T05:54:00+10:00,2023-06-05,05:54,1,2,3
75,2023-06-05T05:54:00+10:00,2023-06-05,05:54,0,1,1
35,2023-06-05T05:54:00+10:00,2023-06-05,05:54,3,0,3
62,2023-06-05T05:54:00+10:00,2023-06-05,05:54,1,0,1
6,2023-06-05T05:54:00+10:00,2023-06-05,05:54,2,0,2
28,2023-06-05T05:54:00+10:00,2023-06-05,05:54,0,4,4
29,2023-06-05T05:54:00+10:00,2023-06-05,05:54,0,1,1
61,2023-06-05T05:54:00+10:00,2023-06-05,05:54,1,2,3
66,2023-06-05T05:54:00+10:00,2023-06-05,05:54,0,4,4
9,2023-06-05T05:54:00+10:00,2023-06-05,05:54,1,0,1
24,2023-06-05T05:54:00+10:00,2023-06-05,05:54,1,1,2
52,2023-06-05T05:54:00+10:00,2023-06-05,05:54,1,1,2
58,2023-06-05T05:54:00+10:00,2023-06-05,05:54,6,2,8
4,2023-06-05T05:53:00+10:00,2023-06-05,05:53,0,3,3
61,2023-06-05T05:53:00+10:00,2023-06-05,05:53,1,0,1
1,2023-06-05T05:53:00+10:00,2023-06-05,05:53,1,1,2
24,2023-06-05T05:53:00+10:00,2023-06-05,05:53,0,1,1
49,2023-06-05T05:53:00+10:00,2023-06-05,05:53,0,3,3
56,2023-06-05T05:53:00+10:00,2023-06-05,05:53,1,0,1
6,2023-06-05T05:53:00+10:00,2023-06-05,05:53,4,1,5
21,2023-06-05T05:53:00+10:00,2023-06-05,05:53,0,1,1
39,2023-06-05T05:53:00+10:00,2023-06-05,05:53,0,1,1
40,2023-06-05T05:53:00+10:00,2023-06-05,05:53,0,1,1
41,2023-06-05T05:53:00+10:00,2023-06-05,05:53,4,1,5
55,2023-06-05T05:53:00+10:00,2023-06-05,05:53,3,1,4
108,2023-06-05T05:53:00+10:00,2023-06-05,05:53,0,2,2
17,2023-06-05T05:53:00+10:00,2023-06-05,05:53,1,0,1
35,2023-06-05T05:53:00+10:00,2023-06-05,05:53,2,1,3
62,2023-06-05T05:53:00+10:00,2023-06-05,05:53,1,0,1
67,2023-06-05T05:53:00+10:00,2023-06-05,05:53,0,1,1
72,2023-06-05T05:53:00+10:00,2023-06-05,05:53,0,2,2
3,2023-06-05T05:53:00+10:00,2023-06-05,05:53,1,1,2
5,2023-06-05T05:53:00+10:00,2023-06-05,05:53,1,3,4
8,2023-06-05T05:53:00+10:00,2023-06-05,05:53,1,0,1
45,2023-06-05T05:53:00+10:00,2023-06-05,05:53,5,0,5
47,2023-06-05T05:53:00+10:00,2023-06-05,05:53,0,1,1
69,2023-06-05T05:53:00+10:00,2023-06-05,05:53,1,0,1
2,2023-06-05T05:53:00+10:00,2023-06-05,05:53,0,2,2
53,2023-06-05T05:53:00+10:00,2023-06-05,05:53,2,0,2
21,2023-06-05T05:52:00+10:00,2023-06-05,05:52,1,0,1
28,2023-06-05T05:52:00+10:00,2023-06-05,05:52,0,1,1
40,2023-06-05T05:52:00+10:00,2023-06-05,05:52,1,0,1
45,2023-06-05T05:52:00+10:00,2023-06-05,05:52,1,0,1
20,2023-06-05T05:52:00+10:00,2023-06-05,05:52,1,0,1
35,2023-06-05T05:52:00+10:00,2023-06-05,05:52,3,1,4
52,2023-06-05T05:52:00+10:00,2023-06-05,05:52,3,0,3
85,2023-06-05T05:52:00+10:00,2023-06-05,05:52,1,0,1
4,2023-06-05T05:52:00+10:00,2023-06-05,05:52,0,1,1
55,2023-06-05T05:52:00+10:00,2023-06-05,05:52,2,2,4
71,2023-06-05T05:52:00+10:00,2023-06-05,05:52,1,0,1
75,2023-06-05T05:52:00+10:00,2023-06-05,05:52,1,0,1
77,2023-06-05T05:52:00+10:00,2023-06-05,05:52,1,0,1
17,2023-06-05T05:52:00+10:00,2023-06-05,05:52,0,1,1
58,2023-06-05T05:52:00+10:00,2023-06-05,05:52,1,2,3
67,2023-06-05T05:52:00+10:00,2023-06-05,05:52,2,1,3
79,2023-06-05T05:52:00+10:00,2023-06-05,05:52,3,0,3
3,2023-06-05T05:52:00+10:00,2023-06-05,05:52,0,1,1
5,2023-06-05T05:52:00+10:00,2023-06-05,05:52,1,1,2
6,2023-06-05T05:52:00+10:00,2023-06-05,05:52,3,0,3
14,2023-06-05T05:52:00+10:00,2023-06-05,05:52,1,0,1
29,2023-06-05T05:52:00+10:00,2023-06-05,05:52,1,0,1
41,2023-06-05T05:52:00+10:00,2023-06-05,05:52,1,4,5
47,2023-06-05T05:52:00+10:00,2023-06-05,05:52,0,1,1
61,2023-06-05T05:52:00+10:00,2023-06-05,05:52,1,0,1
66,2023-06-05T05:52:00+10:00,2023-06-05,05:52,0,2,2
108,2023-06-05T05:52:00+10:00,2023-06-05,05:52,0,2,2
9,2023-06-05T05:52:00+10:00,2023-06-05,05:52,3,3,6
24,2023-06-05T05:52:00+10:00,2023-06-05,05:52,2,2,4
53,2023-06-05T05:52:00+10:00,2023-06-05,05:52,0,1,1
57,2023-06-05T05:52:00+10:00,2023-06-05,05:52,1,0,1
62,2023-06-05T05:52:00+10:00,2023-06-05,05:52,1,0,1
4,2023-06-05T05:51:00+10:00,2023-06-05,05:51,0,1,1
5,2023-06-05T05:51:00+10:00,2023-06-05,05:51,0,2,2
6,2023-06-05T05:51:00+10:00,2023-06-05,05:51,2,0,2
29,2023-06-05T05:51:00+10:00,2023-06-05,05:51,1,0,1
36,2023-06-05T05:51:00+10:00,2023-06-05,05:51,1,0,1
47,2023-06-05T05:51:00+10:00,2023-06-05,05:51,0,3,3
54,2023-06-05T05:51:00+10:00,2023-06-05,05:51,2,0,2
55,2023-06-05T05:51:00+10:00,2023-06-05,05:51,3,1,4
61,2023-06-05T05:51:00+10:00,2023-06-05,05:51,2,0,2
78,2023-06-05T05:51:00+10:00,2023-06-05,05:51,0,1,1
19,2023-06-05T05:51:00+10:00,2023-06-05,05:51,0,1,1
57,2023-06-05T05:51:00+10:00,2023-06-05,05:51,0,1,1
67,2023-06-05T05:51:00+10:00,2023-06-05,05:51,1,1,2
41,2023-06-05T05:51:00+10:00,2023-06-05,05:51,1,5,6
9,2023-06-05T05:51:00+10:00,2023-06-05,05:51,1,1,2
18,2023-06-05T05:51:00+10:00,2023-06-05,05:51,0,2,2
24,2023-06-05T05:51:00+10:00,2023-06-05,05:51,1,1,2
35,2023-06-05T05:51:00+10:00,2023-06-05,05:51,2,0,2
46,2023-06-05T05:51:00+10:00,2023-06-05,05:51,0,1,1
62,2023-06-05T05:51:00+10:00,2023-06-05,05:51,1,0,1
79,2023-06-05T05:51:00+10:00,2023-06-05,05:51,3,0,3
85,2023-06-05T05:51:00+10:00,2023-06-05,05:51,1,0,1
14,2023-06-05T05:51:00+10:00,2023-06-05,05:51,1,0,1
26,2023-06-05T05:51:00+10:00,2023-06-05,05:51,0,1,1
40,2023-06-05T05:51:00+10:00,2023-06-05,05:51,0,1,1
45,2023-06-05T05:51:00+10:00,2023-06-05,05:51,0,1,1
75,2023-06-05T05:51:00+10:00,2023-06-05,05:51,0,1,1
108,2023-06-05T05:51:00+10:00,2023-06-05,05:51,0,2,2
12,2023-06-05T05:51:00+10:00,2023-06-05,05:51,1,1,2
17,2023-06-05T05:51:00+10:00,2023-06-05,05:51,4,0,4
23,2023-06-05T05:51:00+10:00,2023-06-05,05:51,1,0,1
6,2023-06-05T05:50:00+10:00,2023-06-05,05:50,1,0,1
54,2023-06-05T05:50:00+10:00,2023-06-05,05:50,0,2,2
9,2023-06-05T05:50:00+10:00,2023-06-05,05:50,0,1,1
17,2023-06-05T05:50:00+10:00,2023-06-05,05:50,2,1,3
27,2023-06-05T05:50:00+10:00,2023-06-05,05:50,1,0,1
5,2023-06-05T05:50:00+10:00,2023-06-05,05:50,0,1,1
14,2023-06-05T05:50:00+10:00,2023-06-05,05:50,0,2,2
28,2023-06-05T05:50:00+10:00,2023-06-05,05:50,0,2,2
41,2023-06-05T05:50:00+10:00,2023-06-05,05:50,0,4,4
45,2023-06-05T05:50:00+10:00,2023-06-05,05:50,1,0,1
55,2023-06-05T05:50:00+10:00,2023-06-05,05:50,3,1,4
107,2023-06-05T05:50:00+10:00,2023-06-05,05:50,1,0,1
2,2023-06-05T05:50:00+10:00,2023-06-05,05:50,0,1,1
11,2023-06-05T05:50:00+10:00,2023-06-05,05:50,1,0,1
18,2023-06-05T05:50:00+10:00,2023-06-05,05:50,0,4,4
24,2023-06-05T05:50:00+10:00,2023-06-05,05:50,2,0,2
30,2023-06-05T05:50:00+10:00,2023-06-05,05:50,0,1,1
49,2023-06-05T05:50:00+10:00,2023-06-05,05:50,0,2,2
58,2023-06-05T05:50:00+10:00,2023-06-05,05:50,2,0,2
62,2023-06-05T05:50:00+10:00,2023-06-05,05:50,1,1,2
76,2023-06-05T05:50:00+10:00,2023-06-05,05:50,1,0,1
109,2023-06-05T05:50:00+10:00,2023-06-05,05:50,0,1,1
4,2023-06-05T05:50:00+10:00,2023-06-05,05:50,1,1,2
21,2023-06-05T05:50:00+10:00,2023-06-05,05:50,0,2,2
40,2023-06-05T05:50:00+10:00,2023-06-05,05:50,2,0,2
47,2023-06-05T05:50:00+10:00,2023-06-05,05:50,2,0,2
65,2023-06-05T05:50:00+10:00,2023-06-05,05:50,1,0,1
84,2023-06-05T05:50:00+10:00,2023-06-05,05:50,0,1,1
35,2023-06-05T05:50:00+10:00,2023-06-05,05:50,1,7,8
67,2023-06-05T05:50:00+10:00,2023-06-05,05:50,3,0,3
79,2023-06-05T05:50:00+10:00,2023-06-05,05:50,1,2,3
5,2023-06-05T05:49:00+10:00,2023-06-05,05:49,1,0,1
8,2023-06-05T05:49:00+10:00,2023-06-05,05:49,1,0,1
14,2023-06-05T05:49:00+10:00,2023-06-05,05:49,0,2,2
26,2023-06-05T05:49:00+10:00,2023-06-05,05:49,1,0,1
29,2023-06-05T05:49:00+10:00,2023-06-05,05:49,1,3,4
23,2023-06-05T05:49:00+10:00,2023-06-05,05:49,1,3,4
30,2023-06-05T05:49:00+10:00,2023-06-05,05:49,2,0,2
51,2023-06-05T05:49:00+10:00,2023-06-05,05:49,0,2,2
56,2023-06-05T05:49:00+10:00,2023-06-05,05:49,1,0,1
58,2023-06-05T05:49:00+10:00,2023-06-05,05:49,0,1,1
4,2023-06-05T05:49:00+10:00,2023-06-05,05:49,2,0,2
28,2023-06-05T05:49:00+10:00,2023-06-05,05:49,0,1,1
39,2023-06-05T05:49:00+10:00,2023-06-05,05:49,0,2,2
2,2023-06-05T05:49:00+10:00,2023-06-05,05:49,1,0,1
19,2023-06-05T05:49:00+10:00,2023-06-05,05:49,0,1,1
24,2023-06-05T05:49:00+10:00,2023-06-05,05:49,0,6,6
35,2023-06-05T05:49:00+10:00,2023-06-05,05:49,1,0,1
48,2023-06-05T05:49:00+10:00,2023-06-05,05:49,0,1,1
62,2023-06-05T05:49:00+10:00,2023-06-05,05:49,1,1,2
6,2023-06-05T05:49:00+10:00,2023-06-05,05:49,2,0,2
41,2023-06-05T05:49:00+10:00,2023-06-05,05:49,0,4,4
45,2023-06-05T05:49:00+10:00,2023-06-05,05:49,1,0,1
47,2023-06-05T05:49:00+10:00,2023-06-05,05:49,2,2,4
55,2023-06-05T05:49:00+10:00,2023-06-05,05:49,3,2,5
61,2023-06-05T05:49:00+10:00,2023-06-05,05:49,0,1,1
66,2023-06-05T05:49:00+10:00,2023-06-05,05:49,0,1,1
75,2023-06-05T05:49:00+10:00,2023-06-05,05:49,1,0,1
10,2023-06-05T05:49:00+10:00,2023-06-05,05:49,0,1,1
17,2023-06-05T05:49:00+10:00,2023-06-05,05:49,2,0,2
52,2023-06-05T05:49:00+10:00,2023-06-05,05:49,0,1,1
67,2023-06-05T05:49:00+10:00,2023-06-05,05:49,0,1,1
72,2023-06-05T05:49:00+10:00,2023-06-05,05:49,0,1,1
3,2023-06-05T05:48:00+10:00,2023-06-05,05:48,0,1,1
5,2023-06-05T05:48:00+10:00,2023-06-05,05:48,0,1,1
6,2023-06-05T05:48:00+10:00,2023-06-05,05:48,1,7,8
28,2023-06-05T05:48:00+10:00,2023-06-05,05:48,0,1,1
65,2023-06-05T05:48:00+10:00,2023-06-05,05:48,1,0,1
69,2023-06-05T05:48:00+10:00,2023-06-05,05:48,1,0,1
23,2023-06-05T05:48:00+10:00,2023-06-05,05:48,2,0,2
24,2023-06-05T05:48:00+10:00,2023-06-05,05:48,3,0,3
53,2023-06-05T05:48:00+10:00,2023-06-05,05:48,0,1,1
85,2023-06-05T05:48:00+10:00,2023-06-05,05:48,1,0,1
8,2023-06-05T05:48:00+10:00,2023-06-05,05:48,1,0,1
47,2023-06-05T05:48:00+10:00,2023-06-05,05:48,0,2,2
55,2023-06-05T05:48:00+10:00,2023-06-05,05:48,0,1,1
35,2023-06-05T05:48:00+10:00,2023-06-05,05:48,3,3,6
49,2023-06-05T05:48:00+10:00,2023-06-05,05:48,4,0,4
58,2023-06-05T05:48:00+10:00,2023-06-05,05:48,3,0,3
67,2023-06-05T05:48:00+10:00,2023-06-05,05:48,0,1,1
66,2023-06-05T05:48:00+10:00,2023-06-05,05:48,0,1,1
71,2023-06-05T05:48:00+10:00,2023-06-05,05:48,0,1,1
9,2023-06-05T05:48:00+10:00,2023-06-05,05:48,0,2,2
79,2023-06-05T05:48:00+10:00,2023-06-05,05:48,0,1,1
41,2023-06-05T05:47:00+10:00,2023-06-05,05:47,4,3,7
45,2023-06-05T05:47:00+10:00,2023-06-05,05:47,2,1,3
55,2023-06-05T05:47:00+10:00,2023-06-05,05:47,0,2,2
66,2023-06-05T05:47:00+10:00,2023-06-05,05:47,1,0,1
108,2023-06-05T05:47:00+10:00,2023-06-05,05:47,0,2,2
24,2023-06-05T05:47:00+10:00,2023-06-05,05:47,3,1,4
35,2023-06-05T05:47:00+10:00,2023-06-05,05:47,1,1,2
62,2023-06-05T05:47:00+10:00,2023-06-05,05:47,1,2,3
86,2023-06-05T05:47:00+10:00,2023-06-05,05:47,0,1,1
3,2023-06-05T05:47:00+10:00,2023-06-05,05:47,1,1,2
5,2023-06-05T05:47:00+10:00,2023-06-05,05:47,0,1,1
14,2023-06-05T05:47:00+10:00,2023-06-05,05:47,0,1,1
26,2023-06-05T05:47:00+10:00,2023-06-05,05:47,1,2,3
36,2023-06-05T05:47:00+10:00,2023-06-05,05:47,0,2,2
39,2023-06-05T05:47:00+10:00,2023-06-05,05:47,1,0,1
47,2023-06-05T05:47:00+10:00,2023-06-05,05:47,0,1,1
2,2023-06-05T05:47:00+10:00,2023-06-05,05:47,0,1,1
58,2023-06-05T05:47:00+10:00,2023-06-05,05:47,4,0,4
79,2023-06-05T05:47:00+10:00,2023-06-05,05:47,1,1,2
4,2023-06-05T05:47:00+10:00,2023-06-05,05:47,1,1,2
28,2023-06-05T05:47:00+10:00,2023-06-05,05:47,2,1,3
29,2023-06-05T05:47:00+10:00,2023-06-05,05:47,3,0,3
61,2023-06-05T05:47:00+10:00,2023-06-05,05:47,1,1,2
9,2023-06-05T05:47:00+10:00,2023-06-05,05:47,1,0,1
19,2023-06-05T05:47:00+10:00,2023-06-05,05:47,1,0,1
23,2023-06-05T05:47:00+10:00,2023-06-05,05:47,2,0,2
30,2023-06-05T05:47:00+10:00,2023-06-05,05:47,0,1,1
6,2023-06-05T05:46:00+10:00,2023-06-05,05:46,1,5,6
26,2023-06-05T05:46:00+10:00,2023-06-05,05:46,1,1,2
29,2023-06-05T05:46:00+10:00,2023-06-05,05:46,0,1,1
40,2023-06-05T05:46:00+10:00,2023-06-05,05:46,0,2,2
41,2023-06-05T05:46:00+10:00,2023-06-05,05:46,1,1,2
108,2023-06-05T05:46:00+10:00,2023-06-05,05:46,0,3,3
17,2023-06-05T05:46:00+10:00,2023-06-05,05:46,1,0,1
35,2023-06-05T05:46:00+10:00,2023-06-05,05:46,1,2,3
49,2023-06-05T05:46:00+10:00,2023-06-05,05:46,0,2,2
79,2023-06-05T05:46:00+10:00,2023-06-05,05:46,1,1,2
4,2023-06-05T05:46:00+10:00,2023-06-05,05:46,0,1,1
14,2023-06-05T05:46:00+10:00,2023-06-05,05:46,0,3,3
61,2023-06-05T05:46:00+10:00,2023-06-05,05:46,0,1,1
18,2023-06-05T05:46:00+10:00,2023-06-05,05:46,0,1,1
23,2023-06-05T05:46:00+10:00,2023-06-05,05:46,2,2,4
48,2023-06-05T05:46:00+10:00,2023-06-05,05:46,0,2,2
51,2023-06-05T05:46:00+10:00,2023-06-05,05:46,2,1,3
52,2023-06-05T05:46:00+10:00,2023-06-05,05:46,1,0,1
62,2023-06-05T05:46:00+10:00,2023-06-05,05:46,0,1,1
72,2023-06-05T05:46:00+10:00,2023-06-05,05:46,0,1,1
55,2023-06-05T05:46:00+10:00,2023-06-05,05:46,0,3,3
9,2023-06-05T05:46:00+10:00,2023-06-05,05:46,1,2,3
24,2023-06-05T05:46:00+10:00,2023-06-05,05:46,3,3,6
57,2023-06-05T05:46:00+10:00,2023-06-05,05:46,1,2,3
67,2023-06-05T05:46:00+10:00,2023-06-05,05:46,1,1,2
5,2023-06-05T05:45:00+10:00,2023-06-05,05:45,0,2,2
29,2023-06-05T05:45:00+10:00,2023-06-05,05:45,0,1,1
31,2023-06-05T05:45:00+10:00,2023-06-05,05:45,0,1,1
61,2023-06-05T05:45:00+10:00,2023-06-05,05:45,0,1,1
9,2023-06-05T05:45:00+10:00,2023-06-05,05:45,2,3,5
23,2023-06-05T05:45:00+10:00,2023-06-05,05:45,1,2,3
24,2023-06-05T05:45:00+10:00,2023-06-05,05:45,0,11,11
58,2023-06-05T05:45:00+10:00,2023-06-05,05:45,1,1,2
72,2023-06-05T05:45:00+10:00,2023-06-05,05:45,1,0,1
76,2023-06-05T05:45:00+10:00,2023-06-05,05:45,1,0,1
79,2023-06-05T05:45:00+10:00,2023-06-05,05:45,2,3,5
6,2023-06-05T05:45:00+10:00,2023-06-05,05:45,0,4,4
28,2023-06-05T05:45:00+10:00,2023-06-05,05:45,1,0,1
45,2023-06-05T05:45:00+10:00,2023-06-05,05:45,2,0,2
47,2023-06-05T05:45:00+10:00,2023-06-05,05:45,2,4,6
2,2023-06-05T05:45:00+10:00,2023-06-05,05:45,1,0,1
17,2023-06-05T05:45:00+10:00,2023-06-05,05:45,2,0,2
35,2023-06-05T05:45:00+10:00,2023-06-05,05:45,2,0,2
109,2023-06-05T05:45:00+10:00,2023-06-05,05:45,1,0,1
117,2023-06-05T05:45:00+10:00,2023-06-05,05:45,1,1,2
14,2023-06-05T05:45:00+10:00,2023-06-05,05:45,0,5,5
36,2023-06-05T05:45:00+10:00,2023-06-05,05:45,0,1,1
41,2023-06-05T05:45:00+10:00,2023-06-05,05:45,5,3,8
55,2023-06-05T05:45:00+10:00,2023-06-05,05:45,1,2,3
65,2023-06-05T05:45:00+10:00,2023-06-05,05:45,1,0,1
66,2023-06-05T05:45:00+10:00,2023-06-05,05:45,0,1,1
84,2023-06-05T05:45:00+10:00,2023-06-05,05:45,6,9,15
30,2023-06-05T05:45:00+10:00,2023-06-05,05:45,1,1,2
53,2023-06-05T05:45:00+10:00,2023-06-05,05:45,1,0,1
67,2023-06-05T05:45:00+10:00,2023-06-05,05:45,0,1,1
86,2023-06-05T05:45:00+10:00,2023-06-05,05:45,1,0,1
3,2023-06-05T05:44:00+10:00,2023-06-05,05:44,0,2,2
5,2023-06-05T05:44:00+10:00,2023-06-05,05:44,0,4,4
6,2023-06-05T05:44:00+10:00,2023-06-05,05:44,2,2,4
26,2023-06-05T05:44:00+10:00,2023-06-05,05:44,2,0,2
39,2023-06-05T05:44:00+10:00,2023-06-05,05:44,0,1,1
41,2023-06-05T05:44:00+10:00,2023-06-05,05:44,1,1,2
47,2023-06-05T05:44:00+10:00,2023-06-05,05:44,0,1,1
54,2023-06-05T05:44:00+10:00,2023-06-05,05:44,0,1,1
55,2023-06-05T05:44:00+10:00,2023-06-05,05:44,0,1,1
108,2023-06-05T05:44:00+10:00,2023-06-05,05:44,0,2,2
9,2023-06-05T05:44:00+10:00,2023-06-05,05:44,0,3,3
57,2023-06-05T05:44:00+10:00,2023-06-05,05:44,1,2,3
72,2023-06-05T05:44:00+10:00,2023-06-05,05:44,1,1,2
14,2023-06-05T05:44:00+10:00,2023-06-05,05:44,0,4,4
45,2023-06-05T05:44:00+10:00,2023-06-05,05:44,1,1,2
66,2023-06-05T05:44:00+10:00,2023-06-05,05:44,0,1,1
56,2023-06-05T05:44:00+10:00,2023-06-05,05:44,0,1,1
79,2023-06-05T05:44:00+10:00,2023-06-05,05:44,0,5,5
28,2023-06-05T05:44:00+10:00,2023-06-05,05:44,1,0,1
65,2023-06-05T05:44:00+10:00,2023-06-05,05:44,1,0,1
69,2023-06-05T05:44:00+10:00,2023-06-05,05:44,1,0,1
70,2023-06-05T05:44:00+10:00,2023-06-05,05:44,0,1,1
24,2023-06-05T05:44:00+10:00,2023-06-05,05:44,1,1,2
35,2023-06-05T05:44:00+10:00,2023-06-05,05:44,1,1,2
49,2023-06-05T05:44:00+10:00,2023-06-05,05:44,1,2,3
6,2023-06-05T05:43:00+10:00,2023-06-05,05:43,0,2,2
26,2023-06-05T05:43:00+10:00,2023-06-05,05:43,1,0,1
28,2023-06-05T05:43:00+10:00,2023-06-05,05:43,0,1,1
36,2023-06-05T05:43:00+10:00,2023-06-05,05:43,0,1,1
47,2023-06-05T05:43:00+10:00,2023-06-05,05:43,0,4,4
61,2023-06-05T05:43:00+10:00,2023-06-05,05:43,1,0,1
66,2023-06-05T05:43:00+10:00,2023-06-05,05:43,0,1,1
71,2023-06-05T05:43:00+10:00,2023-06-05,05:43,1,0,1
4,2023-06-05T05:43:00+10:00,2023-06-05,05:43,0,1,1
41,2023-06-05T05:43:00+10:00,2023-06-05,05:43,2,2,4
9,2023-06-05T05:43:00+10:00,2023-06-05,05:43,0,1,1
24,2023-06-05T05:43:00+10:00,2023-06-05,05:43,1,2,3
52,2023-06-05T05:43:00+10:00,2023-06-05,05:43,0,1,1
3,2023-06-05T05:43:00+10:00,2023-06-05,05:43,0,4,4
14,2023-06-05T05:43:00+10:00,2023-06-05,05:43,0,1,1
21,2023-06-05T05:43:00+10:00,2023-06-05,05:43,1,0,1
55,2023-06-05T05:43:00+10:00,2023-06-05,05:43,1,0,1
65,2023-06-05T05:43:00+10:00,2023-06-05,05:43,1,0,1
108,2023-06-05T05:43:00+10:00,2023-06-05,05:43,0,4,4
1,2023-06-05T05:43:00+10:00,2023-06-05,05:43,1,0,1
17,2023-06-05T05:43:00+10:00,2023-06-05,05:43,1,0,1
35,2023-06-05T05:43:00+10:00,2023-06-05,05:43,2,1,3
57,2023-06-05T05:43:00+10:00,2023-06-05,05:43,0,1,1
58,2023-06-05T05:43:00+10:00,2023-06-05,05:43,4,0,4
62,2023-06-05T05:43:00+10:00,2023-06-05,05:43,0,2,2
28,2023-06-05T05:42:00+10:00,2023-06-05,05:42,3,0,3
36,2023-06-05T05:42:00+10:00,2023-06-05,05:42,1,0,1
1,2023-06-05T05:42:00+10:00,2023-06-05,05:42,1,0,1
23,2023-06-05T05:42:00+10:00,2023-06-05,05:42,1,0,1
72,2023-06-05T05:42:00+10:00,2023-06-05,05:42,0,1,1
5,2023-06-05T05:42:00+10:00,2023-06-05,05:42,1,1,2
26,2023-06-05T05:42:00+10:00,2023-06-05,05:42,1,0,1
108,2023-06-05T05:42:00+10:00,2023-06-05,05:42,1,1,2
4,2023-06-05T05:42:00+10:00,2023-06-05,05:42,2,1,3
6,2023-06-05T05:42:00+10:00,2023-06-05,05:42,1,2,3
14,2023-06-05T05:42:00+10:00,2023-06-05,05:42,0,2,2
21,2023-06-05T05:42:00+10:00,2023-06-05,05:42,0,1,1
29,2023-06-05T05:42:00+10:00,2023-06-05,05:42,0,1,1
41,2023-06-05T05:42:00+10:00,2023-06-05,05:42,1,5,6
45,2023-06-05T05:42:00+10:00,2023-06-05,05:42,1,0,1
55,2023-06-05T05:42:00+10:00,2023-06-05,05:42,2,3,5
65,2023-06-05T05:42:00+10:00,2023-06-05,05:42,0,1,1
17,2023-06-05T05:42:00+10:00,2023-06-05,05:42,1,2,3
24,2023-06-05T05:42:00+10:00,2023-06-05,05:42,4,0,4
51,2023-06-05T05:42:00+10:00,2023-06-05,05:42,0,1,1
56,2023-06-05T05:42:00+10:00,2023-06-05,05:42,0,1,1
79,2023-06-05T05:42:00+10:00,2023-06-05,05:42,0,1,1
3,2023-06-05T05:41:00+10:00,2023-06-05,05:41,0,1,1
5,2023-06-05T05:41:00+10:00,2023-06-05,05:41,0,1,1
14,2023-06-05T05:41:00+10:00,2023-06-05,05:41,1,1,2
29,2023-06-05T05:41:00+10:00,2023-06-05,05:41,1,0,1
40,2023-06-05T05:41:00+10:00,2023-06-05,05:41,0,1,1
35,2023-06-05T05:41:00+10:00,2023-06-05,05:41,0,1,1
57,2023-06-05T05:41:00+10:00,2023-06-05,05:41,1,2,3
58,2023-06-05T05:41:00+10:00,2023-06-05,05:41,1,0,1
62,2023-06-05T05:41:00+10:00,2023-06-05,05:41,1,1,2
4,2023-06-05T05:41:00+10:00,2023-06-05,05:41,1,1,2
26,2023-06-05T05:41:00+10:00,2023-06-05,05:41,1,0,1
36,2023-06-05T05:41:00+10:00,2023-06-05,05:41,0,1,1
41,2023-06-05T05:41:00+10:00,2023-06-05,05:41,2,9,11
54,2023-06-05T05:41:00+10:00,2023-06-05,05:41,0,1,1
61,2023-06-05T05:41:00+10:00,2023-06-05,05:41,1,2,3
77,2023-06-05T05:41:00+10:00,2023-06-05,05:41,0,1,1
9,2023-06-05T05:41:00+10:00,2023-06-05,05:41,0,2,2
18,2023-06-05T05:41:00+10:00,2023-06-05,05:41,0,1,1
51,2023-06-05T05:41:00+10:00,2023-06-05,05:41,0,2,2
6,2023-06-05T05:41:00+10:00,2023-06-05,05:41,0,4,4
47,2023-06-05T05:41:00+10:00,2023-06-05,05:41,0,1,1
55,2023-06-05T05:41:00+10:00,2023-06-05,05:41,1,2,3
65,2023-06-05T05:41:00+10:00,2023-06-05,05:41,0,1,1
70,2023-06-05T05:41:00+10:00,2023-06-05,05:41,1,0,1
108,2023-06-05T05:41:00+10:00,2023-06-05,05:41,1,2,3
24,2023-06-05T05:41:00+10:00,2023-06-05,05:41,2,0,2
30,2023-06-05T05:41:00+10:00,2023-06-05,05:41,1,0,1
79,2023-06-05T05:41:00+10:00,2023-06-05,05:41,1,0,1
4,2023-06-05T05:40:00+10:00,2023-06-05,05:40,2,1,3
14,2023-06-05T05:40:00+10:00,2023-06-05,05:40,1,2,3
26,2023-06-05T05:40:00+10:00,2023-06-05,05:40,1,0,1
28,2023-06-05T05:40:00+10:00,2023-06-05,05:40,1,0,1
40,2023-06-05T05:40:00+10:00,2023-06-05,05:40,0,1,1
45,2023-06-05T05:40:00+10:00,2023-06-05,05:40,0,2,2
47,2023-06-05T05:40:00+10:00,2023-06-05,05:40,0,5,5
66,2023-06-05T05:40:00+10:00,2023-06-05,05:40,0,2,2
84,2023-06-05T05:40:00+10:00,2023-06-05,05:40,2,6,8
23,2023-06-05T05:40:00+10:00,2023-06-05,05:40,0,1,1
24,2023-06-05T05:40:00+10:00,2023-06-05,05:40,3,0,3
79,2023-06-05T05:40:00+10:00,2023-06-05,05:40,2,0,2
5,2023-06-05T05:40:00+10:00,2023-06-05,05:40,0,1,1
6,2023-06-05T05:40:00+10:00,2023-06-05,05:40,1,4,5
41,2023-06-05T05:40:00+10:00,2023-06-05,05:40,1,0,1
55,2023-06-05T05:40:00+10:00,2023-06-05,05:40,0,1,1
108,2023-06-05T05:40:00+10:00,2023-06-05,05:40,0,2,2
17,2023-06-05T05:40:00+10:00,2023-06-05,05:40,2,0,2
30,2023-06-05T05:40:00+10:00,2023-06-05,05:40,0,1,1
49,2023-06-05T05:40:00+10:00,2023-06-05,05:40,2,0,2
58,2023-06-05T05:40:00+10:00,2023-06-05,05:40,1,0,1
62,2023-06-05T05:40:00+10:00,2023-06-05,05:40,0,1,1
3,2023-06-05T05:40:00+10:00,2023-06-05,05:40,0,1,1
107,2023-06-05T05:40:00+10:00,2023-06-05,05:40,0,1,1
35,2023-06-05T05:40:00+10:00,2023-06-05,05:40,1,0,1
46,2023-06-05T05:40:00+10:00,2023-06-05,05:40,0,1,1
57,2023-06-05T05:40:00+10:00,2023-06-05,05:40,1,2,3
67,2023-06-05T05:40:00+10:00,2023-06-05,05:40,1,2,3
72,2023-06-05T05:40:00+10:00,2023-06-05,05:40,0,1,1
109,2023-06-05T05:40:00+10:00,2023-06-05,05:40,2,1,3
117,2023-06-05T05:40:00+10:00,2023-06-05,05:40,1,0,1
6,2023-06-05T05:39:00+10:00,2023-06-05,05:39,2,1,3
14,2023-06-05T05:39:00+10:00,2023-06-05,05:39,1,1,2
87,2023-06-05T05:39:00+10:00,2023-06-05,05:39,1,0,1
17,2023-06-05T05:39:00+10:00,2023-06-05,05:39,0,1,1
18,2023-06-05T05:39:00+10:00,2023-06-05,05:39,0,1,1
24,2023-06-05T05:39:00+10:00,2023-06-05,05:39,4,0,4
35,2023-06-05T05:39:00+10:00,2023-06-05,05:39,0,2,2
67,2023-06-05T05:39:00+10:00,2023-06-05,05:39,1,0,1
72,2023-06-05T05:39:00+10:00,2023-06-05,05:39,3,1,4
28,2023-06-05T05:39:00+10:00,2023-06-05,05:39,1,0,1
29,2023-06-05T05:39:00+10:00,2023-06-05,05:39,1,0,1
47,2023-06-05T05:39:00+10:00,2023-06-05,05:39,0,2,2
65,2023-06-05T05:39:00+10:00,2023-06-05,05:39,0,1,1
12,2023-06-05T05:39:00+10:00,2023-06-05,05:39,1,0,1
30,2023-06-05T05:39:00+10:00,2023-06-05,05:39,0,1,1
79,2023-06-05T05:39:00+10:00,2023-06-05,05:39,1,2,3
3,2023-06-05T05:39:00+10:00,2023-06-05,05:39,0,2,2
4,2023-06-05T05:39:00+10:00,2023-06-05,05:39,0,8,8
5,2023-06-05T05:39:00+10:00,2023-06-05,05:39,0,3,3
26,2023-06-05T05:39:00+10:00,2023-06-05,05:39,1,1,2
41,2023-06-05T05:39:00+10:00,2023-06-05,05:39,12,2,14
55,2023-06-05T05:39:00+10:00,2023-06-05,05:39,1,2,3
108,2023-06-05T05:39:00+10:00,2023-06-05,05:39,0,3,3
2,2023-06-05T05:39:00+10:00,2023-06-05,05:39,1,0,1
3,2023-06-05T05:38:00+10:00,2023-06-05,05:38,2,0,2
26,2023-06-05T05:38:00+10:00,2023-06-05,05:38,0,1,1
69,2023-06-05T05:38:00+10:00,2023-06-05,05:38,1,0,1
24,2023-06-05T05:38:00+10:00,2023-06-05,05:38,1,0,1
52,2023-06-05T05:38:00+10:00,2023-06-05,05:38,1,0,1
67,2023-06-05T05:38:00+10:00,2023-06-05,05:38,1,0,1
85,2023-06-05T05:38:00+10:00,2023-06-05,05:38,1,0,1
36,2023-06-05T05:38:00+10:00,2023-06-05,05:38,1,0,1
40,2023-06-05T05:38:00+10:00,2023-06-05,05:38,6,0,6
66,2023-06-05T05:38:00+10:00,2023-06-05,05:38,0,1,1
35,2023-06-05T05:38:00+10:00,2023-06-05,05:38,1,1,2
51,2023-06-05T05:38:00+10:00,2023-06-05,05:38,2,0,2
72,2023-06-05T05:38:00+10:00,2023-06-05,05:38,5,4,9
4,2023-06-05T05:38:00+10:00,2023-06-05,05:38,1,1,2
5,2023-06-05T05:38:00+10:00,2023-06-05,05:38,0,3,3
6,2023-06-05T05:38:00+10:00,2023-06-05,05:38,0,5,5
14,2023-06-05T05:38:00+10:00,2023-06-05,05:38,0,2,2
28,2023-06-05T05:38:00+10:00,2023-06-05,05:38,1,0,1
41,2023-06-05T05:38:00+10:00,2023-06-05,05:38,5,2,7
61,2023-06-05T05:38:00+10:00,2023-06-05,05:38,0,1,1
108,2023-06-05T05:38:00+10:00,2023-06-05,05:38,0,1,1
2,2023-06-05T05:38:00+10:00,2023-06-05,05:38,1,1,2
17,2023-06-05T05:38:00+10:00,2023-06-05,05:38,4,0,4
49,2023-06-05T05:38:00+10:00,2023-06-05,05:38,4,1,5
79,2023-06-05T05:38:00+10:00,2023-06-05,05:38,1,1,2
3,2023-06-05T05:37:00+10:00,2023-06-05,05:37,0,1,1
5,2023-06-05T05:37:00+10:00,2023-06-05,05:37,0,4,4
40,2023-06-05T05:37:00+10:00,2023-06-05,05:37,1,0,1
45,2023-06-05T05:37:00+10:00,2023-06-05,05:37,0,1,1
55,2023-06-05T05:37:00+10:00,2023-06-05,05:37,3,1,4
18,2023-06-05T05:37:00+10:00,2023-06-05,05:37,0,1,1
19,2023-06-05T05:37:00+10:00,2023-06-05,05:37,1,0,1
35,2023-06-05T05:37:00+10:00,2023-06-05,05:37,1,0,1
58,2023-06-05T05:37:00+10:00,2023-06-05,05:37,2,0,2
72,2023-06-05T05:37:00+10:00,2023-06-05,05:37,1,4,5
79,2023-06-05T05:37:00+10:00,2023-06-05,05:37,4,1,5
6,2023-06-05T05:37:00+10:00,2023-06-05,05:37,3,1,4
14,2023-06-05T05:37:00+10:00,2023-06-05,05:37,1,2,3
28,2023-06-05T05:37:00+10:00,2023-06-05,05:37,1,1,2
54,2023-06-05T05:37:00+10:00,2023-06-05,05:37,1,0,1
77,2023-06-05T05:37:00+10:00,2023-06-05,05:37,0,1,1
87,2023-06-05T05:37:00+10:00,2023-06-05,05:37,0,1,1
17,2023-06-05T05:37:00+10:00,2023-06-05,05:37,1,0,1
4,2023-06-05T05:37:00+10:00,2023-06-05,05:37,0,1,1
26,2023-06-05T05:37:00+10:00,2023-06-05,05:37,0,1,1
29,2023-06-05T05:37:00+10:00,2023-06-05,05:37,1,2,3
36,2023-06-05T05:37:00+10:00,2023-06-05,05:37,0,1,1
65,2023-06-05T05:37:00+10:00,2023-06-05,05:37,1,0,1
108,2023-06-05T05:37:00+10:00,2023-06-05,05:37,0,2,2
23,2023-06-05T05:37:00+10:00,2023-06-05,05:37,1,0,1
30,2023-06-05T05:37:00+10:00,2023-06-05,05:37,2,1,3
49,2023-06-05T05:37:00+10:00,2023-06-05,05:37,0,2,2
53,2023-06-05T05:37:00+10:00,2023-06-05,05:37,0,1,1
6,2023-06-05T05:36:00+10:00,2023-06-05,05:36,0,2,2
41,2023-06-05T05:36:00+10:00,2023-06-05,05:36,2,0,2
47,2023-06-05T05:36:00+10:00,2023-06-05,05:36,1,1,2
9,2023-06-05T05:36:00+10:00,2023-06-05,05:36,0,1,1
35,2023-06-05T05:36:00+10:00,2023-06-05,05:36,4,0,4
52,2023-06-05T05:36:00+10:00,2023-06-05,05:36,1,0,1
57,2023-06-05T05:36:00+10:00,2023-06-05,05:36,1,0,1
58,2023-06-05T05:36:00+10:00,2023-06-05,05:36,1,0,1
29,2023-06-05T05:36:00+10:00,2023-06-05,05:36,1,0,1
42,2023-06-05T05:36:00+10:00,2023-06-05,05:36,0,1,1
20,2023-06-05T05:36:00+10:00,2023-06-05,05:36,1,0,1
23,2023-06-05T05:36:00+10:00,2023-06-05,05:36,1,0,1
24,2023-06-05T05:36:00+10:00,2023-06-05,05:36,2,0,2
53,2023-06-05T05:36:00+10:00,2023-06-05,05:36,1,0,1
79,2023-06-05T05:36:00+10:00,2023-06-05,05:36,1,0,1
21,2023-06-05T05:36:00+10:00,2023-06-05,05:36,0,1,1
28,2023-06-05T05:36:00+10:00,2023-06-05,05:36,0,1,1
55,2023-06-05T05:36:00+10:00,2023-06-05,05:36,0,3,3
108,2023-06-05T05:36:00+10:00,2023-06-05,05:36,0,2,2
17,2023-06-05T05:36:00+10:00,2023-06-05,05:36,3,1,4
29,2023-06-05T05:35:00+10:00,2023-06-05,05:35,2,0,2
40,2023-06-05T05:35:00+10:00,2023-06-05,05:35,1,1,2
45,2023-06-05T05:35:00+10:00,2023-06-05,05:35,0,2,2
54,2023-06-05T05:35:00+10:00,2023-06-05,05:35,0,1,1
55,2023-06-05T05:35:00+10:00,2023-06-05,05:35,0,3,3
87,2023-06-05T05:35:00+10:00,2023-06-05,05:35,1,0,1
9,2023-06-05T05:35:00+10:00,2023-06-05,05:35,0,2,2
12,2023-06-05T05:35:00+10:00,2023-06-05,05:35,1,0,1
48,2023-06-05T05:35:00+10:00,2023-06-05,05:35,1,0,1
117,2023-06-05T05:35:00+10:00,2023-06-05,05:35,1,0,1
28,2023-06-05T05:35:00+10:00,2023-06-05,05:35,1,0,1
41,2023-06-05T05:35:00+10:00,2023-06-05,05:35,3,0,3
17,2023-06-05T05:35:00+10:00,2023-06-05,05:35,1,3,4
24,2023-06-05T05:35:00+10:00,2023-06-05,05:35,1,0,1
56,2023-06-05T05:35:00+10:00,2023-06-05,05:35,0,1,1
5,2023-06-05T05:35:00+10:00,2023-06-05,05:35,2,5,7
26,2023-06-05T05:35:00+10:00,2023-06-05,05:35,1,2,3
84,2023-06-05T05:35:00+10:00,2023-06-05,05:35,4,3,7
107,2023-06-05T05:35:00+10:00,2023-06-05,05:35,0,2,2
108,2023-06-05T05:35:00+10:00,2023-06-05,05:35,0,1,1
2,2023-06-05T05:35:00+10:00,2023-06-05,05:35,1,0,1
19,2023-06-05T05:35:00+10:00,2023-06-05,05:35,1,0,1
35,2023-06-05T05:35:00+10:00,2023-06-05,05:35,1,0,1
49,2023-06-05T05:35:00+10:00,2023-06-05,05:35,2,0,2
57,2023-06-05T05:35:00+10:00,2023-06-05,05:35,1,1,2
79,2023-06-05T05:35:00+10:00,2023-06-05,05:35,1,0,1
109,2023-06-05T05:35:00+10:00,2023-06-05,05:35,1,4,5
4,2023-06-05T05:34:00+10:00,2023-06-05,05:34,0,1,1
28,2023-06-05T05:34:00+10:00,2023-06-05,05:34,2,0,2
40,2023-06-05T05:34:00+10:00,2023-06-05,05:34,0,1,1
108,2023-06-05T05:34:00+10:00,2023-06-05,05:34,0,1,1
19,2023-06-05T05:34:00+10:00,2023-06-05,05:34,1,1,2
24,2023-06-05T05:34:00+10:00,2023-06-05,05:34,1,1,2
53,2023-06-05T05:34:00+10:00,2023-06-05,05:34,0,1,1
57,2023-06-05T05:34:00+10:00,2023-06-05,05:34,0,1,1
58,2023-06-05T05:34:00+10:00,2023-06-05,05:34,1,0,1
76,2023-06-05T05:34:00+10:00,2023-06-05,05:34,0,1,1
5,2023-06-05T05:34:00+10:00,2023-06-05,05:34,1,4,5
85,2023-06-05T05:34:00+10:00,2023-06-05,05:34,0,1,1
6,2023-06-05T05:34:00+10:00,2023-06-05,05:34,4,2,6
14,2023-06-05T05:34:00+10:00,2023-06-05,05:34,0,1,1
26,2023-06-05T05:34:00+10:00,2023-06-05,05:34,0,4,4
41,2023-06-05T05:34:00+10:00,2023-06-05,05:34,1,1,2
47,2023-06-05T05:34:00+10:00,2023-06-05,05:34,3,2,5
65,2023-06-05T05:34:00+10:00,2023-06-05,05:34,0,1,1
9,2023-06-05T05:34:00+10:00,2023-06-05,05:34,0,1,1
35,2023-06-05T05:34:00+10:00,2023-06-05,05:34,0,2,2
49,2023-06-05T05:34:00+10:00,2023-06-05,05:34,0,1,1
79,2023-06-05T05:34:00+10:00,2023-06-05,05:34,0,2,2
3,2023-06-05T05:33:00+10:00,2023-06-05,05:33,0,11,11
5,2023-06-05T05:33:00+10:00,2023-06-05,05:33,1,2,3
6,2023-06-05T05:33:00+10:00,2023-06-05,05:33,0,1,1
29,2023-06-05T05:33:00+10:00,2023-06-05,05:33,1,0,1
66,2023-06-05T05:33:00+10:00,2023-06-05,05:33,0,1,1
23,2023-06-05T05:33:00+10:00,2023-06-05,05:33,1,0,1
30,2023-06-05T05:33:00+10:00,2023-06-05,05:33,1,0,1
35,2023-06-05T05:33:00+10:00,2023-06-05,05:33,3,0,3
48,2023-06-05T05:33:00+10:00,2023-06-05,05:33,1,0,1
67,2023-06-05T05:33:00+10:00,2023-06-05,05:33,0,1,1
68,2023-06-05T05:33:00+10:00,2023-06-05,05:33,1,1,2
14,2023-06-05T05:33:00+10:00,2023-06-05,05:33,1,2,3
41,2023-06-05T05:33:00+10:00,2023-06-05,05:33,0,2,2
108,2023-06-05T05:33:00+10:00,2023-06-05,05:33,1,2,3
72,2023-06-05T05:33:00+10:00,2023-06-05,05:33,0,1,1
28,2023-06-05T05:33:00+10:00,2023-06-05,05:33,0,1,1
71,2023-06-05T05:33:00+10:00,2023-06-05,05:33,1,0,1
57,2023-06-05T05:33:00+10:00,2023-06-05,05:33,1,0,1
62,2023-06-05T05:33:00+10:00,2023-06-05,05:33,0,1,1
5,2023-06-05T05:32:00+10:00,2023-06-05,05:32,2,2,4
6,2023-06-05T05:32:00+10:00,2023-06-05,05:32,2,0,2
14,2023-06-05T05:32:00+10:00,2023-06-05,05:32,0,1,1
28,2023-06-05T05:32:00+10:00,2023-06-05,05:32,1,1,2
41,2023-06-05T05:32:00+10:00,2023-06-05,05:32,1,0,1
1,2023-06-05T05:32:00+10:00,2023-06-05,05:32,0,1,1
3,2023-06-05T05:32:00+10:00,2023-06-05,05:32,0,1,1
21,2023-06-05T05:32:00+10:00,2023-06-05,05:32,0,3,3
55,2023-06-05T05:32:00+10:00,2023-06-05,05:32,1,1,2
65,2023-06-05T05:32:00+10:00,2023-06-05,05:32,2,0,2
108,2023-06-05T05:32:00+10:00,2023-06-05,05:32,0,5,5
17,2023-06-05T05:32:00+10:00,2023-06-05,05:32,2,0,2
35,2023-06-05T05:32:00+10:00,2023-06-05,05:32,3,0,3
58,2023-06-05T05:32:00+10:00,2023-06-05,05:32,1,0,1
79,2023-06-05T05:32:00+10:00,2023-06-05,05:32,1,1,2
4,2023-06-05T05:32:00+10:00,2023-06-05,05:32,0,1,1
45,2023-06-05T05:32:00+10:00,2023-06-05,05:32,1,0,1
20,2023-06-05T05:32:00+10:00,2023-06-05,05:32,2,0,2
24,2023-06-05T05:32:00+10:00,2023-06-05,05:32,1,0,1
46,2023-06-05T05:32:00+10:00,2023-06-05,05:32,1,0,1
49,2023-06-05T05:32:00+10:00,2023-06-05,05:32,0,1,1
72,2023-06-05T05:32:00+10:00,2023-06-05,05:32,1,0,1
6,2023-06-05T05:31:00+10:00,2023-06-05,05:31,1,0,1
41,2023-06-05T05:31:00+10:00,2023-06-05,05:31,1,0,1
27,2023-06-05T05:31:00+10:00,2023-06-05,05:31,1,0,1
72,2023-06-05T05:31:00+10:00,2023-06-05,05:31,0,1,1
14,2023-06-05T05:31:00+10:00,2023-06-05,05:31,1,0,1
45,2023-06-05T05:31:00+10:00,2023-06-05,05:31,0,2,2
35,2023-06-05T05:31:00+10:00,2023-06-05,05:31,0,1,1
5,2023-06-05T05:31:00+10:00,2023-06-05,05:31,1,1,2
26,2023-06-05T05:31:00+10:00,2023-06-05,05:31,1,0,1
55,2023-06-05T05:31:00+10:00,2023-06-05,05:31,3,0,3
108,2023-06-05T05:31:00+10:00,2023-06-05,05:31,1,1,2
10,2023-06-05T05:31:00+10:00,2023-06-05,05:31,1,0,1
17,2023-06-05T05:31:00+10:00,2023-06-05,05:31,2,0,2
58,2023-06-05T05:31:00+10:00,2023-06-05,05:31,1,0,1
3,2023-06-05T05:30:00+10:00,2023-06-05,05:30,0,1,1
21,2023-06-05T05:30:00+10:00,2023-06-05,05:30,0,1,1
41,2023-06-05T05:30:00+10:00,2023-06-05,05:30,1,1,2
55,2023-06-05T05:30:00+10:00,2023-06-05,05:30,1,4,5
71,2023-06-05T05:30:00+10:00,2023-06-05,05:30,0,1,1
87,2023-06-05T05:30:00+10:00,2023-06-05,05:30,1,0,1
24,2023-06-05T05:30:00+10:00,2023-06-05,05:30,3,2,5
27,2023-06-05T05:30:00+10:00,2023-06-05,05:30,0,1,1
35,2023-06-05T05:30:00+10:00,2023-06-05,05:30,1,0,1
68,2023-06-05T05:30:00+10:00,2023-06-05,05:30,0,1,1
109,2023-06-05T05:30:00+10:00,2023-06-05,05:30,1,1,2
5,2023-06-05T05:30:00+10:00,2023-06-05,05:30,1,2,3
29,2023-06-05T05:30:00+10:00,2023-06-05,05:30,0,1,1
61,2023-06-05T05:30:00+10:00,2023-06-05,05:30,0,1,1
66,2023-06-05T05:30:00+10:00,2023-06-05,05:30,0,1,1
107,2023-06-05T05:30:00+10:00,2023-06-05,05:30,0,4,4
48,2023-06-05T05:30:00+10:00,2023-06-05,05:30,0,1,1
53,2023-06-05T05:30:00+10:00,2023-06-05,05:30,1,0,1
8,2023-06-05T05:30:00+10:00,2023-06-05,05:30,0,1,1
14,2023-06-05T05:30:00+10:00,2023-06-05,05:30,0,1,1
28,2023-06-05T05:30:00+10:00,2023-06-05,05:30,0,1,1
47,2023-06-05T05:30:00+10:00,2023-06-05,05:30,0,1,1
84,2023-06-05T05:30:00+10:00,2023-06-05,05:30,3,5,8
108,2023-06-05T05:30:00+10:00,2023-06-05,05:30,0,2,2
17,2023-06-05T05:30:00+10:00,2023-06-05,05:30,0,1,1
18,2023-06-05T05:30:00+10:00,2023-06-05,05:30,0,1,1
57,2023-06-05T05:30:00+10:00,2023-06-05,05:30,0,1,1
58,2023-06-05T05:30:00+10:00,2023-06-05,05:30,1,0,1
62,2023-06-05T05:30:00+10:00,2023-06-05,05:30,2,0,2
67,2023-06-05T05:30:00+10:00,2023-06-05,05:30,1,0,1
14,2023-06-05T05:29:00+10:00,2023-06-05,05:29,1,1,2
26,2023-06-05T05:29:00+10:00,2023-06-05,05:29,1,0,1
39,2023-06-05T05:29:00+10:00,2023-06-05,05:29,0,1,1
41,2023-06-05T05:29:00+10:00,2023-06-05,05:29,2,0,2
65,2023-06-05T05:29:00+10:00,2023-06-05,05:29,1,0,1
24,2023-06-05T05:29:00+10:00,2023-06-05,05:29,0,2,2
35,2023-06-05T05:29:00+10:00,2023-06-05,05:29,2,0,2
28,2023-06-05T05:29:00+10:00,2023-06-05,05:29,0,1,1
52,2023-06-05T05:29:00+10:00,2023-06-05,05:29,0,1,1
3,2023-06-05T05:29:00+10:00,2023-06-05,05:29,4,1,5
6,2023-06-05T05:29:00+10:00,2023-06-05,05:29,1,2,3
21,2023-06-05T05:29:00+10:00,2023-06-05,05:29,3,0,3
108,2023-06-05T05:29:00+10:00,2023-06-05,05:29,0,1,1
46,2023-06-05T05:29:00+10:00,2023-06-05,05:29,0,2,2
62,2023-06-05T05:29:00+10:00,2023-06-05,05:29,0,1,1
68,2023-06-05T05:29:00+10:00,2023-06-05,05:29,1,0,1
5,2023-06-05T05:28:00+10:00,2023-06-05,05:28,1,1,2
54,2023-06-05T05:28:00+10:00,2023-06-05,05:28,0,1,1
18,2023-06-05T05:28:00+10:00,2023-06-05,05:28,0,2,2
35,2023-06-05T05:28:00+10:00,2023-06-05,05:28,1,0,1
49,2023-06-05T05:28:00+10:00,2023-06-05,05:28,1,0,1
51,2023-06-05T05:28:00+10:00,2023-06-05,05:28,0,1,1
26,2023-06-05T05:28:00+10:00,2023-06-05,05:28,0,1,1
28,2023-06-05T05:28:00+10:00,2023-06-05,05:28,0,1,1
41,2023-06-05T05:28:00+10:00,2023-06-05,05:28,1,2,3
3,2023-06-05T05:28:00+10:00,2023-06-05,05:28,2,0,2
4,2023-06-05T05:28:00+10:00,2023-06-05,05:28,1,1,2
6,2023-06-05T05:28:00+10:00,2023-06-05,05:28,1,2,3
47,2023-06-05T05:28:00+10:00,2023-06-05,05:28,0,1,1
66,2023-06-05T05:28:00+10:00,2023-06-05,05:28,0,1,1
19,2023-06-05T05:28:00+10:00,2023-06-05,05:28,0,1,1
24,2023-06-05T05:28:00+10:00,2023-06-05,05:28,2,1,3
67,2023-06-05T05:28:00+10:00,2023-06-05,05:28,1,0,1
3,2023-06-05T05:27:00+10:00,2023-06-05,05:27,0,2,2
30,2023-06-05T05:27:00+10:00,2023-06-05,05:27,0,1,1
67,2023-06-05T05:27:00+10:00,2023-06-05,05:27,0,1,1
5,2023-06-05T05:27:00+10:00,2023-06-05,05:27,2,0,2
6,2023-06-05T05:27:00+10:00,2023-06-05,05:27,2,2,4
40,2023-06-05T05:27:00+10:00,2023-06-05,05:27,0,1,1
55,2023-06-05T05:27:00+10:00,2023-06-05,05:27,1,1,2
9,2023-06-05T05:27:00+10:00,2023-06-05,05:27,2,0,2
12,2023-06-05T05:27:00+10:00,2023-06-05,05:27,2,0,2
24,2023-06-05T05:27:00+10:00,2023-06-05,05:27,2,0,2
35,2023-06-05T05:27:00+10:00,2023-06-05,05:27,0,1,1
51,2023-06-05T05:27:00+10:00,2023-06-05,05:27,0,1,1
28,2023-06-05T05:27:00+10:00,2023-06-05,05:27,0,1,1
36,2023-06-05T05:27:00+10:00,2023-06-05,05:27,1,0,1
41,2023-06-05T05:27:00+10:00,2023-06-05,05:27,0,2,2
47,2023-06-05T05:27:00+10:00,2023-06-05,05:27,0,1,1
77,2023-06-05T05:27:00+10:00,2023-06-05,05:27,0,1,1
23,2023-06-05T05:27:00+10:00,2023-06-05,05:27,1,0,1
49,2023-06-05T05:27:00+10:00,2023-06-05,05:27,0,1,1
58,2023-06-05T05:27:00+10:00,2023-06-05,05:27,1,2,3
79,2023-06-05T05:27:00+10:00,2023-06-05,05:27,0,1,1
4,2023-06-05T05:26:00+10:00,2023-06-05,05:26,1,0,1
26,2023-06-05T05:26:00+10:00,2023-06-05,05:26,1,0,1
9,2023-06-05T05:26:00+10:00,2023-06-05,05:26,2,0,2
48,2023-06-05T05:26:00+10:00,2023-06-05,05:26,1,0,1
58,2023-06-05T05:26:00+10:00,2023-06-05,05:26,1,0,1
21,2023-06-05T05:26:00+10:00,2023-06-05,05:26,3,1,4
55,2023-06-05T05:26:00+10:00,2023-06-05,05:26,0,1,1
71,2023-06-05T05:26:00+10:00,2023-06-05,05:26,1,1,2
2,2023-06-05T05:26:00+10:00,2023-06-05,05:26,1,0,1
17,2023-06-05T05:26:00+10:00,2023-06-05,05:26,2,0,2
24,2023-06-05T05:26:00+10:00,2023-06-05,05:26,3,0,3
30,2023-06-05T05:26:00+10:00,2023-06-05,05:26,1,0,1
49,2023-06-05T05:26:00+10:00,2023-06-05,05:26,0,1,1
51,2023-06-05T05:26:00+10:00,2023-06-05,05:26,1,0,1
3,2023-06-05T05:26:00+10:00,2023-06-05,05:26,0,1,1
41,2023-06-05T05:26:00+10:00,2023-06-05,05:26,0,1,1
47,2023-06-05T05:26:00+10:00,2023-06-05,05:26,0,2,2
70,2023-06-05T05:26:00+10:00,2023-06-05,05:26,1,0,1
108,2023-06-05T05:26:00+10:00,2023-06-05,05:26,0,2,2
23,2023-06-05T05:26:00+10:00,2023-06-05,05:26,0,4,4
35,2023-06-05T05:26:00+10:00,2023-06-05,05:26,1,0,1
3,2023-06-05T05:25:00+10:00,2023-06-05,05:25,0,1,1
6,2023-06-05T05:25:00+10:00,2023-06-05,05:25,0,1,1
26,2023-06-05T05:25:00+10:00,2023-06-05,05:25,1,0,1
39,2023-06-05T05:25:00+10:00,2023-06-05,05:25,1,0,1
77,2023-06-05T05:25:00+10:00,2023-06-05,05:25,0,1,1
24,2023-06-05T05:25:00+10:00,2023-06-05,05:25,1,0,1
46,2023-06-05T05:25:00+10:00,2023-06-05,05:25,1,0,1
57,2023-06-05T05:25:00+10:00,2023-06-05,05:25,0,1,1
76,2023-06-05T05:25:00+10:00,2023-06-05,05:25,0,1,1
109,2023-06-05T05:25:00+10:00,2023-06-05,05:25,2,1,3
4,2023-06-05T05:25:00+10:00,2023-06-05,05:25,0,1,1
28,2023-06-05T05:25:00+10:00,2023-06-05,05:25,0,3,3
47,2023-06-05T05:25:00+10:00,2023-06-05,05:25,0,1,1
61,2023-06-05T05:25:00+10:00,2023-06-05,05:25,0,1,1
71,2023-06-05T05:25:00+10:00,2023-06-05,05:25,0,1,1
84,2023-06-05T05:25:00+10:00,2023-06-05,05:25,4,1,5
108,2023-06-05T05:25:00+10:00,2023-06-05,05:25,0,1,1
1,2023-06-05T05:25:00+10:00,2023-06-05,05:25,2,0,2
5,2023-06-05T05:25:00+10:00,2023-06-05,05:25,1,0,1
41,2023-06-05T05:25:00+10:00,2023-06-05,05:25,1,0,1
107,2023-06-05T05:25:00+10:00,2023-06-05,05:25,1,0,1
23,2023-06-05T05:25:00+10:00,2023-06-05,05:25,1,0,1
30,2023-06-05T05:25:00+10:00,2023-06-05,05:25,0,2,2
35,2023-06-05T05:25:00+10:00,2023-06-05,05:25,2,0,2
62,2023-06-05T05:25:00+10:00,2023-06-05,05:25,1,0,1
79,2023-06-05T05:25:00+10:00,2023-06-05,05:25,0,1,1
70,2023-06-05T05:24:00+10:00,2023-06-05,05:24,1,0,1
19,2023-06-05T05:24:00+10:00,2023-06-05,05:24,2,0,2
23,2023-06-05T05:24:00+10:00,2023-06-05,05:24,1,0,1
57,2023-06-05T05:24:00+10:00,2023-06-05,05:24,1,1,2
67,2023-06-05T05:24:00+10:00,2023-06-05,05:24,1,0,1
79,2023-06-05T05:24:00+10:00,2023-06-05,05:24,0,1,1
6,2023-06-05T05:24:00+10:00,2023-06-05,05:24,1,0,1
28,2023-06-05T05:24:00+10:00,2023-06-05,05:24,1,1,2
41,2023-06-05T05:24:00+10:00,2023-06-05,05:24,3,2,5
85,2023-06-05T05:24:00+10:00,2023-06-05,05:24,1,0,1
3,2023-06-05T05:24:00+10:00,2023-06-05,05:24,1,0,1
5,2023-06-05T05:24:00+10:00,2023-06-05,05:24,0,1,1
55,2023-06-05T05:24:00+10:00,2023-06-05,05:24,2,4,6
2,2023-06-05T05:24:00+10:00,2023-06-05,05:24,0,1,1
30,2023-06-05T05:24:00+10:00,2023-06-05,05:24,0,2,2
68,2023-06-05T05:24:00+10:00,2023-06-05,05:24,2,2,4
5,2023-06-05T05:23:00+10:00,2023-06-05,05:23,0,1,1
14,2023-06-05T05:23:00+10:00,2023-06-05,05:23,0,1,1
55,2023-06-05T05:23:00+10:00,2023-06-05,05:23,0,4,4
108,2023-06-05T05:23:00+10:00,2023-06-05,05:23,0,1,1
9,2023-06-05T05:23:00+10:00,2023-06-05,05:23,0,1,1
17,2023-06-05T05:23:00+10:00,2023-06-05,05:23,0,1,1
18,2023-06-05T05:23:00+10:00,2023-06-05,05:23,0,1,1
35,2023-06-05T05:23:00+10:00,2023-06-05,05:23,0,1,1
68,2023-06-05T05:23:00+10:00,2023-06-05,05:23,0,1,1
21,2023-06-05T05:23:00+10:00,2023-06-05,05:23,0,2,2
26,2023-06-05T05:23:00+10:00,2023-06-05,05:23,0,1,1
28,2023-06-05T05:23:00+10:00,2023-06-05,05:23,1,0,1
29,2023-06-05T05:23:00+10:00,2023-06-05,05:23,0,1,1
52,2023-06-05T05:23:00+10:00,2023-06-05,05:23,0,7,7
53,2023-06-05T05:23:00+10:00,2023-06-05,05:23,0,1,1
3,2023-06-05T05:23:00+10:00,2023-06-05,05:23,1,1,2
41,2023-06-05T05:23:00+10:00,2023-06-05,05:23,0,1,1
49,2023-06-05T05:23:00+10:00,2023-06-05,05:23,1,0,1
57,2023-06-05T05:23:00+10:00,2023-06-05,05:23,4,0,4
4,2023-06-05T05:22:00+10:00,2023-06-05,05:22,1,0,1
26,2023-06-05T05:22:00+10:00,2023-06-05,05:22,0,1,1
41,2023-06-05T05:22:00+10:00,2023-06-05,05:22,1,2,3
65,2023-06-05T05:22:00+10:00,2023-06-05,05:22,0,1,1
17,2023-06-05T05:22:00+10:00,2023-06-05,05:22,1,0,1
35,2023-06-05T05:22:00+10:00,2023-06-05,05:22,0,1,1
67,2023-06-05T05:22:00+10:00,2023-06-05,05:22,2,0,2
5,2023-06-05T05:22:00+10:00,2023-06-05,05:22,0,1,1
69,2023-06-05T05:22:00+10:00,2023-06-05,05:22,1,0,1
2,2023-06-05T05:22:00+10:00,2023-06-05,05:22,0,2,2
19,2023-06-05T05:22:00+10:00,2023-06-05,05:22,0,1,1
51,2023-06-05T05:22:00+10:00,2023-06-05,05:22,2,0,2
58,2023-06-05T05:22:00+10:00,2023-06-05,05:22,0,1,1
3,2023-06-05T05:22:00+10:00,2023-06-05,05:22,1,0,1
108,2023-06-05T05:22:00+10:00,2023-06-05,05:22,0,3,3
72,2023-06-05T05:22:00+10:00,2023-06-05,05:22,1,0,1
5,2023-06-05T05:21:00+10:00,2023-06-05,05:21,0,1,1
37,2023-06-05T05:21:00+10:00,2023-06-05,05:21,0,1,1
61,2023-06-05T05:21:00+10:00,2023-06-05,05:21,3,1,4
108,2023-06-05T05:21:00+10:00,2023-06-05,05:21,1,0,1
2,2023-06-05T05:21:00+10:00,2023-06-05,05:21,1,2,3
20,2023-06-05T05:21:00+10:00,2023-06-05,05:21,2,0,2
23,2023-06-05T05:21:00+10:00,2023-06-05,05:21,2,0,2
24,2023-06-05T05:21:00+10:00,2023-06-05,05:21,0,1,1
58,2023-06-05T05:21:00+10:00,2023-06-05,05:21,2,0,2
28,2023-06-05T05:21:00+10:00,2023-06-05,05:21,0,1,1
41,2023-06-05T05:21:00+10:00,2023-06-05,05:21,4,1,5
51,2023-06-05T05:21:00+10:00,2023-06-05,05:21,1,0,1
56,2023-06-05T05:21:00+10:00,2023-06-05,05:21,6,0,6
67,2023-06-05T05:21:00+10:00,2023-06-05,05:21,0,1,1
29,2023-06-05T05:21:00+10:00,2023-06-05,05:21,0,3,3
65,2023-06-05T05:21:00+10:00,2023-06-05,05:21,0,1,1
78,2023-06-05T05:21:00+10:00,2023-06-05,05:21,1,0,1
35,2023-06-05T05:21:00+10:00,2023-06-05,05:21,1,0,1
52,2023-06-05T05:21:00+10:00,2023-06-05,05:21,0,1,1
84,2023-06-05T05:20:00+10:00,2023-06-05,05:20,0,4,4
107,2023-06-05T05:20:00+10:00,2023-06-05,05:20,1,1,2
108,2023-06-05T05:20:00+10:00,2023-06-05,05:20,1,1,2
17,2023-06-05T05:20:00+10:00,2023-06-05,05:20,2,0,2
35,2023-06-05T05:20:00+10:00,2023-06-05,05:20,1,1,2
48,2023-06-05T05:20:00+10:00,2023-06-05,05:20,1,0,1
3,2023-06-05T05:20:00+10:00,2023-06-05,05:20,8,0,8
26,2023-06-05T05:20:00+10:00,2023-06-05,05:20,1,1,2
28,2023-06-05T05:20:00+10:00,2023-06-05,05:20,1,1,2
62,2023-06-05T05:20:00+10:00,2023-06-05,05:20,0,1,1
6,2023-06-05T05:20:00+10:00,2023-06-05,05:20,0,1,1
41,2023-06-05T05:20:00+10:00,2023-06-05,05:20,1,5,6
55,2023-06-05T05:20:00+10:00,2023-06-05,05:20,1,0,1
53,2023-06-05T05:20:00+10:00,2023-06-05,05:20,0,1,1
109,2023-06-05T05:20:00+10:00,2023-06-05,05:20,0,3,3
26,2023-06-05T05:19:00+10:00,2023-06-05,05:19,0,1,1
35,2023-06-05T05:19:00+10:00,2023-06-05,05:19,0,1,1
51,2023-06-05T05:19:00+10:00,2023-06-05,05:19,1,0,1
56,2023-06-05T05:19:00+10:00,2023-06-05,05:19,2,0,2
62,2023-06-05T05:19:00+10:00,2023-06-05,05:19,1,0,1
6,2023-06-05T05:19:00+10:00,2023-06-05,05:19,2,2,4
28,2023-06-05T05:19:00+10:00,2023-06-05,05:19,0,1,1
108,2023-06-05T05:19:00+10:00,2023-06-05,05:19,1,0,1
5,2023-06-05T05:19:00+10:00,2023-06-05,05:19,1,3,4
21,2023-06-05T05:19:00+10:00,2023-06-05,05:19,0,2,2
69,2023-06-05T05:19:00+10:00,2023-06-05,05:19,1,0,1
1,2023-06-05T05:19:00+10:00,2023-06-05,05:19,1,0,1
19,2023-06-05T05:19:00+10:00,2023-06-05,05:19,1,0,1
72,2023-06-05T05:19:00+10:00,2023-06-05,05:19,0,1,1
79,2023-06-05T05:19:00+10:00,2023-06-05,05:19,1,0,1
4,2023-06-05T05:18:00+10:00,2023-06-05,05:18,0,1,1
6,2023-06-05T05:18:00+10:00,2023-06-05,05:18,0,1,1
28,2023-06-05T05:18:00+10:00,2023-06-05,05:18,0,1,1
36,2023-06-05T05:18:00+10:00,2023-06-05,05:18,1,0,1
62,2023-06-05T05:18:00+10:00,2023-06-05,05:18,1,1,2
79,2023-06-05T05:18:00+10:00,2023-06-05,05:18,1,1,2
3,2023-06-05T05:18:00+10:00,2023-06-05,05:18,0,1,1
41,2023-06-05T05:18:00+10:00,2023-06-05,05:18,0,2,2
55,2023-06-05T05:18:00+10:00,2023-06-05,05:18,2,1,3
65,2023-06-05T05:18:00+10:00,2023-06-05,05:18,1,0,1
108,2023-06-05T05:18:00+10:00,2023-06-05,05:18,0,1,1
56,2023-06-05T05:18:00+10:00,2023-06-05,05:18,1,0,1
47,2023-06-05T05:18:00+10:00,2023-06-05,05:18,2,3,5
54,2023-06-05T05:18:00+10:00,2023-06-05,05:18,1,0,1
1,2023-06-05T05:18:00+10:00,2023-06-05,05:18,1,0,1
23,2023-06-05T05:18:00+10:00,2023-06-05,05:18,0,10,10
27,2023-06-05T05:18:00+10:00,2023-06-05,05:18,0,2,2
85,2023-06-05T05:18:00+10:00,2023-06-05,05:18,1,0,1
66,2023-06-05T05:17:00+10:00,2023-06-05,05:17,0,1,1
20,2023-06-05T05:17:00+10:00,2023-06-05,05:17,0,4,4
52,2023-06-05T05:17:00+10:00,2023-06-05,05:17,0,1,1
58,2023-06-05T05:17:00+10:00,2023-06-05,05:17,0,1,1
72,2023-06-05T05:17:00+10:00,2023-06-05,05:17,0,2,2
3,2023-06-05T05:17:00+10:00,2023-06-05,05:17,0,1,1
6,2023-06-05T05:17:00+10:00,2023-06-05,05:17,2,1,3
41,2023-06-05T05:17:00+10:00,2023-06-05,05:17,0,1,1
55,2023-06-05T05:17:00+10:00,2023-06-05,05:17,0,1,1
10,2023-06-05T05:17:00+10:00,2023-06-05,05:17,1,0,1
24,2023-06-05T05:17:00+10:00,2023-06-05,05:17,4,1,5
35,2023-06-05T05:17:00+10:00,2023-06-05,05:17,3,0,3
53,2023-06-05T05:17:00+10:00,2023-06-05,05:17,0,1,1
4,2023-06-05T05:17:00+10:00,2023-06-05,05:17,0,1,1
5,2023-06-05T05:17:00+10:00,2023-06-05,05:17,2,1,3
2,2023-06-05T05:17:00+10:00,2023-06-05,05:17,0,1,1
17,2023-06-05T05:17:00+10:00,2023-06-05,05:17,1,0,1
30,2023-06-05T05:17:00+10:00,2023-06-05,05:17,1,3,4
79,2023-06-05T05:17:00+10:00,2023-06-05,05:17,2,0,2
26,2023-06-05T05:16:00+10:00,2023-06-05,05:16,0,1,1
41,2023-06-05T05:16:00+10:00,2023-06-05,05:16,0,1,1
77,2023-06-05T05:16:00+10:00,2023-06-05,05:16,0,1,1
9,2023-06-05T05:16:00+10:00,2023-06-05,05:16,1,0,1
24,2023-06-05T05:16:00+10:00,2023-06-05,05:16,2,5,7
35,2023-06-05T05:16:00+10:00,2023-06-05,05:16,1,0,1
79,2023-06-05T05:16:00+10:00,2023-06-05,05:16,1,1,2
5,2023-06-05T05:16:00+10:00,2023-06-05,05:16,0,2,2
6,2023-06-05T05:16:00+10:00,2023-06-05,05:16,1,0,1
28,2023-06-05T05:16:00+10:00,2023-06-05,05:16,0,2,2
42,2023-06-05T05:16:00+10:00,2023-06-05,05:16,0,1,1
47,2023-06-05T05:16:00+10:00,2023-06-05,05:16,0,1,1
19,2023-06-05T05:16:00+10:00,2023-06-05,05:16,0,1,1
51,2023-06-05T05:16:00+10:00,2023-06-05,05:16,0,2,2
62,2023-06-05T05:16:00+10:00,2023-06-05,05:16,0,1,1
3,2023-06-05T05:16:00+10:00,2023-06-05,05:16,0,7,7
40,2023-06-05T05:16:00+10:00,2023-06-05,05:16,0,1,1
66,2023-06-05T05:16:00+10:00,2023-06-05,05:16,3,0,3
30,2023-06-05T05:16:00+10:00,2023-06-05,05:16,2,4,6
55,2023-06-05T05:15:00+10:00,2023-06-05,05:15,0,1,1
17,2023-06-05T05:15:00+10:00,2023-06-05,05:15,0,1,1
24,2023-06-05T05:15:00+10:00,2023-06-05,05:15,1,1,2
30,2023-06-05T05:15:00+10:00,2023-06-05,05:15,0,1,1
35,2023-06-05T05:15:00+10:00,2023-06-05,05:15,3,0,3
51,2023-06-05T05:15:00+10:00,2023-06-05,05:15,1,0,1
3,2023-06-05T05:15:00+10:00,2023-06-05,05:15,1,0,1
6,2023-06-05T05:15:00+10:00,2023-06-05,05:15,1,0,1
41,2023-06-05T05:15:00+10:00,2023-06-05,05:15,0,1,1
79,2023-06-05T05:15:00+10:00,2023-06-05,05:15,1,2,3
109,2023-06-05T05:15:00+10:00,2023-06-05,05:15,0,2,2
4,2023-06-05T05:15:00+10:00,2023-06-05,05:15,0,1,1
47,2023-06-05T05:15:00+10:00,2023-06-05,05:15,0,2,2
84,2023-06-05T05:15:00+10:00,2023-06-05,05:15,1,2,3
62,2023-06-05T05:15:00+10:00,2023-06-05,05:15,0,2,2
117,2023-06-05T05:15:00+10:00,2023-06-05,05:15,0,3,3
14,2023-06-05T05:14:00+10:00,2023-06-05,05:14,1,0,1
108,2023-06-05T05:14:00+10:00,2023-06-05,05:14,0,2,2
35,2023-06-05T05:14:00+10:00,2023-06-05,05:14,1,0,1
3,2023-06-05T05:14:00+10:00,2023-06-05,05:14,0,1,1
28,2023-06-05T05:14:00+10:00,2023-06-05,05:14,0,1,1
41,2023-06-05T05:14:00+10:00,2023-06-05,05:14,0,2,2
47,2023-06-05T05:14:00+10:00,2023-06-05,05:14,0,1,1
55,2023-06-05T05:14:00+10:00,2023-06-05,05:14,1,2,3
66,2023-06-05T05:14:00+10:00,2023-06-05,05:14,1,1,2
23,2023-06-05T05:14:00+10:00,2023-06-05,05:14,0,2,2
24,2023-06-05T05:14:00+10:00,2023-06-05,05:14,0,1,1
21,2023-06-05T05:14:00+10:00,2023-06-05,05:14,0,1,1
45,2023-06-05T05:14:00+10:00,2023-06-05,05:14,1,0,1
1,2023-06-05T05:14:00+10:00,2023-06-05,05:14,2,0,2
53,2023-06-05T05:14:00+10:00,2023-06-05,05:14,1,0,1
57,2023-06-05T05:14:00+10:00,2023-06-05,05:14,2,1,3
79,2023-06-05T05:14:00+10:00,2023-06-05,05:14,1,1,2
62,2023-06-05T05:13:00+10:00,2023-06-05,05:13,3,3,6
5,2023-06-05T05:13:00+10:00,2023-06-05,05:13,1,0,1
41,2023-06-05T05:13:00+10:00,2023-06-05,05:13,1,2,3
47,2023-06-05T05:13:00+10:00,2023-06-05,05:13,1,0,1
55,2023-06-05T05:13:00+10:00,2023-06-05,05:13,1,1,2
17,2023-06-05T05:13:00+10:00,2023-06-05,05:13,1,0,1
23,2023-06-05T05:13:00+10:00,2023-06-05,05:13,2,0,2
21,2023-06-05T05:13:00+10:00,2023-06-05,05:13,2,0,2
28,2023-06-05T05:13:00+10:00,2023-06-05,05:13,0,2,2
66,2023-06-05T05:13:00+10:00,2023-06-05,05:13,0,1,1
35,2023-06-05T05:13:00+10:00,2023-06-05,05:13,1,0,1
52,2023-06-05T05:13:00+10:00,2023-06-05,05:13,0,1,1
72,2023-06-05T05:13:00+10:00,2023-06-05,05:13,1,2,3
3,2023-06-05T05:12:00+10:00,2023-06-05,05:12,1,0,1
41,2023-06-05T05:12:00+10:00,2023-06-05,05:12,0,2,2
24,2023-06-05T05:12:00+10:00,2023-06-05,05:12,0,2,2
72,2023-06-05T05:12:00+10:00,2023-06-05,05:12,2,0,2
5,2023-06-05T05:12:00+10:00,2023-06-05,05:12,0,1,1
40,2023-06-05T05:12:00+10:00,2023-06-05,05:12,0,1,1
108,2023-06-05T05:12:00+10:00,2023-06-05,05:12,0,2,2
9,2023-06-05T05:12:00+10:00,2023-06-05,05:12,0,1,1
62,2023-06-05T05:12:00+10:00,2023-06-05,05:12,0,1,1
67,2023-06-05T05:12:00+10:00,2023-06-05,05:12,0,1,1
6,2023-06-05T05:12:00+10:00,2023-06-05,05:12,1,0,1
87,2023-06-05T05:12:00+10:00,2023-06-05,05:12,0,1,1
17,2023-06-05T05:12:00+10:00,2023-06-05,05:12,0,1,1
18,2023-06-05T05:12:00+10:00,2023-06-05,05:12,0,1,1
30,2023-06-05T05:12:00+10:00,2023-06-05,05:12,1,3,4
57,2023-06-05T05:12:00+10:00,2023-06-05,05:12,1,0,1
41,2023-06-05T05:11:00+10:00,2023-06-05,05:11,2,5,7
50,2023-06-05T05:11:00+10:00,2023-06-05,05:11,4,0,4
17,2023-06-05T05:11:00+10:00,2023-06-05,05:11,1,0,1
49,2023-06-05T05:11:00+10:00,2023-06-05,05:11,0,2,2
6,2023-06-05T05:11:00+10:00,2023-06-05,05:11,1,0,1
21,2023-06-05T05:11:00+10:00,2023-06-05,05:11,1,0,1
20,2023-06-05T05:11:00+10:00,2023-06-05,05:11,0,1,1
23,2023-06-05T05:11:00+10:00,2023-06-05,05:11,1,0,1
26,2023-06-05T05:11:00+10:00,2023-06-05,05:11,1,0,1
28,2023-06-05T05:11:00+10:00,2023-06-05,05:11,0,1,1
47,2023-06-05T05:11:00+10:00,2023-06-05,05:11,1,0,1
24,2023-06-05T05:11:00+10:00,2023-06-05,05:11,1,0,1
36,2023-06-05T05:10:00+10:00,2023-06-05,05:10,1,0,1
55,2023-06-05T05:10:00+10:00,2023-06-05,05:10,0,1,1
24,2023-06-05T05:10:00+10:00,2023-06-05,05:10,0,1,1
109,2023-06-05T05:10:00+10:00,2023-06-05,05:10,0,1,1
35,2023-06-05T05:10:00+10:00,2023-06-05,05:10,2,0,2
3,2023-06-05T05:10:00+10:00,2023-06-05,05:10,0,1,1
47,2023-06-05T05:10:00+10:00,2023-06-05,05:10,1,0,1
9,2023-06-05T05:10:00+10:00,2023-06-05,05:10,0,2,2
17,2023-06-05T05:10:00+10:00,2023-06-05,05:10,2,0,2
18,2023-06-05T05:10:00+10:00,2023-06-05,05:10,0,1,1
3,2023-06-05T05:09:00+10:00,2023-06-05,05:09,0,1,1
87,2023-06-05T05:09:00+10:00,2023-06-05,05:09,1,0,1
2,2023-06-05T05:09:00+10:00,2023-06-05,05:09,0,2,2
41,2023-06-05T05:09:00+10:00,2023-06-05,05:09,1,0,1
55,2023-06-05T05:09:00+10:00,2023-06-05,05:09,0,1,1
61,2023-06-05T05:09:00+10:00,2023-06-05,05:09,0,1,1
23,2023-06-05T05:09:00+10:00,2023-06-05,05:09,1,1,2
52,2023-06-05T05:09:00+10:00,2023-06-05,05:09,0,1,1
62,2023-06-05T05:09:00+10:00,2023-06-05,05:09,0,1,1
4,2023-06-05T05:09:00+10:00,2023-06-05,05:09,0,2,2
5,2023-06-05T05:09:00+10:00,2023-06-05,05:09,1,0,1
21,2023-06-05T05:09:00+10:00,2023-06-05,05:09,2,0,2
4,2023-06-05T05:08:00+10:00,2023-06-05,05:08,1,0,1
5,2023-06-05T05:08:00+10:00,2023-06-05,05:08,1,0,1
61,2023-06-05T05:08:00+10:00,2023-06-05,05:08,0,2,2
1,2023-06-05T05:08:00+10:00,2023-06-05,05:08,1,0,1
79,2023-06-05T05:08:00+10:00,2023-06-05,05:08,2,0,2
47,2023-06-05T05:08:00+10:00,2023-06-05,05:08,0,3,3
66,2023-06-05T05:08:00+10:00,2023-06-05,05:08,0,1,1
2,2023-06-05T05:08:00+10:00,2023-06-05,05:08,0,1,1
24,2023-06-05T05:08:00+10:00,2023-06-05,05:08,0,1,1
6,2023-06-05T05:08:00+10:00,2023-06-05,05:08,1,0,1
14,2023-06-05T05:08:00+10:00,2023-06-05,05:08,1,0,1
55,2023-06-05T05:08:00+10:00,2023-06-05,05:08,2,0,2
19,2023-06-05T05:08:00+10:00,2023-06-05,05:08,0,1,1
62,2023-06-05T05:08:00+10:00,2023-06-05,05:08,1,0,1
72,2023-06-05T05:08:00+10:00,2023-06-05,05:08,1,1,2
41,2023-06-05T05:07:00+10:00,2023-06-05,05:07,0,2,2
24,2023-06-05T05:07:00+10:00,2023-06-05,05:07,0,1,1
6,2023-06-05T05:07:00+10:00,2023-06-05,05:07,1,0,1
21,2023-06-05T05:07:00+10:00,2023-06-05,05:07,0,1,1
2,2023-06-05T05:07:00+10:00,2023-06-05,05:07,2,0,2
58,2023-06-05T05:07:00+10:00,2023-06-05,05:07,1,4,5
62,2023-06-05T05:07:00+10:00,2023-06-05,05:07,1,0,1
79,2023-06-05T05:07:00+10:00,2023-06-05,05:07,0,1,1
87,2023-06-05T05:07:00+10:00,2023-06-05,05:07,0,1,1
17,2023-06-05T05:07:00+10:00,2023-06-05,05:07,1,0,1
23,2023-06-05T05:07:00+10:00,2023-06-05,05:07,1,0,1
6,2023-06-05T05:06:00+10:00,2023-06-05,05:06,1,0,1
14,2023-06-05T05:06:00+10:00,2023-06-05,05:06,1,0,1
29,2023-06-05T05:06:00+10:00,2023-06-05,05:06,1,0,1
47,2023-06-05T05:06:00+10:00,2023-06-05,05:06,1,0,1
1,2023-06-05T05:06:00+10:00,2023-06-05,05:06,1,0,1
5,2023-06-05T05:06:00+10:00,2023-06-05,05:06,1,0,1
8,2023-06-05T05:06:00+10:00,2023-06-05,05:06,0,1,1
45,2023-06-05T05:06:00+10:00,2023-06-05,05:06,0,1,1
24,2023-06-05T05:06:00+10:00,2023-06-05,05:06,0,1,1
31,2023-06-05T05:05:00+10:00,2023-06-05,05:05,6,0,6
55,2023-06-05T05:05:00+10:00,2023-06-05,05:05,2,0,2
23,2023-06-05T05:05:00+10:00,2023-06-05,05:05,1,0,1
109,2023-06-05T05:05:00+10:00,2023-06-05,05:05,0,1,1
10,2023-06-05T05:05:00+10:00,2023-06-05,05:05,1,0,1
24,2023-06-05T05:05:00+10:00,2023-06-05,05:05,3,1,4
30,2023-06-05T05:05:00+10:00,2023-06-05,05:05,0,1,1
57,2023-06-05T05:05:00+10:00,2023-06-05,05:05,0,3,3
5,2023-06-05T05:05:00+10:00,2023-06-05,05:05,1,1,2
26,2023-06-05T05:05:00+10:00,2023-06-05,05:05,0,1,1
84,2023-06-05T05:05:00+10:00,2023-06-05,05:05,1,1,2
20,2023-06-05T05:05:00+10:00,2023-06-05,05:05,0,2,2
35,2023-06-05T05:05:00+10:00,2023-06-05,05:05,2,0,2
117,2023-06-05T05:05:00+10:00,2023-06-05,05:05,0,1,1
3,2023-06-05T05:04:00+10:00,2023-06-05,05:04,1,0,1
4,2023-06-05T05:04:00+10:00,2023-06-05,05:04,0,1,1
6,2023-06-05T05:04:00+10:00,2023-06-05,05:04,1,0,1
21,2023-06-05T05:04:00+10:00,2023-06-05,05:04,2,0,2
44,2023-06-05T05:04:00+10:00,2023-06-05,05:04,0,1,1
30,2023-06-05T05:04:00+10:00,2023-06-05,05:04,0,1,1
53,2023-06-05T05:04:00+10:00,2023-06-05,05:04,0,2,2
58,2023-06-05T05:04:00+10:00,2023-06-05,05:04,1,0,1
62,2023-06-05T05:04:00+10:00,2023-06-05,05:04,1,0,1
41,2023-06-05T05:04:00+10:00,2023-06-05,05:04,0,1,1
57,2023-06-05T05:04:00+10:00,2023-06-05,05:04,0,1,1
6,2023-06-05T05:03:00+10:00,2023-06-05,05:03,1,0,1
28,2023-06-05T05:03:00+10:00,2023-06-05,05:03,1,1,2
35,2023-06-05T05:03:00+10:00,2023-06-05,05:03,1,0,1
3,2023-06-05T05:03:00+10:00,2023-06-05,05:03,1,0,1
29,2023-06-05T05:03:00+10:00,2023-06-05,05:03,2,0,2
55,2023-06-05T05:03:00+10:00,2023-06-05,05:03,1,0,1
65,2023-06-05T05:03:00+10:00,2023-06-05,05:03,0,1,1
30,2023-06-05T05:03:00+10:00,2023-06-05,05:03,2,0,2
17,2023-06-05T05:03:00+10:00,2023-06-05,05:03,1,0,1
9,2023-06-05T05:02:00+10:00,2023-06-05,05:02,2,0,2
23,2023-06-05T05:02:00+10:00,2023-06-05,05:02,0,1,1
3,2023-06-05T05:02:00+10:00,2023-06-05,05:02,0,1,1
41,2023-06-05T05:02:00+10:00,2023-06-05,05:02,1,1,2
55,2023-06-05T05:02:00+10:00,2023-06-05,05:02,0,2,2
3,2023-06-05T05:01:00+10:00,2023-06-05,05:01,0,1,1
19,2023-06-05T05:01:00+10:00,2023-06-05,05:01,0,1,1
68,2023-06-05T05:01:00+10:00,2023-06-05,05:01,1,1,2
41,2023-06-05T05:01:00+10:00,2023-06-05,05:01,5,0,5
17,2023-06-05T05:01:00+10:00,2023-06-05,05:01,0,1,1
20,2023-06-05T05:01:00+10:00,2023-06-05,05:01,0,1,1
49,2023-06-05T05:01:00+10:00,2023-06-05,05:01,2,0,2
5,2023-06-05T05:01:00+10:00,2023-06-05,05:01,1,1,2
14,2023-06-05T05:01:00+10:00,2023-06-05,05:01,1,1,2
30,2023-06-05T05:01:00+10:00,2023-06-05,05:01,0,1,1
35,2023-06-05T05:01:00+10:00,2023-06-05,05:01,1,0,1
58,2023-06-05T05:01:00+10:00,2023-06-05,05:01,0,1,1
62,2023-06-05T05:01:00+10:00,2023-06-05,05:01,1,1,2
3,2023-06-05T05:00:00+10:00,2023-06-05,05:00,1,0,1
21,2023-06-05T05:00:00+10:00,2023-06-05,05:00,0,3,3
28,2023-06-05T05:00:00+10:00,2023-06-05,05:00,0,1,1
37,2023-06-05T05:00:00+10:00,2023-06-05,05:00,1,0,1
47,2023-06-05T05:00:00+10:00,2023-06-05,05:00,0,2,2
84,2023-06-05T05:00:00+10:00,2023-06-05,05:00,2,2,4
107,2023-06-05T05:00:00+10:00,2023-06-05,05:00,0,1,1
58,2023-06-05T05:00:00+10:00,2023-06-05,05:00,0,2,2
109,2023-06-05T05:00:00+10:00,2023-06-05,05:00,1,0,1
14,2023-06-05T05:00:00+10:00,2023-06-05,05:00,1,0,1
26,2023-06-05T05:00:00+10:00,2023-06-05,05:00,3,1,4
45,2023-06-05T05:00:00+10:00,2023-06-05,05:00,0,2,2
55,2023-06-05T05:00:00+10:00,2023-06-05,05:00,3,0,3
1,2023-06-05T05:00:00+10:00,2023-06-05,05:00,1,0,1
53,2023-06-05T05:00:00+10:00,2023-06-05,05:00,1,0,1
62,2023-06-05T05:00:00+10:00,2023-06-05,05:00,0,1,1
6,2023-06-05T05:00:00+10:00,2023-06-05,05:00,4,0,4
10,2023-06-05T05:00:00+10:00,2023-06-05,05:00,1,0,1
17,2023-06-05T05:00:00+10:00,2023-06-05,05:00,2,0,2
3,2023-06-05T04:59:00+10:00,2023-06-05,04:59,1,0,1
5,2023-06-05T04:59:00+10:00,2023-06-05,04:59,1,1,2
61,2023-06-05T04:59:00+10:00,2023-06-05,04:59,0,1,1
57,2023-06-05T04:59:00+10:00,2023-06-05,04:59,1,0,1
58,2023-06-05T04:59:00+10:00,2023-06-05,04:59,1,0,1
55,2023-06-05T04:59:00+10:00,2023-06-05,04:59,0,1,1
62,2023-06-05T04:59:00+10:00,2023-06-05,04:59,1,0,1
6,2023-06-05T04:59:00+10:00,2023-06-05,04:59,4,1,5
26,2023-06-05T04:59:00+10:00,2023-06-05,04:59,1,0,1
41,2023-06-05T04:59:00+10:00,2023-06-05,04:59,0,5,5
17,2023-06-05T04:59:00+10:00,2023-06-05,04:59,0,1,1
6,2023-06-05T04:58:00+10:00,2023-06-05,04:58,1,1,2
36,2023-06-05T04:58:00+10:00,2023-06-05,04:58,0,2,2
35,2023-06-05T04:58:00+10:00,2023-06-05,04:58,2,0,2
21,2023-06-05T04:58:00+10:00,2023-06-05,04:58,0,2,2
5,2023-06-05T04:58:00+10:00,2023-06-05,04:58,2,1,3
28,2023-06-05T04:58:00+10:00,2023-06-05,04:58,0,2,2
79,2023-06-05T04:58:00+10:00,2023-06-05,04:58,1,0,1
29,2023-06-05T04:57:00+10:00,2023-06-05,04:57,2,0,2
65,2023-06-05T04:57:00+10:00,2023-06-05,04:57,0,1,1
30,2023-06-05T04:57:00+10:00,2023-06-05,04:57,0,1,1
6,2023-06-05T04:57:00+10:00,2023-06-05,04:57,7,0,7
28,2023-06-05T04:57:00+10:00,2023-06-05,04:57,1,0,1
41,2023-06-05T04:57:00+10:00,2023-06-05,04:57,0,1,1
47,2023-06-05T04:57:00+10:00,2023-06-05,04:57,0,1,1
55,2023-06-05T04:57:00+10:00,2023-06-05,04:57,1,1,2
10,2023-06-05T04:57:00+10:00,2023-06-05,04:57,1,0,1
35,2023-06-05T04:57:00+10:00,2023-06-05,04:57,3,0,3
79,2023-06-05T04:57:00+10:00,2023-06-05,04:57,1,0,1
4,2023-06-05T04:56:00+10:00,2023-06-05,04:56,1,1,2
21,2023-06-05T04:56:00+10:00,2023-06-05,04:56,2,0,2
28,2023-06-05T04:56:00+10:00,2023-06-05,04:56,0,2,2
48,2023-06-05T04:56:00+10:00,2023-06-05,04:56,0,2,2
79,2023-06-05T04:56:00+10:00,2023-06-05,04:56,0,1,1
14,2023-06-05T04:56:00+10:00,2023-06-05,04:56,1,0,1
55,2023-06-05T04:56:00+10:00,2023-06-05,04:56,1,1,2
71,2023-06-05T04:56:00+10:00,2023-06-05,04:56,0,1,1
9,2023-06-05T04:56:00+10:00,2023-06-05,04:56,1,0,1
3,2023-06-05T04:56:00+10:00,2023-06-05,04:56,1,0,1
53,2023-06-05T04:56:00+10:00,2023-06-05,04:56,0,2,2
65,2023-06-05T04:55:00+10:00,2023-06-05,04:55,1,1,2
71,2023-06-05T04:55:00+10:00,2023-06-05,04:55,2,2,4
77,2023-06-05T04:55:00+10:00,2023-06-05,04:55,0,1,1
9,2023-06-05T04:55:00+10:00,2023-06-05,04:55,1,0,1
62,2023-06-05T04:55:00+10:00,2023-06-05,04:55,1,1,2
6,2023-06-05T04:55:00+10:00,2023-06-05,04:55,3,0,3
55,2023-06-05T04:55:00+10:00,2023-06-05,04:55,0,1,1
84,2023-06-05T04:55:00+10:00,2023-06-05,04:55,2,4,6
4,2023-06-05T04:55:00+10:00,2023-06-05,04:55,0,2,2
5,2023-06-05T04:55:00+10:00,2023-06-05,04:55,1,0,1
37,2023-06-05T04:55:00+10:00,2023-06-05,04:55,0,1,1
56,2023-06-05T04:55:00+10:00,2023-06-05,04:55,0,1,1
4,2023-06-05T04:54:00+10:00,2023-06-05,04:54,1,0,1
21,2023-06-05T04:54:00+10:00,2023-06-05,04:54,0,2,2
41,2023-06-05T04:54:00+10:00,2023-06-05,04:54,0,1,1
52,2023-06-05T04:54:00+10:00,2023-06-05,04:54,0,1,1
14,2023-06-05T04:54:00+10:00,2023-06-05,04:54,2,0,2
55,2023-06-05T04:54:00+10:00,2023-06-05,04:54,0,4,4
66,2023-06-05T04:54:00+10:00,2023-06-05,04:54,0,1,1
58,2023-06-05T04:54:00+10:00,2023-06-05,04:54,0,1,1
45,2023-06-05T04:54:00+10:00,2023-06-05,04:54,2,0,2
71,2023-06-05T04:54:00+10:00,2023-06-05,04:54,2,0,2
1,2023-06-05T04:54:00+10:00,2023-06-05,04:54,0,1,1
35,2023-06-05T04:54:00+10:00,2023-06-05,04:54,2,0,2
5,2023-06-05T04:53:00+10:00,2023-06-05,04:53,1,0,1
26,2023-06-05T04:53:00+10:00,2023-06-05,04:53,3,0,3
47,2023-06-05T04:53:00+10:00,2023-06-05,04:53,1,0,1
71,2023-06-05T04:53:00+10:00,2023-06-05,04:53,1,0,1
30,2023-06-05T04:53:00+10:00,2023-06-05,04:53,0,2,2
6,2023-06-05T04:53:00+10:00,2023-06-05,04:53,2,0,2
49,2023-06-05T04:53:00+10:00,2023-06-05,04:53,1,0,1
57,2023-06-05T04:53:00+10:00,2023-06-05,04:53,1,1,2
14,2023-06-05T04:53:00+10:00,2023-06-05,04:53,1,0,1
44,2023-06-05T04:53:00+10:00,2023-06-05,04:53,0,1,1
55,2023-06-05T04:53:00+10:00,2023-06-05,04:53,0,1,1
35,2023-06-05T04:53:00+10:00,2023-06-05,04:53,2,0,2
79,2023-06-05T04:53:00+10:00,2023-06-05,04:53,0,1,1
14,2023-06-05T04:52:00+10:00,2023-06-05,04:52,1,0,1
40,2023-06-05T04:52:00+10:00,2023-06-05,04:52,0,3,3
24,2023-06-05T04:52:00+10:00,2023-06-05,04:52,0,1,1
3,2023-06-05T04:52:00+10:00,2023-06-05,04:52,1,0,1
6,2023-06-05T04:52:00+10:00,2023-06-05,04:52,1,0,1
61,2023-06-05T04:52:00+10:00,2023-06-05,04:52,0,2,2
65,2023-06-05T04:52:00+10:00,2023-06-05,04:52,0,5,5
9,2023-06-05T04:52:00+10:00,2023-06-05,04:52,1,0,1
55,2023-06-05T04:52:00+10:00,2023-06-05,04:52,2,0,2
1,2023-06-05T04:52:00+10:00,2023-06-05,04:52,0,4,4
23,2023-06-05T04:52:00+10:00,2023-06-05,04:52,0,2,2
79,2023-06-05T04:52:00+10:00,2023-06-05,04:52,1,1,2
4,2023-06-05T04:51:00+10:00,2023-06-05,04:51,0,1,1
65,2023-06-05T04:51:00+10:00,2023-06-05,04:51,0,1,1
2,2023-06-05T04:51:00+10:00,2023-06-05,04:51,0,1,1
24,2023-06-05T04:51:00+10:00,2023-06-05,04:51,1,0,1
35,2023-06-05T04:51:00+10:00,2023-06-05,04:51,1,0,1
28,2023-06-05T04:51:00+10:00,2023-06-05,04:51,0,2,2
55,2023-06-05T04:51:00+10:00,2023-06-05,04:51,1,1,2
71,2023-06-05T04:51:00+10:00,2023-06-05,04:51,0,2,2
1,2023-06-05T04:51:00+10:00,2023-06-05,04:51,1,0,1
39,2023-06-05T04:50:00+10:00,2023-06-05,04:50,1,0,1
45,2023-06-05T04:50:00+10:00,2023-06-05,04:50,0,4,4
84,2023-06-05T04:50:00+10:00,2023-06-05,04:50,1,3,4
87,2023-06-05T04:50:00+10:00,2023-06-05,04:50,1,0,1
48,2023-06-05T04:50:00+10:00,2023-06-05,04:50,2,0,2
58,2023-06-05T04:50:00+10:00,2023-06-05,04:50,0,2,2
79,2023-06-05T04:50:00+10:00,2023-06-05,04:50,0,1,1
109,2023-06-05T04:50:00+10:00,2023-06-05,04:50,1,0,1
117,2023-06-05T04:50:00+10:00,2023-06-05,04:50,1,0,1
3,2023-06-05T04:50:00+10:00,2023-06-05,04:50,0,3,3
5,2023-06-05T04:50:00+10:00,2023-06-05,04:50,0,2,2
55,2023-06-05T04:50:00+10:00,2023-06-05,04:50,0,1,1
49,2023-06-05T04:50:00+10:00,2023-06-05,04:50,0,2,2
28,2023-06-05T04:50:00+10:00,2023-06-05,04:50,0,1,1
41,2023-06-05T04:50:00+10:00,2023-06-05,04:50,0,2,2
67,2023-06-05T04:50:00+10:00,2023-06-05,04:50,1,0,1
6,2023-06-05T04:49:00+10:00,2023-06-05,04:49,2,0,2
65,2023-06-05T04:49:00+10:00,2023-06-05,04:49,0,1,1
23,2023-06-05T04:49:00+10:00,2023-06-05,04:49,0,1,1
62,2023-06-05T04:49:00+10:00,2023-06-05,04:49,0,1,1
3,2023-06-05T04:49:00+10:00,2023-06-05,04:49,0,2,2
5,2023-06-05T04:49:00+10:00,2023-06-05,04:49,1,1,2
41,2023-06-05T04:49:00+10:00,2023-06-05,04:49,0,1,1
55,2023-06-05T04:49:00+10:00,2023-06-05,04:49,1,2,3
66,2023-06-05T04:49:00+10:00,2023-06-05,04:49,1,0,1
47,2023-06-05T04:49:00+10:00,2023-06-05,04:49,5,0,5
77,2023-06-05T04:49:00+10:00,2023-06-05,04:49,0,1,1
56,2023-06-05T04:49:00+10:00,2023-06-05,04:49,1,0,1
6,2023-06-05T04:48:00+10:00,2023-06-05,04:48,3,1,4
45,2023-06-05T04:48:00+10:00,2023-06-05,04:48,0,1,1
3,2023-06-05T04:48:00+10:00,2023-06-05,04:48,0,1,1
5,2023-06-05T04:48:00+10:00,2023-06-05,04:48,0,1,1
47,2023-06-05T04:48:00+10:00,2023-06-05,04:48,0,1,1
18,2023-06-05T04:48:00+10:00,2023-06-05,04:48,0,2,2
72,2023-06-05T04:48:00+10:00,2023-06-05,04:48,0,1,1
49,2023-06-05T04:48:00+10:00,2023-06-05,04:48,0,1,1
52,2023-06-05T04:48:00+10:00,2023-06-05,04:48,1,0,1
58,2023-06-05T04:48:00+10:00,2023-06-05,04:48,1,0,1
3,2023-06-05T04:47:00+10:00,2023-06-05,04:47,2,0,2
6,2023-06-05T04:47:00+10:00,2023-06-05,04:47,1,0,1
41,2023-06-05T04:47:00+10:00,2023-06-05,04:47,0,3,3
4,2023-06-05T04:47:00+10:00,2023-06-05,04:47,0,1,1
26,2023-06-05T04:47:00+10:00,2023-06-05,04:47,0,1,1
39,2023-06-05T04:46:00+10:00,2023-06-05,04:46,1,0,1
2,2023-06-05T04:46:00+10:00,2023-06-05,04:46,0,1,1
35,2023-06-05T04:46:00+10:00,2023-06-05,04:46,2,0,2
3,2023-06-05T04:46:00+10:00,2023-06-05,04:46,0,1,1
6,2023-06-05T04:46:00+10:00,2023-06-05,04:46,2,0,2
26,2023-06-05T04:46:00+10:00,2023-06-05,04:46,1,0,1
28,2023-06-05T04:46:00+10:00,2023-06-05,04:46,0,1,1
55,2023-06-05T04:46:00+10:00,2023-06-05,04:46,0,1,1
66,2023-06-05T04:46:00+10:00,2023-06-05,04:46,1,0,1
24,2023-06-05T04:46:00+10:00,2023-06-05,04:46,1,1,2
49,2023-06-05T04:46:00+10:00,2023-06-05,04:46,2,0,2
67,2023-06-05T04:46:00+10:00,2023-06-05,04:46,1,0,1
61,2023-06-05T04:46:00+10:00,2023-06-05,04:46,1,0,1
3,2023-06-05T04:45:00+10:00,2023-06-05,04:45,1,0,1
28,2023-06-05T04:45:00+10:00,2023-06-05,04:45,0,1,1
66,2023-06-05T04:45:00+10:00,2023-06-05,04:45,0,4,4
84,2023-06-05T04:45:00+10:00,2023-06-05,04:45,0,3,3
20,2023-06-05T04:45:00+10:00,2023-06-05,04:45,0,3,3
35,2023-06-05T04:45:00+10:00,2023-06-05,04:45,1,0,1
109,2023-06-05T04:45:00+10:00,2023-06-05,04:45,1,0,1
4,2023-06-05T04:45:00+10:00,2023-06-05,04:45,0,1,1
6,2023-06-05T04:45:00+10:00,2023-06-05,04:45,2,0,2
41,2023-06-05T04:45:00+10:00,2023-06-05,04:45,1,1,2
5,2023-06-05T04:45:00+10:00,2023-06-05,04:45,1,0,1
14,2023-06-05T04:45:00+10:00,2023-06-05,04:45,2,0,2
44,2023-06-05T04:45:00+10:00,2023-06-05,04:45,1,0,1
55,2023-06-05T04:45:00+10:00,2023-06-05,04:45,0,1,1
65,2023-06-05T04:45:00+10:00,2023-06-05,04:45,0,1,1
24,2023-06-05T04:45:00+10:00,2023-06-05,04:45,1,1,2
62,2023-06-05T04:45:00+10:00,2023-06-05,04:45,2,0,2
3,2023-06-05T04:44:00+10:00,2023-06-05,04:44,0,1,1
47,2023-06-05T04:44:00+10:00,2023-06-05,04:44,1,0,1
55,2023-06-05T04:44:00+10:00,2023-06-05,04:44,0,1,1
66,2023-06-05T04:44:00+10:00,2023-06-05,04:44,1,0,1
49,2023-06-05T04:44:00+10:00,2023-06-05,04:44,0,2,2
53,2023-06-05T04:44:00+10:00,2023-06-05,04:44,1,0,1
56,2023-06-05T04:44:00+10:00,2023-06-05,04:44,0,1,1
79,2023-06-05T04:44:00+10:00,2023-06-05,04:44,0,1,1
23,2023-06-05T04:44:00+10:00,2023-06-05,04:44,2,1,3
62,2023-06-05T04:44:00+10:00,2023-06-05,04:44,3,0,3
17,2023-06-05T04:43:00+10:00,2023-06-05,04:43,1,0,1
20,2023-06-05T04:43:00+10:00,2023-06-05,04:43,0,1,1
45,2023-06-05T04:43:00+10:00,2023-06-05,04:43,0,1,1
66,2023-06-05T04:43:00+10:00,2023-06-05,04:43,0,1,1
49,2023-06-05T04:43:00+10:00,2023-06-05,04:43,0,4,4
26,2023-06-05T04:43:00+10:00,2023-06-05,04:43,0,1,1
36,2023-06-05T04:43:00+10:00,2023-06-05,04:43,1,0,1
55,2023-06-05T04:43:00+10:00,2023-06-05,04:43,1,0,1
71,2023-06-05T04:43:00+10:00,2023-06-05,04:43,1,1,2
24,2023-06-05T04:43:00+10:00,2023-06-05,04:43,2,0,2
8,2023-06-05T04:42:00+10:00,2023-06-05,04:42,2,0,2
26,2023-06-05T04:42:00+10:00,2023-06-05,04:42,1,1,2
66,2023-06-05T04:42:00+10:00,2023-06-05,04:42,1,1,2
24,2023-06-05T04:42:00+10:00,2023-06-05,04:42,1,0,1
51,2023-06-05T04:42:00+10:00,2023-06-05,04:42,1,0,1
62,2023-06-05T04:42:00+10:00,2023-06-05,04:42,0,2,2
14,2023-06-05T04:42:00+10:00,2023-06-05,04:42,1,0,1
49,2023-06-05T04:42:00+10:00,2023-06-05,04:42,3,0,3
3,2023-06-05T04:41:00+10:00,2023-06-05,04:41,0,2,2
5,2023-06-05T04:41:00+10:00,2023-06-05,04:41,1,2,3
28,2023-06-05T04:41:00+10:00,2023-06-05,04:41,0,1,1
17,2023-06-05T04:41:00+10:00,2023-06-05,04:41,1,2,3
49,2023-06-05T04:41:00+10:00,2023-06-05,04:41,2,0,2
62,2023-06-05T04:41:00+10:00,2023-06-05,04:41,0,1,1
45,2023-06-05T04:41:00+10:00,2023-06-05,04:41,0,2,2
24,2023-06-05T04:41:00+10:00,2023-06-05,04:41,3,0,3
72,2023-06-05T04:41:00+10:00,2023-06-05,04:41,0,1,1
26,2023-06-05T04:40:00+10:00,2023-06-05,04:40,1,0,1
17,2023-06-05T04:40:00+10:00,2023-06-05,04:40,1,0,1
52,2023-06-05T04:40:00+10:00,2023-06-05,04:40,0,1,1
58,2023-06-05T04:40:00+10:00,2023-06-05,04:40,0,1,1
47,2023-06-05T04:40:00+10:00,2023-06-05,04:40,1,2,3
84,2023-06-05T04:40:00+10:00,2023-06-05,04:40,1,0,1
6,2023-06-05T04:40:00+10:00,2023-06-05,04:40,1,0,1
29,2023-06-05T04:40:00+10:00,2023-06-05,04:40,1,0,1
61,2023-06-05T04:40:00+10:00,2023-06-05,04:40,0,1,1
66,2023-06-05T04:40:00+10:00,2023-06-05,04:40,0,1,1
24,2023-06-05T04:40:00+10:00,2023-06-05,04:40,2,3,5
79,2023-06-05T04:40:00+10:00,2023-06-05,04:40,2,0,2
6,2023-06-05T04:39:00+10:00,2023-06-05,04:39,2,0,2
36,2023-06-05T04:39:00+10:00,2023-06-05,04:39,0,1,1
66,2023-06-05T04:39:00+10:00,2023-06-05,04:39,1,1,2
51,2023-06-05T04:39:00+10:00,2023-06-05,04:39,0,1,1
26,2023-06-05T04:39:00+10:00,2023-06-05,04:39,3,0,3
56,2023-06-05T04:39:00+10:00,2023-06-05,04:39,1,0,1
3,2023-06-05T04:39:00+10:00,2023-06-05,04:39,0,1,1
5,2023-06-05T04:39:00+10:00,2023-06-05,04:39,1,0,1
41,2023-06-05T04:39:00+10:00,2023-06-05,04:39,0,1,1
24,2023-06-05T04:39:00+10:00,2023-06-05,04:39,1,1,2
52,2023-06-05T04:39:00+10:00,2023-06-05,04:39,0,1,1
28,2023-06-05T04:38:00+10:00,2023-06-05,04:38,0,1,1
46,2023-06-05T04:38:00+10:00,2023-06-05,04:38,0,1,1
56,2023-06-05T04:38:00+10:00,2023-06-05,04:38,0,1,1
4,2023-06-05T04:38:00+10:00,2023-06-05,04:38,1,1,2
62,2023-06-05T04:38:00+10:00,2023-06-05,04:38,0,1,1
5,2023-06-05T04:38:00+10:00,2023-06-05,04:38,1,1,2
26,2023-06-05T04:38:00+10:00,2023-06-05,04:38,0,1,1
17,2023-06-05T04:38:00+10:00,2023-06-05,04:38,1,0,1
35,2023-06-05T04:38:00+10:00,2023-06-05,04:38,1,0,1
49,2023-06-05T04:38:00+10:00,2023-06-05,04:38,1,0,1
3,2023-06-05T04:37:00+10:00,2023-06-05,04:37,0,2,2
37,2023-06-05T04:37:00+10:00,2023-06-05,04:37,0,5,5
19,2023-06-05T04:37:00+10:00,2023-06-05,04:37,0,1,1
2,2023-06-05T04:37:00+10:00,2023-06-05,04:37,1,0,1
17,2023-06-05T04:37:00+10:00,2023-06-05,04:37,1,0,1
24,2023-06-05T04:37:00+10:00,2023-06-05,04:37,0,1,1
5,2023-06-05T04:37:00+10:00,2023-06-05,04:37,1,0,1
41,2023-06-05T04:37:00+10:00,2023-06-05,04:37,0,1,1
55,2023-06-05T04:37:00+10:00,2023-06-05,04:37,0,1,1
58,2023-06-05T04:37:00+10:00,2023-06-05,04:37,0,1,1
62,2023-06-05T04:37:00+10:00,2023-06-05,04:37,0,1,1
79,2023-06-05T04:37:00+10:00,2023-06-05,04:37,0,1,1
3,2023-06-05T04:36:00+10:00,2023-06-05,04:36,0,1,1
29,2023-06-05T04:36:00+10:00,2023-06-05,04:36,1,0,1
47,2023-06-05T04:36:00+10:00,2023-06-05,04:36,1,0,1
9,2023-06-05T04:36:00+10:00,2023-06-05,04:36,0,2,2
4,2023-06-05T04:36:00+10:00,2023-06-05,04:36,1,0,1
41,2023-06-05T04:36:00+10:00,2023-06-05,04:36,0,1,1
2,2023-06-05T04:36:00+10:00,2023-06-05,04:36,0,1,1
19,2023-06-05T04:36:00+10:00,2023-06-05,04:36,2,3,5
58,2023-06-05T04:36:00+10:00,2023-06-05,04:36,0,1,1
79,2023-06-05T04:36:00+10:00,2023-06-05,04:36,0,1,1
6,2023-06-05T04:36:00+10:00,2023-06-05,04:36,2,0,2
55,2023-06-05T04:36:00+10:00,2023-06-05,04:36,1,0,1
31,2023-06-05T04:35:00+10:00,2023-06-05,04:35,1,0,1
61,2023-06-05T04:35:00+10:00,2023-06-05,04:35,0,1,1
19,2023-06-05T04:35:00+10:00,2023-06-05,04:35,2,0,2
56,2023-06-05T04:35:00+10:00,2023-06-05,04:35,0,2,2
1,2023-06-05T04:35:00+10:00,2023-06-05,04:35,1,0,1
30,2023-06-05T04:35:00+10:00,2023-06-05,04:35,1,0,1
51,2023-06-05T04:35:00+10:00,2023-06-05,04:35,0,1,1
5,2023-06-05T04:35:00+10:00,2023-06-05,04:35,1,0,1
55,2023-06-05T04:35:00+10:00,2023-06-05,04:35,1,0,1
84,2023-06-05T04:35:00+10:00,2023-06-05,04:35,1,0,1
9,2023-06-05T04:35:00+10:00,2023-06-05,04:35,1,0,1
3,2023-06-05T04:34:00+10:00,2023-06-05,04:34,1,0,1
55,2023-06-05T04:34:00+10:00,2023-06-05,04:34,0,1,1
71,2023-06-05T04:34:00+10:00,2023-06-05,04:34,1,1,2
41,2023-06-05T04:34:00+10:00,2023-06-05,04:34,1,0,1
35,2023-06-05T04:34:00+10:00,2023-06-05,04:34,1,0,1
58,2023-06-05T04:34:00+10:00,2023-06-05,04:34,1,0,1
67,2023-06-05T04:34:00+10:00,2023-06-05,04:34,0,1,1
4,2023-06-05T04:34:00+10:00,2023-06-05,04:34,0,1,1
5,2023-06-05T04:34:00+10:00,2023-06-05,04:34,0,1,1
6,2023-06-05T04:34:00+10:00,2023-06-05,04:34,0,1,1
51,2023-06-05T04:34:00+10:00,2023-06-05,04:34,0,1,1
53,2023-06-05T04:34:00+10:00,2023-06-05,04:34,1,0,1
3,2023-06-05T04:33:00+10:00,2023-06-05,04:33,0,2,2
5,2023-06-05T04:33:00+10:00,2023-06-05,04:33,0,1,1
55,2023-06-05T04:33:00+10:00,2023-06-05,04:33,3,4,7
71,2023-06-05T04:33:00+10:00,2023-06-05,04:33,1,0,1
62,2023-06-05T04:33:00+10:00,2023-06-05,04:33,1,0,1
6,2023-06-05T04:33:00+10:00,2023-06-05,04:33,1,0,1
26,2023-06-05T04:33:00+10:00,2023-06-05,04:33,0,1,1
35,2023-06-05T04:33:00+10:00,2023-06-05,04:33,1,0,1
31,2023-06-05T04:33:00+10:00,2023-06-05,04:33,1,0,1
41,2023-06-05T04:33:00+10:00,2023-06-05,04:33,0,1,1
45,2023-06-05T04:33:00+10:00,2023-06-05,04:33,1,0,1
2,2023-06-05T04:33:00+10:00,2023-06-05,04:33,0,1,1
49,2023-06-05T04:33:00+10:00,2023-06-05,04:33,0,1,1
52,2023-06-05T04:33:00+10:00,2023-06-05,04:33,0,1,1
57,2023-06-05T04:33:00+10:00,2023-06-05,04:33,1,0,1
50,2023-06-05T04:32:00+10:00,2023-06-05,04:32,6,0,6
20,2023-06-05T04:32:00+10:00,2023-06-05,04:32,3,0,3
30,2023-06-05T04:32:00+10:00,2023-06-05,04:32,2,0,2
14,2023-06-05T04:32:00+10:00,2023-06-05,04:32,1,0,1
21,2023-06-05T04:32:00+10:00,2023-06-05,04:32,0,1,1
41,2023-06-05T04:32:00+10:00,2023-06-05,04:32,1,0,1
24,2023-06-05T04:32:00+10:00,2023-06-05,04:32,0,1,1
36,2023-06-05T04:32:00+10:00,2023-06-05,04:32,1,0,1
21,2023-06-05T04:31:00+10:00,2023-06-05,04:31,1,0,1
6,2023-06-05T04:31:00+10:00,2023-06-05,04:31,1,0,1
47,2023-06-05T04:31:00+10:00,2023-06-05,04:31,1,0,1
3,2023-06-05T04:31:00+10:00,2023-06-05,04:31,2,0,2
28,2023-06-05T04:31:00+10:00,2023-06-05,04:31,0,1,1
54,2023-06-05T04:31:00+10:00,2023-06-05,04:31,1,0,1
57,2023-06-05T04:31:00+10:00,2023-06-05,04:31,0,1,1
28,2023-06-05T04:30:00+10:00,2023-06-05,04:30,0,1,1
55,2023-06-05T04:30:00+10:00,2023-06-05,04:30,1,0,1
84,2023-06-05T04:30:00+10:00,2023-06-05,04:30,2,1,3
24,2023-06-05T04:30:00+10:00,2023-06-05,04:30,1,0,1
62,2023-06-05T04:30:00+10:00,2023-06-05,04:30,0,1,1
57,2023-06-05T04:30:00+10:00,2023-06-05,04:30,0,1,1
3,2023-06-05T04:30:00+10:00,2023-06-05,04:30,0,1,1
4,2023-06-05T04:30:00+10:00,2023-06-05,04:30,1,1,2
6,2023-06-05T04:30:00+10:00,2023-06-05,04:30,1,0,1
41,2023-06-05T04:30:00+10:00,2023-06-05,04:30,1,0,1
117,2023-06-05T04:30:00+10:00,2023-06-05,04:30,2,1,3
3,2023-06-05T04:29:00+10:00,2023-06-05,04:29,0,3,3
65,2023-06-05T04:29:00+10:00,2023-06-05,04:29,0,1,1
23,2023-06-05T04:29:00+10:00,2023-06-05,04:29,0,1,1
14,2023-06-05T04:29:00+10:00,2023-06-05,04:29,2,0,2
41,2023-06-05T04:29:00+10:00,2023-06-05,04:29,0,2,2
49,2023-06-05T04:29:00+10:00,2023-06-05,04:29,0,1,1
31,2023-06-05T04:29:00+10:00,2023-06-05,04:29,0,1,1
47,2023-06-05T04:29:00+10:00,2023-06-05,04:29,0,1,1
55,2023-06-05T04:29:00+10:00,2023-06-05,04:29,3,3,6
2,2023-06-05T04:29:00+10:00,2023-06-05,04:29,0,1,1
19,2023-06-05T04:29:00+10:00,2023-06-05,04:29,0,1,1
24,2023-06-05T04:29:00+10:00,2023-06-05,04:29,0,1,1
6,2023-06-05T04:28:00+10:00,2023-06-05,04:28,1,0,1
26,2023-06-05T04:28:00+10:00,2023-06-05,04:28,0,1,1
47,2023-06-05T04:28:00+10:00,2023-06-05,04:28,0,1,1
2,2023-06-05T04:28:00+10:00,2023-06-05,04:28,0,1,1
76,2023-06-05T04:28:00+10:00,2023-06-05,04:28,0,1,1
20,2023-06-05T04:28:00+10:00,2023-06-05,04:28,0,1,1
3,2023-06-05T04:28:00+10:00,2023-06-05,04:28,0,1,1
41,2023-06-05T04:28:00+10:00,2023-06-05,04:28,2,2,4
50,2023-06-05T04:28:00+10:00,2023-06-05,04:28,1,0,1
55,2023-06-05T04:28:00+10:00,2023-06-05,04:28,0,1,1
12,2023-06-05T04:28:00+10:00,2023-06-05,04:28,0,1,1
53,2023-06-05T04:28:00+10:00,2023-06-05,04:28,0,1,1
57,2023-06-05T04:28:00+10:00,2023-06-05,04:28,1,0,1
55,2023-06-05T04:27:00+10:00,2023-06-05,04:27,6,2,8
2,2023-06-05T04:27:00+10:00,2023-06-05,04:27,0,1,1
17,2023-06-05T04:27:00+10:00,2023-06-05,04:27,1,0,1
6,2023-06-05T04:27:00+10:00,2023-06-05,04:27,1,1,2
26,2023-06-05T04:27:00+10:00,2023-06-05,04:27,1,0,1
61,2023-06-05T04:27:00+10:00,2023-06-05,04:27,3,0,3
66,2023-06-05T04:27:00+10:00,2023-06-05,04:27,1,0,1
1,2023-06-05T04:27:00+10:00,2023-06-05,04:27,1,0,1
62,2023-06-05T04:27:00+10:00,2023-06-05,04:27,1,0,1
67,2023-06-05T04:27:00+10:00,2023-06-05,04:27,1,0,1
5,2023-06-05T04:27:00+10:00,2023-06-05,04:27,0,2,2
41,2023-06-05T04:27:00+10:00,2023-06-05,04:27,1,0,1
72,2023-06-05T04:27:00+10:00,2023-06-05,04:27,0,1,1
26,2023-06-05T04:26:00+10:00,2023-06-05,04:26,0,1,1
40,2023-06-05T04:26:00+10:00,2023-06-05,04:26,0,1,1
30,2023-06-05T04:26:00+10:00,2023-06-05,04:26,0,1,1
31,2023-06-05T04:26:00+10:00,2023-06-05,04:26,5,4,9
12,2023-06-05T04:26:00+10:00,2023-06-05,04:26,1,0,1
27,2023-06-05T04:26:00+10:00,2023-06-05,04:26,1,0,1
3,2023-06-05T04:26:00+10:00,2023-06-05,04:26,2,0,2
47,2023-06-05T04:26:00+10:00,2023-06-05,04:26,0,1,1
55,2023-06-05T04:26:00+10:00,2023-06-05,04:26,1,0,1
75,2023-06-05T04:26:00+10:00,2023-06-05,04:26,0,1,1
2,2023-06-05T04:26:00+10:00,2023-06-05,04:26,0,1,1
20,2023-06-05T04:26:00+10:00,2023-06-05,04:26,1,3,4
35,2023-06-05T04:26:00+10:00,2023-06-05,04:26,1,1,2
72,2023-06-05T04:26:00+10:00,2023-06-05,04:26,1,0,1
3,2023-06-05T04:25:00+10:00,2023-06-05,04:25,1,0,1
26,2023-06-05T04:25:00+10:00,2023-06-05,04:25,0,1,1
84,2023-06-05T04:25:00+10:00,2023-06-05,04:25,1,1,2
56,2023-06-05T04:25:00+10:00,2023-06-05,04:25,0,1,1
58,2023-06-05T04:25:00+10:00,2023-06-05,04:25,1,0,1
5,2023-06-05T04:25:00+10:00,2023-06-05,04:25,1,0,1
50,2023-06-05T04:25:00+10:00,2023-06-05,04:25,0,1,1
55,2023-06-05T04:25:00+10:00,2023-06-05,04:25,1,2,3
26,2023-06-05T04:24:00+10:00,2023-06-05,04:24,1,0,1
2,2023-06-05T04:24:00+10:00,2023-06-05,04:24,1,1,2
30,2023-06-05T04:24:00+10:00,2023-06-05,04:24,0,1,1
46,2023-06-05T04:24:00+10:00,2023-06-05,04:24,1,0,1
5,2023-06-05T04:24:00+10:00,2023-06-05,04:24,1,0,1
55,2023-06-05T04:24:00+10:00,2023-06-05,04:24,0,1,1
35,2023-06-05T04:24:00+10:00,2023-06-05,04:24,1,0,1
79,2023-06-05T04:24:00+10:00,2023-06-05,04:24,0,1,1
26,2023-06-05T04:23:00+10:00,2023-06-05,04:23,1,0,1
2,2023-06-05T04:23:00+10:00,2023-06-05,04:23,1,0,1
24,2023-06-05T04:23:00+10:00,2023-06-05,04:23,1,0,1
5,2023-06-05T04:23:00+10:00,2023-06-05,04:23,0,1,1
28,2023-06-05T04:23:00+10:00,2023-06-05,04:23,0,2,2
47,2023-06-05T04:23:00+10:00,2023-06-05,04:23,2,2,4
55,2023-06-05T04:23:00+10:00,2023-06-05,04:23,0,1,1
79,2023-06-05T04:23:00+10:00,2023-06-05,04:23,1,0,1
5,2023-06-05T04:22:00+10:00,2023-06-05,04:22,0,1,1
48,2023-06-05T04:22:00+10:00,2023-06-05,04:22,0,1,1
58,2023-06-05T04:22:00+10:00,2023-06-05,04:22,2,0,2
26,2023-06-05T04:22:00+10:00,2023-06-05,04:22,3,1,4
55,2023-06-05T04:22:00+10:00,2023-06-05,04:22,0,1,1
66,2023-06-05T04:22:00+10:00,2023-06-05,04:22,0,1,1
1,2023-06-05T04:22:00+10:00,2023-06-05,04:22,0,1,1
30,2023-06-05T04:22:00+10:00,2023-06-05,04:22,0,2,2
66,2023-06-05T04:21:00+10:00,2023-06-05,04:21,2,1,3
30,2023-06-05T04:21:00+10:00,2023-06-05,04:21,1,0,1
79,2023-06-05T04:21:00+10:00,2023-06-05,04:21,0,1,1
26,2023-06-05T04:21:00+10:00,2023-06-05,04:21,1,0,1
47,2023-06-05T04:21:00+10:00,2023-06-05,04:21,4,0,4
1,2023-06-05T04:21:00+10:00,2023-06-05,04:21,1,0,1
24,2023-06-05T04:21:00+10:00,2023-06-05,04:21,1,0,1
35,2023-06-05T04:21:00+10:00,2023-06-05,04:21,0,1,1
58,2023-06-05T04:21:00+10:00,2023-06-05,04:21,1,0,1
28,2023-06-05T04:21:00+10:00,2023-06-05,04:21,0,1,1
9,2023-06-05T04:21:00+10:00,2023-06-05,04:21,1,0,1
49,2023-06-05T04:21:00+10:00,2023-06-05,04:21,0,1,1
67,2023-06-05T04:21:00+10:00,2023-06-05,04:21,0,1,1
55,2023-06-05T04:20:00+10:00,2023-06-05,04:20,1,0,1
66,2023-06-05T04:20:00+10:00,2023-06-05,04:20,1,0,1
84,2023-06-05T04:20:00+10:00,2023-06-05,04:20,2,4,6
62,2023-06-05T04:20:00+10:00,2023-06-05,04:20,0,1,1
117,2023-06-05T04:20:00+10:00,2023-06-05,04:20,0,1,1
71,2023-06-05T04:20:00+10:00,2023-06-05,04:20,0,1,1
5,2023-06-05T04:20:00+10:00,2023-06-05,04:20,2,1,3
28,2023-06-05T04:20:00+10:00,2023-06-05,04:20,0,1,1
41,2023-06-05T04:20:00+10:00,2023-06-05,04:20,0,2,2
47,2023-06-05T04:20:00+10:00,2023-06-05,04:20,0,2,2
19,2023-06-05T04:20:00+10:00,2023-06-05,04:20,3,0,3
24,2023-06-05T04:20:00+10:00,2023-06-05,04:20,0,1,1
57,2023-06-05T04:20:00+10:00,2023-06-05,04:20,1,0,1
6,2023-06-05T04:19:00+10:00,2023-06-05,04:19,1,0,1
26,2023-06-05T04:19:00+10:00,2023-06-05,04:19,1,0,1
40,2023-06-05T04:19:00+10:00,2023-06-05,04:19,0,1,1
41,2023-06-05T04:19:00+10:00,2023-06-05,04:19,1,0,1
75,2023-06-05T04:19:00+10:00,2023-06-05,04:19,1,0,1
5,2023-06-05T04:19:00+10:00,2023-06-05,04:19,2,3,5
28,2023-06-05T04:19:00+10:00,2023-06-05,04:19,0,1,1
54,2023-06-05T04:19:00+10:00,2023-06-05,04:19,1,0,1
72,2023-06-05T04:19:00+10:00,2023-06-05,04:19,1,2,3
3,2023-06-05T04:19:00+10:00,2023-06-05,04:19,1,1,2
55,2023-06-05T04:19:00+10:00,2023-06-05,04:19,0,1,1
49,2023-06-05T04:19:00+10:00,2023-06-05,04:19,1,0,1
79,2023-06-05T04:19:00+10:00,2023-06-05,04:19,1,0,1
21,2023-06-05T04:18:00+10:00,2023-06-05,04:18,0,1,1
40,2023-06-05T04:18:00+10:00,2023-06-05,04:18,0,1,1
55,2023-06-05T04:18:00+10:00,2023-06-05,04:18,1,1,2
65,2023-06-05T04:18:00+10:00,2023-06-05,04:18,0,1,1
30,2023-06-05T04:18:00+10:00,2023-06-05,04:18,0,2,2
26,2023-06-05T04:18:00+10:00,2023-06-05,04:18,0,1,1
28,2023-06-05T04:18:00+10:00,2023-06-05,04:18,0,1,1
41,2023-06-05T04:18:00+10:00,2023-06-05,04:18,0,2,2
66,2023-06-05T04:18:00+10:00,2023-06-05,04:18,1,0,1
1,2023-06-05T04:18:00+10:00,2023-06-05,04:18,0,2,2
9,2023-06-05T04:18:00+10:00,2023-06-05,04:18,1,0,1
62,2023-06-05T04:18:00+10:00,2023-06-05,04:18,1,0,1
4,2023-06-05T04:17:00+10:00,2023-06-05,04:17,0,2,2
54,2023-06-05T04:17:00+10:00,2023-06-05,04:17,0,1,1
58,2023-06-05T04:17:00+10:00,2023-06-05,04:17,3,0,3
62,2023-06-05T04:17:00+10:00,2023-06-05,04:17,1,3,4
21,2023-06-05T04:17:00+10:00,2023-06-05,04:17,0,1,1
24,2023-06-05T04:17:00+10:00,2023-06-05,04:17,0,3,3
49,2023-06-05T04:17:00+10:00,2023-06-05,04:17,0,2,2
28,2023-06-05T04:17:00+10:00,2023-06-05,04:17,0,1,1
66,2023-06-05T04:17:00+10:00,2023-06-05,04:17,0,1,1
28,2023-06-05T04:16:00+10:00,2023-06-05,04:16,0,1,1
42,2023-06-05T04:16:00+10:00,2023-06-05,04:16,0,1,1
20,2023-06-05T04:16:00+10:00,2023-06-05,04:16,0,1,1
55,2023-06-05T04:16:00+10:00,2023-06-05,04:16,1,1,2
57,2023-06-05T04:16:00+10:00,2023-06-05,04:16,2,1,3
35,2023-06-05T04:16:00+10:00,2023-06-05,04:16,1,0,1
30,2023-06-05T04:15:00+10:00,2023-06-05,04:15,0,4,4
79,2023-06-05T04:15:00+10:00,2023-06-05,04:15,1,1,2
41,2023-06-05T04:15:00+10:00,2023-06-05,04:15,1,0,1
45,2023-06-05T04:15:00+10:00,2023-06-05,04:15,0,2,2
54,2023-06-05T04:15:00+10:00,2023-06-05,04:15,1,0,1
66,2023-06-05T04:15:00+10:00,2023-06-05,04:15,2,0,2
84,2023-06-05T04:15:00+10:00,2023-06-05,04:15,2,4,6
107,2023-06-05T04:15:00+10:00,2023-06-05,04:15,1,0,1
20,2023-06-05T04:15:00+10:00,2023-06-05,04:15,1,0,1
3,2023-06-05T04:14:00+10:00,2023-06-05,04:14,0,1,1
54,2023-06-05T04:14:00+10:00,2023-06-05,04:14,0,1,1
9,2023-06-05T04:14:00+10:00,2023-06-05,04:14,2,0,2
30,2023-06-05T04:14:00+10:00,2023-06-05,04:14,1,2,3
56,2023-06-05T04:14:00+10:00,2023-06-05,04:14,1,0,1
26,2023-06-05T04:14:00+10:00,2023-06-05,04:14,1,0,1
45,2023-06-05T04:14:00+10:00,2023-06-05,04:14,0,1,1
55,2023-06-05T04:14:00+10:00,2023-06-05,04:14,3,0,3
1,2023-06-05T04:14:00+10:00,2023-06-05,04:14,0,5,5
24,2023-06-05T04:14:00+10:00,2023-06-05,04:14,1,0,1
57,2023-06-05T04:14:00+10:00,2023-06-05,04:14,1,0,1
62,2023-06-05T04:14:00+10:00,2023-06-05,04:14,0,1,1
79,2023-06-05T04:14:00+10:00,2023-06-05,04:14,1,1,2
3,2023-06-05T04:13:00+10:00,2023-06-05,04:13,0,2,2
47,2023-06-05T04:13:00+10:00,2023-06-05,04:13,0,1,1
1,2023-06-05T04:13:00+10:00,2023-06-05,04:13,0,1,1
24,2023-06-05T04:13:00+10:00,2023-06-05,04:13,1,1,2
49,2023-06-05T04:13:00+10:00,2023-06-05,04:13,2,0,2
57,2023-06-05T04:13:00+10:00,2023-06-05,04:13,2,0,2
72,2023-06-05T04:13:00+10:00,2023-06-05,04:13,0,1,1
14,2023-06-05T04:13:00+10:00,2023-06-05,04:13,1,0,1
30,2023-06-05T04:13:00+10:00,2023-06-05,04:13,0,2,2
62,2023-06-05T04:13:00+10:00,2023-06-05,04:13,1,6,7
21,2023-06-05T04:12:00+10:00,2023-06-05,04:12,1,0,1
55,2023-06-05T04:12:00+10:00,2023-06-05,04:12,4,1,5
10,2023-06-05T04:12:00+10:00,2023-06-05,04:12,0,2,2
26,2023-06-05T04:12:00+10:00,2023-06-05,04:12,1,1,2
52,2023-06-05T04:12:00+10:00,2023-06-05,04:12,0,3,3
58,2023-06-05T04:12:00+10:00,2023-06-05,04:12,0,1,1
72,2023-06-05T04:12:00+10:00,2023-06-05,04:12,1,1,2
79,2023-06-05T04:12:00+10:00,2023-06-05,04:12,0,1,1
5,2023-06-05T04:12:00+10:00,2023-06-05,04:12,1,0,1
42,2023-06-05T04:12:00+10:00,2023-06-05,04:12,0,1,1
24,2023-06-05T04:12:00+10:00,2023-06-05,04:12,1,0,1
5,2023-06-05T04:11:00+10:00,2023-06-05,04:11,1,1,2
21,2023-06-05T04:11:00+10:00,2023-06-05,04:11,0,3,3
47,2023-06-05T04:11:00+10:00,2023-06-05,04:11,0,1,1
55,2023-06-05T04:11:00+10:00,2023-06-05,04:11,1,0,1
61,2023-06-05T04:11:00+10:00,2023-06-05,04:11,0,1,1
3,2023-06-05T04:11:00+10:00,2023-06-05,04:11,0,1,1
6,2023-06-05T04:11:00+10:00,2023-06-05,04:11,1,0,1
77,2023-06-05T04:11:00+10:00,2023-06-05,04:11,0,1,1
24,2023-06-05T04:11:00+10:00,2023-06-05,04:11,2,0,2
10,2023-06-05T04:10:00+10:00,2023-06-05,04:10,0,2,2
24,2023-06-05T04:10:00+10:00,2023-06-05,04:10,0,3,3
51,2023-06-05T04:10:00+10:00,2023-06-05,04:10,1,0,1
21,2023-06-05T04:10:00+10:00,2023-06-05,04:10,0,2,2
36,2023-06-05T04:10:00+10:00,2023-06-05,04:10,0,1,1
37,2023-06-05T04:10:00+10:00,2023-06-05,04:10,1,0,1
55,2023-06-05T04:10:00+10:00,2023-06-05,04:10,0,1,1
84,2023-06-05T04:10:00+10:00,2023-06-05,04:10,1,0,1
79,2023-06-05T04:10:00+10:00,2023-06-05,04:10,1,0,1
3,2023-06-05T04:10:00+10:00,2023-06-05,04:10,1,1,2
41,2023-06-05T04:10:00+10:00,2023-06-05,04:10,0,1,1
5,2023-06-05T04:09:00+10:00,2023-06-05,04:09,1,0,1
77,2023-06-05T04:09:00+10:00,2023-06-05,04:09,1,0,1
79,2023-06-05T04:09:00+10:00,2023-06-05,04:09,1,0,1
47,2023-06-05T04:09:00+10:00,2023-06-05,04:09,0,1,1
54,2023-06-05T04:09:00+10:00,2023-06-05,04:09,1,0,1
66,2023-06-05T04:09:00+10:00,2023-06-05,04:09,0,1,1
20,2023-06-05T04:09:00+10:00,2023-06-05,04:09,0,2,2
30,2023-06-05T04:09:00+10:00,2023-06-05,04:09,2,0,2
3,2023-06-05T04:08:00+10:00,2023-06-05,04:08,1,0,1
55,2023-06-05T04:08:00+10:00,2023-06-05,04:08,1,0,1
10,2023-06-05T04:08:00+10:00,2023-06-05,04:08,1,1,2
24,2023-06-05T04:08:00+10:00,2023-06-05,04:08,0,2,2
79,2023-06-05T04:08:00+10:00,2023-06-05,04:08,0,1,1
41,2023-06-05T04:08:00+10:00,2023-06-05,04:08,1,1,2
47,2023-06-05T04:08:00+10:00,2023-06-05,04:08,0,9,9
30,2023-06-05T04:08:00+10:00,2023-06-05,04:08,0,3,3
5,2023-06-05T04:08:00+10:00,2023-06-05,04:08,0,1,1
49,2023-06-05T04:08:00+10:00,2023-06-05,04:08,0,2,2
58,2023-06-05T04:08:00+10:00,2023-06-05,04:08,1,0,1
62,2023-06-05T04:08:00+10:00,2023-06-05,04:08,0,1,1
72,2023-06-05T04:08:00+10:00,2023-06-05,04:08,1,0,1
26,2023-06-05T04:07:00+10:00,2023-06-05,04:07,1,0,1
40,2023-06-05T04:07:00+10:00,2023-06-05,04:07,0,1,1
50,2023-06-05T04:07:00+10:00,2023-06-05,04:07,1,0,1
55,2023-06-05T04:07:00+10:00,2023-06-05,04:07,0,2,2
3,2023-06-05T04:07:00+10:00,2023-06-05,04:07,0,1,1
41,2023-06-05T04:07:00+10:00,2023-06-05,04:07,1,0,1
58,2023-06-05T04:07:00+10:00,2023-06-05,04:07,0,2,2
62,2023-06-05T04:07:00+10:00,2023-06-05,04:07,2,0,2
79,2023-06-05T04:07:00+10:00,2023-06-05,04:07,1,0,1
14,2023-06-05T04:06:00+10:00,2023-06-05,04:06,1,0,1
28,2023-06-05T04:06:00+10:00,2023-06-05,04:06,0,1,1
57,2023-06-05T04:06:00+10:00,2023-06-05,04:06,1,0,1
24,2023-06-05T04:06:00+10:00,2023-06-05,04:06,0,3,3
52,2023-06-05T04:06:00+10:00,2023-06-05,04:06,0,2,2
53,2023-06-05T04:06:00+10:00,2023-06-05,04:06,0,1,1
9,2023-06-05T04:06:00+10:00,2023-06-05,04:06,1,0,1
49,2023-06-05T04:06:00+10:00,2023-06-05,04:06,0,1,1
62,2023-06-05T04:06:00+10:00,2023-06-05,04:06,1,0,1
36,2023-06-05T04:05:00+10:00,2023-06-05,04:05,0,1,1
84,2023-06-05T04:05:00+10:00,2023-06-05,04:05,1,1,2
17,2023-06-05T04:05:00+10:00,2023-06-05,04:05,1,0,1
30,2023-06-05T04:05:00+10:00,2023-06-05,04:05,0,1,1
49,2023-06-05T04:05:00+10:00,2023-06-05,04:05,2,0,2
52,2023-06-05T04:05:00+10:00,2023-06-05,04:05,0,4,4
58,2023-06-05T04:05:00+10:00,2023-06-05,04:05,0,1,1
5,2023-06-05T04:05:00+10:00,2023-06-05,04:05,0,2,2
6,2023-06-05T04:05:00+10:00,2023-06-05,04:05,1,0,1
21,2023-06-05T04:05:00+10:00,2023-06-05,04:05,0,1,1
28,2023-06-05T04:05:00+10:00,2023-06-05,04:05,1,0,1
55,2023-06-05T04:05:00+10:00,2023-06-05,04:05,0,2,2
51,2023-06-05T04:04:00+10:00,2023-06-05,04:04,0,2,2
57,2023-06-05T04:04:00+10:00,2023-06-05,04:04,2,0,2
58,2023-06-05T04:04:00+10:00,2023-06-05,04:04,3,0,3
55,2023-06-05T04:04:00+10:00,2023-06-05,04:04,0,3,3
52,2023-06-05T04:04:00+10:00,2023-06-05,04:04,2,0,2
62,2023-06-05T04:04:00+10:00,2023-06-05,04:04,1,3,4
39,2023-06-05T04:04:00+10:00,2023-06-05,04:04,0,1,1
61,2023-06-05T04:04:00+10:00,2023-06-05,04:04,3,0,3
24,2023-06-05T04:04:00+10:00,2023-06-05,04:04,0,3,3
5,2023-06-05T04:03:00+10:00,2023-06-05,04:03,1,1,2
65,2023-06-05T04:03:00+10:00,2023-06-05,04:03,1,0,1
66,2023-06-05T04:03:00+10:00,2023-06-05,04:03,1,0,1
1,2023-06-05T04:03:00+10:00,2023-06-05,04:03,0,1,1
49,2023-06-05T04:03:00+10:00,2023-06-05,04:03,4,0,4
62,2023-06-05T04:03:00+10:00,2023-06-05,04:03,0,1,1
55,2023-06-05T04:03:00+10:00,2023-06-05,04:03,1,1,2
61,2023-06-05T04:03:00+10:00,2023-06-05,04:03,2,0,2
108,2023-06-05T04:03:00+10:00,2023-06-05,04:03,0,1,1
24,2023-06-05T04:03:00+10:00,2023-06-05,04:03,2,3,5
58,2023-06-05T04:03:00+10:00,2023-06-05,04:03,1,0,1
5,2023-06-05T04:02:00+10:00,2023-06-05,04:02,0,1,1
87,2023-06-05T04:02:00+10:00,2023-06-05,04:02,0,1,1
19,2023-06-05T04:02:00+10:00,2023-06-05,04:02,0,1,1
24,2023-06-05T04:02:00+10:00,2023-06-05,04:02,1,1,2
58,2023-06-05T04:02:00+10:00,2023-06-05,04:02,1,1,2
14,2023-06-05T04:02:00+10:00,2023-06-05,04:02,0,2,2
21,2023-06-05T04:02:00+10:00,2023-06-05,04:02,0,1,1
26,2023-06-05T04:02:00+10:00,2023-06-05,04:02,0,3,3
41,2023-06-05T04:02:00+10:00,2023-06-05,04:02,0,1,1
65,2023-06-05T04:02:00+10:00,2023-06-05,04:02,0,1,1
62,2023-06-05T04:02:00+10:00,2023-06-05,04:02,0,4,4
72,2023-06-05T04:02:00+10:00,2023-06-05,04:02,2,2,4
30,2023-06-05T04:02:00+10:00,2023-06-05,04:02,2,1,3
26,2023-06-05T04:01:00+10:00,2023-06-05,04:01,0,1,1
28,2023-06-05T04:01:00+10:00,2023-06-05,04:01,0,1,1
62,2023-06-05T04:01:00+10:00,2023-06-05,04:01,1,1,2
37,2023-06-05T04:01:00+10:00,2023-06-05,04:01,1,0,1
10,2023-06-05T04:01:00+10:00,2023-06-05,04:01,0,1,1
41,2023-06-05T04:01:00+10:00,2023-06-05,04:01,0,1,1
55,2023-06-05T04:01:00+10:00,2023-06-05,04:01,0,1,1
24,2023-06-05T04:01:00+10:00,2023-06-05,04:01,0,1,1
5,2023-06-05T04:00:00+10:00,2023-06-05,04:00,1,2,3
21,2023-06-05T04:00:00+10:00,2023-06-05,04:00,0,3,3
47,2023-06-05T04:00:00+10:00,2023-06-05,04:00,0,5,5
24,2023-06-05T04:00:00+10:00,2023-06-05,04:00,1,0,1
57,2023-06-05T04:00:00+10:00,2023-06-05,04:00,1,1,2
62,2023-06-05T04:00:00+10:00,2023-06-05,04:00,0,1,1
109,2023-06-05T04:00:00+10:00,2023-06-05,04:00,1,0,1
84,2023-06-05T04:00:00+10:00,2023-06-05,04:00,1,0,1
10,2023-06-05T04:00:00+10:00,2023-06-05,04:00,0,1,1
49,2023-06-05T04:00:00+10:00,2023-06-05,04:00,0,1,1
58,2023-06-05T04:00:00+10:00,2023-06-05,04:00,0,1,1
21,2023-06-05T03:59:00+10:00,2023-06-05,03:59,0,7,7
26,2023-06-05T03:59:00+10:00,2023-06-05,03:59,2,1,3
47,2023-06-05T03:59:00+10:00,2023-06-05,03:59,1,0,1
3,2023-06-05T03:59:00+10:00,2023-06-05,03:59,2,0,2
5,2023-06-05T03:59:00+10:00,2023-06-05,03:59,1,0,1
41,2023-06-05T03:59:00+10:00,2023-06-05,03:59,0,2,2
57,2023-06-05T03:59:00+10:00,2023-06-05,03:59,1,2,3
67,2023-06-05T03:59:00+10:00,2023-06-05,03:59,1,0,1
4,2023-06-05T03:59:00+10:00,2023-06-05,03:59,0,2,2
55,2023-06-05T03:59:00+10:00,2023-06-05,03:59,1,0,1
56,2023-06-05T03:59:00+10:00,2023-06-05,03:59,0,1,1
62,2023-06-05T03:59:00+10:00,2023-06-05,03:59,0,3,3
5,2023-06-05T03:58:00+10:00,2023-06-05,03:58,0,1,1
41,2023-06-05T03:58:00+10:00,2023-06-05,03:58,1,2,3
47,2023-06-05T03:58:00+10:00,2023-06-05,03:58,0,1,1
62,2023-06-05T03:58:00+10:00,2023-06-05,03:58,0,1,1
26,2023-06-05T03:58:00+10:00,2023-06-05,03:58,2,0,2
30,2023-06-05T03:58:00+10:00,2023-06-05,03:58,0,3,3
67,2023-06-05T03:58:00+10:00,2023-06-05,03:58,0,1,1
5,2023-06-05T03:57:00+10:00,2023-06-05,03:57,0,1,1
8,2023-06-05T03:57:00+10:00,2023-06-05,03:57,1,1,2
21,2023-06-05T03:57:00+10:00,2023-06-05,03:57,0,5,5
28,2023-06-05T03:57:00+10:00,2023-06-05,03:57,0,1,1
41,2023-06-05T03:57:00+10:00,2023-06-05,03:57,0,1,1
30,2023-06-05T03:57:00+10:00,2023-06-05,03:57,0,2,2
47,2023-06-05T03:57:00+10:00,2023-06-05,03:57,0,1,1
66,2023-06-05T03:57:00+10:00,2023-06-05,03:57,0,1,1
23,2023-06-05T03:57:00+10:00,2023-06-05,03:57,3,5,8
62,2023-06-05T03:57:00+10:00,2023-06-05,03:57,1,0,1
55,2023-06-05T03:57:00+10:00,2023-06-05,03:57,0,1,1
3,2023-06-05T03:56:00+10:00,2023-06-05,03:56,0,1,1
26,2023-06-05T03:56:00+10:00,2023-06-05,03:56,0,1,1
28,2023-06-05T03:56:00+10:00,2023-06-05,03:56,0,1,1
49,2023-06-05T03:56:00+10:00,2023-06-05,03:56,0,4,4
56,2023-06-05T03:56:00+10:00,2023-06-05,03:56,2,0,2
5,2023-06-05T03:56:00+10:00,2023-06-05,03:56,1,0,1
55,2023-06-05T03:56:00+10:00,2023-06-05,03:56,3,0,3
61,2023-06-05T03:56:00+10:00,2023-06-05,03:56,1,0,1
66,2023-06-05T03:56:00+10:00,2023-06-05,03:56,5,0,5
70,2023-06-05T03:56:00+10:00,2023-06-05,03:56,1,0,1
4,2023-06-05T03:56:00+10:00,2023-06-05,03:56,0,1,1
6,2023-06-05T03:56:00+10:00,2023-06-05,03:56,1,0,1
65,2023-06-05T03:56:00+10:00,2023-06-05,03:56,0,1,1
10,2023-06-05T03:56:00+10:00,2023-06-05,03:56,0,1,1
62,2023-06-05T03:56:00+10:00,2023-06-05,03:56,1,0,1
6,2023-06-05T03:55:00+10:00,2023-06-05,03:55,0,1,1
30,2023-06-05T03:55:00+10:00,2023-06-05,03:55,0,1,1
49,2023-06-05T03:55:00+10:00,2023-06-05,03:55,0,2,2
52,2023-06-05T03:55:00+10:00,2023-06-05,03:55,1,0,1
58,2023-06-05T03:55:00+10:00,2023-06-05,03:55,1,0,1
5,2023-06-05T03:55:00+10:00,2023-06-05,03:55,0,1,1
45,2023-06-05T03:55:00+10:00,2023-06-05,03:55,1,0,1
62,2023-06-05T03:55:00+10:00,2023-06-05,03:55,0,1,1
109,2023-06-05T03:55:00+10:00,2023-06-05,03:55,0,2,2
28,2023-06-05T03:55:00+10:00,2023-06-05,03:55,0,1,1
41,2023-06-05T03:55:00+10:00,2023-06-05,03:55,0,4,4
55,2023-06-05T03:55:00+10:00,2023-06-05,03:55,0,3,3
4,2023-06-05T03:54:00+10:00,2023-06-05,03:54,1,0,1
41,2023-06-05T03:54:00+10:00,2023-06-05,03:54,2,1,3
72,2023-06-05T03:54:00+10:00,2023-06-05,03:54,1,0,1
108,2023-06-05T03:54:00+10:00,2023-06-05,03:54,0,1,1
35,2023-06-05T03:54:00+10:00,2023-06-05,03:54,1,0,1
49,2023-06-05T03:54:00+10:00,2023-06-05,03:54,1,0,1
28,2023-06-05T03:54:00+10:00,2023-06-05,03:54,0,2,2
45,2023-06-05T03:54:00+10:00,2023-06-05,03:54,0,1,1
30,2023-06-05T03:54:00+10:00,2023-06-05,03:54,0,1,1
58,2023-06-05T03:54:00+10:00,2023-06-05,03:54,2,0,2
41,2023-06-05T03:53:00+10:00,2023-06-05,03:53,3,0,3
49,2023-06-05T03:53:00+10:00,2023-06-05,03:53,1,0,1
62,2023-06-05T03:53:00+10:00,2023-06-05,03:53,1,0,1
19,2023-06-05T03:53:00+10:00,2023-06-05,03:53,0,2,2
26,2023-06-05T03:52:00+10:00,2023-06-05,03:52,1,3,4
36,2023-06-05T03:52:00+10:00,2023-06-05,03:52,2,0,2
17,2023-06-05T03:52:00+10:00,2023-06-05,03:52,2,0,2
53,2023-06-05T03:52:00+10:00,2023-06-05,03:52,1,0,1
5,2023-06-05T03:52:00+10:00,2023-06-05,03:52,2,0,2
40,2023-06-05T03:52:00+10:00,2023-06-05,03:52,0,1,1
47,2023-06-05T03:52:00+10:00,2023-06-05,03:52,1,0,1
55,2023-06-05T03:52:00+10:00,2023-06-05,03:52,0,1,1
35,2023-06-05T03:52:00+10:00,2023-06-05,03:52,1,1,2
28,2023-06-05T03:52:00+10:00,2023-06-05,03:52,0,1,1
41,2023-06-05T03:52:00+10:00,2023-06-05,03:52,0,3,3
79,2023-06-05T03:52:00+10:00,2023-06-05,03:52,0,1,1
4,2023-06-05T03:51:00+10:00,2023-06-05,03:51,0,1,1
41,2023-06-05T03:51:00+10:00,2023-06-05,03:51,2,1,3
24,2023-06-05T03:51:00+10:00,2023-06-05,03:51,0,1,1
30,2023-06-05T03:51:00+10:00,2023-06-05,03:51,0,4,4
79,2023-06-05T03:51:00+10:00,2023-06-05,03:51,1,0,1
3,2023-06-05T03:51:00+10:00,2023-06-05,03:51,3,0,3
5,2023-06-05T03:51:00+10:00,2023-06-05,03:51,2,1,3
55,2023-06-05T03:51:00+10:00,2023-06-05,03:51,0,1,1
52,2023-06-05T03:51:00+10:00,2023-06-05,03:51,1,0,1
56,2023-06-05T03:51:00+10:00,2023-06-05,03:51,0,1,1
62,2023-06-05T03:51:00+10:00,2023-06-05,03:51,0,1,1
19,2023-06-05T03:50:00+10:00,2023-06-05,03:50,2,0,2
30,2023-06-05T03:50:00+10:00,2023-06-05,03:50,1,0,1
58,2023-06-05T03:50:00+10:00,2023-06-05,03:50,2,2,4
79,2023-06-05T03:50:00+10:00,2023-06-05,03:50,1,0,1
41,2023-06-05T03:50:00+10:00,2023-06-05,03:50,0,1,1
20,2023-06-05T03:50:00+10:00,2023-06-05,03:50,1,0,1
52,2023-06-05T03:50:00+10:00,2023-06-05,03:50,1,0,1
62,2023-06-05T03:50:00+10:00,2023-06-05,03:50,1,1,2
84,2023-06-05T03:50:00+10:00,2023-06-05,03:50,1,0,1
53,2023-06-05T03:50:00+10:00,2023-06-05,03:50,0,1,1
3,2023-06-05T03:49:00+10:00,2023-06-05,03:49,0,1,1
21,2023-06-05T03:49:00+10:00,2023-06-05,03:49,1,0,1
23,2023-06-05T03:49:00+10:00,2023-06-05,03:49,1,0,1
50,2023-06-05T03:49:00+10:00,2023-06-05,03:49,0,1,1
53,2023-06-05T03:49:00+10:00,2023-06-05,03:49,0,1,1
4,2023-06-05T03:49:00+10:00,2023-06-05,03:49,0,2,2
47,2023-06-05T03:49:00+10:00,2023-06-05,03:49,1,1,2
58,2023-06-05T03:49:00+10:00,2023-06-05,03:49,2,0,2
21,2023-06-05T03:48:00+10:00,2023-06-05,03:48,2,2,4
45,2023-06-05T03:48:00+10:00,2023-06-05,03:48,0,1,1
55,2023-06-05T03:48:00+10:00,2023-06-05,03:48,2,1,3
52,2023-06-05T03:48:00+10:00,2023-06-05,03:48,0,1,1
79,2023-06-05T03:48:00+10:00,2023-06-05,03:48,0,1,1
36,2023-06-05T03:48:00+10:00,2023-06-05,03:48,1,0,1
24,2023-06-05T03:48:00+10:00,2023-06-05,03:48,3,0,3
31,2023-06-05T03:48:00+10:00,2023-06-05,03:48,1,0,1
58,2023-06-05T03:48:00+10:00,2023-06-05,03:48,1,1,2
5,2023-06-05T03:47:00+10:00,2023-06-05,03:47,0,3,3
28,2023-06-05T03:47:00+10:00,2023-06-05,03:47,0,1,1
54,2023-06-05T03:47:00+10:00,2023-06-05,03:47,2,0,2
12,2023-06-05T03:47:00+10:00,2023-06-05,03:47,0,1,1
6,2023-06-05T03:47:00+10:00,2023-06-05,03:47,1,1,2
52,2023-06-05T03:47:00+10:00,2023-06-05,03:47,1,0,1
14,2023-06-05T03:46:00+10:00,2023-06-05,03:46,0,2,2
52,2023-06-05T03:46:00+10:00,2023-06-05,03:46,0,1,1
62,2023-06-05T03:46:00+10:00,2023-06-05,03:46,0,2,2
6,2023-06-05T03:46:00+10:00,2023-06-05,03:46,1,0,1
26,2023-06-05T03:46:00+10:00,2023-06-05,03:46,0,1,1
47,2023-06-05T03:46:00+10:00,2023-06-05,03:46,0,1,1
72,2023-06-05T03:46:00+10:00,2023-06-05,03:46,0,1,1
21,2023-06-05T03:46:00+10:00,2023-06-05,03:46,1,1,2
31,2023-06-05T03:46:00+10:00,2023-06-05,03:46,0,1,1
45,2023-06-05T03:46:00+10:00,2023-06-05,03:46,0,1,1
19,2023-06-05T03:46:00+10:00,2023-06-05,03:46,2,0,2
84,2023-06-05T03:45:00+10:00,2023-06-05,03:45,1,1,2
108,2023-06-05T03:45:00+10:00,2023-06-05,03:45,0,1,1
62,2023-06-05T03:45:00+10:00,2023-06-05,03:45,1,2,3
109,2023-06-05T03:45:00+10:00,2023-06-05,03:45,1,0,1
78,2023-06-05T03:45:00+10:00,2023-06-05,03:45,1,0,1
49,2023-06-05T03:45:00+10:00,2023-06-05,03:45,0,2,2
3,2023-06-05T03:45:00+10:00,2023-06-05,03:45,0,2,2
36,2023-06-05T03:45:00+10:00,2023-06-05,03:45,2,0,2
41,2023-06-05T03:45:00+10:00,2023-06-05,03:45,0,2,2
71,2023-06-05T03:45:00+10:00,2023-06-05,03:45,0,1,1
3,2023-06-05T03:44:00+10:00,2023-06-05,03:44,0,3,3
5,2023-06-05T03:44:00+10:00,2023-06-05,03:44,1,0,1
40,2023-06-05T03:44:00+10:00,2023-06-05,03:44,0,1,1
2,2023-06-05T03:44:00+10:00,2023-06-05,03:44,1,0,1
19,2023-06-05T03:44:00+10:00,2023-06-05,03:44,3,2,5
62,2023-06-05T03:44:00+10:00,2023-06-05,03:44,1,0,1
108,2023-06-05T03:44:00+10:00,2023-06-05,03:44,0,1,1
67,2023-06-05T03:44:00+10:00,2023-06-05,03:44,1,0,1
14,2023-06-05T03:44:00+10:00,2023-06-05,03:44,1,0,1
28,2023-06-05T03:44:00+10:00,2023-06-05,03:44,0,1,1
55,2023-06-05T03:44:00+10:00,2023-06-05,03:44,2,1,3
35,2023-06-05T03:44:00+10:00,2023-06-05,03:44,1,0,1
6,2023-06-05T03:43:00+10:00,2023-06-05,03:43,3,1,4
5,2023-06-05T03:43:00+10:00,2023-06-05,03:43,1,0,1
55,2023-06-05T03:43:00+10:00,2023-06-05,03:43,1,0,1
71,2023-06-05T03:43:00+10:00,2023-06-05,03:43,0,2,2
49,2023-06-05T03:43:00+10:00,2023-06-05,03:43,2,0,2
21,2023-06-05T03:43:00+10:00,2023-06-05,03:43,0,2,2
26,2023-06-05T03:43:00+10:00,2023-06-05,03:43,0,3,3
58,2023-06-05T03:43:00+10:00,2023-06-05,03:43,1,0,1
62,2023-06-05T03:43:00+10:00,2023-06-05,03:43,0,1,1
5,2023-06-05T03:42:00+10:00,2023-06-05,03:42,0,2,2
3,2023-06-05T03:42:00+10:00,2023-06-05,03:42,0,3,3
6,2023-06-05T03:42:00+10:00,2023-06-05,03:42,1,1,2
61,2023-06-05T03:42:00+10:00,2023-06-05,03:42,1,0,1
35,2023-06-05T03:42:00+10:00,2023-06-05,03:42,0,1,1
21,2023-06-05T03:42:00+10:00,2023-06-05,03:42,1,1,2
3,2023-06-05T03:41:00+10:00,2023-06-05,03:41,0,1,1
28,2023-06-05T03:41:00+10:00,2023-06-05,03:41,0,1,1
55,2023-06-05T03:41:00+10:00,2023-06-05,03:41,2,0,2
66,2023-06-05T03:41:00+10:00,2023-06-05,03:41,4,0,4
20,2023-06-05T03:41:00+10:00,2023-06-05,03:41,1,0,1
35,2023-06-05T03:41:00+10:00,2023-06-05,03:41,0,1,1
6,2023-06-05T03:41:00+10:00,2023-06-05,03:41,0,1,1
21,2023-06-05T03:41:00+10:00,2023-06-05,03:41,0,1,1
79,2023-06-05T03:41:00+10:00,2023-06-05,03:41,1,0,1
71,2023-06-05T03:41:00+10:00,2023-06-05,03:41,1,0,1
49,2023-06-05T03:41:00+10:00,2023-06-05,03:41,0,1,1
3,2023-06-05T03:40:00+10:00,2023-06-05,03:40,1,0,1
71,2023-06-05T03:40:00+10:00,2023-06-05,03:40,1,1,2
30,2023-06-05T03:40:00+10:00,2023-06-05,03:40,0,2,2
62,2023-06-05T03:40:00+10:00,2023-06-05,03:40,1,0,1
109,2023-06-05T03:40:00+10:00,2023-06-05,03:40,0,2,2
28,2023-06-05T03:40:00+10:00,2023-06-05,03:40,0,1,1
55,2023-06-05T03:40:00+10:00,2023-06-05,03:40,0,2,2
17,2023-06-05T03:40:00+10:00,2023-06-05,03:40,1,0,1
84,2023-06-05T03:40:00+10:00,2023-06-05,03:40,2,5,7
1,2023-06-05T03:40:00+10:00,2023-06-05,03:40,0,1,1
79,2023-06-05T03:40:00+10:00,2023-06-05,03:40,0,2,2
3,2023-06-05T03:39:00+10:00,2023-06-05,03:39,4,0,4
5,2023-06-05T03:39:00+10:00,2023-06-05,03:39,0,1,1
17,2023-06-05T03:39:00+10:00,2023-06-05,03:39,1,1,2
27,2023-06-05T03:39:00+10:00,2023-06-05,03:39,0,2,2
62,2023-06-05T03:39:00+10:00,2023-06-05,03:39,2,1,3
6,2023-06-05T03:39:00+10:00,2023-06-05,03:39,0,2,2
14,2023-06-05T03:39:00+10:00,2023-06-05,03:39,1,1,2
21,2023-06-05T03:39:00+10:00,2023-06-05,03:39,0,3,3
36,2023-06-05T03:39:00+10:00,2023-06-05,03:39,1,0,1
61,2023-06-05T03:39:00+10:00,2023-06-05,03:39,1,0,1
48,2023-06-05T03:39:00+10:00,2023-06-05,03:39,1,0,1
58,2023-06-05T03:39:00+10:00,2023-06-05,03:39,0,1,1
4,2023-06-05T03:39:00+10:00,2023-06-05,03:39,1,0,1
47,2023-06-05T03:39:00+10:00,2023-06-05,03:39,0,1,1
55,2023-06-05T03:39:00+10:00,2023-06-05,03:39,0,1,1
30,2023-06-05T03:39:00+10:00,2023-06-05,03:39,0,1,1
5,2023-06-05T03:38:00+10:00,2023-06-05,03:38,1,1,2
42,2023-06-05T03:38:00+10:00,2023-06-05,03:38,2,0,2
49,2023-06-05T03:38:00+10:00,2023-06-05,03:38,0,2,2
3,2023-06-05T03:38:00+10:00,2023-06-05,03:38,1,0,1
55,2023-06-05T03:38:00+10:00,2023-06-05,03:38,0,2,2
27,2023-06-05T03:38:00+10:00,2023-06-05,03:38,1,0,1
48,2023-06-05T03:38:00+10:00,2023-06-05,03:38,0,2,2
79,2023-06-05T03:38:00+10:00,2023-06-05,03:38,1,0,1
3,2023-06-05T03:37:00+10:00,2023-06-05,03:37,2,1,3
26,2023-06-05T03:37:00+10:00,2023-06-05,03:37,0,1,1
54,2023-06-05T03:37:00+10:00,2023-06-05,03:37,0,1,1
77,2023-06-05T03:37:00+10:00,2023-06-05,03:37,0,1,1
62,2023-06-05T03:37:00+10:00,2023-06-05,03:37,1,2,3
79,2023-06-05T03:37:00+10:00,2023-06-05,03:37,0,1,1
36,2023-06-05T03:37:00+10:00,2023-06-05,03:37,3,0,3
5,2023-06-05T03:37:00+10:00,2023-06-05,03:37,1,0,1
41,2023-06-05T03:37:00+10:00,2023-06-05,03:37,0,2,2
30,2023-06-05T03:37:00+10:00,2023-06-05,03:37,0,1,1
35,2023-06-05T03:37:00+10:00,2023-06-05,03:37,0,1,1
5,2023-06-05T03:36:00+10:00,2023-06-05,03:36,1,0,1
41,2023-06-05T03:36:00+10:00,2023-06-05,03:36,0,1,1
3,2023-06-05T03:36:00+10:00,2023-06-05,03:36,2,0,2
6,2023-06-05T03:36:00+10:00,2023-06-05,03:36,0,1,1
26,2023-06-05T03:36:00+10:00,2023-06-05,03:36,0,1,1
9,2023-06-05T03:36:00+10:00,2023-06-05,03:36,0,2,2
35,2023-06-05T03:36:00+10:00,2023-06-05,03:36,0,1,1
72,2023-06-05T03:36:00+10:00,2023-06-05,03:36,2,1,3
19,2023-06-05T03:36:00+10:00,2023-06-05,03:36,1,1,2
24,2023-06-05T03:36:00+10:00,2023-06-05,03:36,0,1,1
30,2023-06-05T03:36:00+10:00,2023-06-05,03:36,0,2,2
5,2023-06-05T03:35:00+10:00,2023-06-05,03:35,1,1,2
19,2023-06-05T03:35:00+10:00,2023-06-05,03:35,3,0,3
30,2023-06-05T03:35:00+10:00,2023-06-05,03:35,0,4,4
48,2023-06-05T03:35:00+10:00,2023-06-05,03:35,0,1,1
49,2023-06-05T03:35:00+10:00,2023-06-05,03:35,1,1,2
62,2023-06-05T03:35:00+10:00,2023-06-05,03:35,0,3,3
12,2023-06-05T03:35:00+10:00,2023-06-05,03:35,0,2,2
4,2023-06-05T03:35:00+10:00,2023-06-05,03:35,0,3,3
54,2023-06-05T03:35:00+10:00,2023-06-05,03:35,0,3,3
84,2023-06-05T03:35:00+10:00,2023-06-05,03:35,2,2,4
58,2023-06-05T03:35:00+10:00,2023-06-05,03:35,1,0,1
3,2023-06-05T03:34:00+10:00,2023-06-05,03:34,0,2,2
6,2023-06-05T03:34:00+10:00,2023-06-05,03:34,1,0,1
41,2023-06-05T03:34:00+10:00,2023-06-05,03:34,1,0,1
55,2023-06-05T03:34:00+10:00,2023-06-05,03:34,1,1,2
30,2023-06-05T03:34:00+10:00,2023-06-05,03:34,6,1,7
49,2023-06-05T03:34:00+10:00,2023-06-05,03:34,1,0,1
79,2023-06-05T03:34:00+10:00,2023-06-05,03:34,0,1,1
4,2023-06-05T03:34:00+10:00,2023-06-05,03:34,1,3,4
66,2023-06-05T03:34:00+10:00,2023-06-05,03:34,0,1,1
9,2023-06-05T03:34:00+10:00,2023-06-05,03:34,1,0,1
55,2023-06-05T03:33:00+10:00,2023-06-05,03:33,2,0,2
61,2023-06-05T03:33:00+10:00,2023-06-05,03:33,1,0,1
5,2023-06-05T03:33:00+10:00,2023-06-05,03:33,0,1,1
23,2023-06-05T03:33:00+10:00,2023-06-05,03:33,0,2,2
26,2023-06-05T03:33:00+10:00,2023-06-05,03:33,2,0,2
24,2023-06-05T03:33:00+10:00,2023-06-05,03:33,0,1,1
30,2023-06-05T03:33:00+10:00,2023-06-05,03:33,0,1,1
62,2023-06-05T03:33:00+10:00,2023-06-05,03:33,1,2,3
4,2023-06-05T03:32:00+10:00,2023-06-05,03:32,0,1,1
55,2023-06-05T03:32:00+10:00,2023-06-05,03:32,2,0,2
24,2023-06-05T03:32:00+10:00,2023-06-05,03:32,1,0,1
5,2023-06-05T03:32:00+10:00,2023-06-05,03:32,0,1,1
26,2023-06-05T03:32:00+10:00,2023-06-05,03:32,1,0,1
28,2023-06-05T03:32:00+10:00,2023-06-05,03:32,0,1,1
61,2023-06-05T03:32:00+10:00,2023-06-05,03:32,1,0,1
2,2023-06-05T03:32:00+10:00,2023-06-05,03:32,0,1,1
17,2023-06-05T03:32:00+10:00,2023-06-05,03:32,0,1,1
51,2023-06-05T03:32:00+10:00,2023-06-05,03:32,0,1,1
3,2023-06-05T03:32:00+10:00,2023-06-05,03:32,0,3,3
21,2023-06-05T03:32:00+10:00,2023-06-05,03:32,1,0,1
47,2023-06-05T03:32:00+10:00,2023-06-05,03:32,1,0,1
78,2023-06-05T03:32:00+10:00,2023-06-05,03:32,0,1,1
23,2023-06-05T03:32:00+10:00,2023-06-05,03:32,1,1,2
55,2023-06-05T03:31:00+10:00,2023-06-05,03:31,2,2,4
23,2023-06-05T03:31:00+10:00,2023-06-05,03:31,0,2,2
24,2023-06-05T03:31:00+10:00,2023-06-05,03:31,1,0,1
52,2023-06-05T03:31:00+10:00,2023-06-05,03:31,0,1,1
5,2023-06-05T03:31:00+10:00,2023-06-05,03:31,0,1,1
21,2023-06-05T03:31:00+10:00,2023-06-05,03:31,2,1,3
28,2023-06-05T03:31:00+10:00,2023-06-05,03:31,2,0,2
49,2023-06-05T03:31:00+10:00,2023-06-05,03:31,0,2,2
47,2023-06-05T03:30:00+10:00,2023-06-05,03:30,3,0,3
84,2023-06-05T03:30:00+10:00,2023-06-05,03:30,1,2,3
24,2023-06-05T03:30:00+10:00,2023-06-05,03:30,1,0,1
79,2023-06-05T03:30:00+10:00,2023-06-05,03:30,0,1,1
26,2023-06-05T03:30:00+10:00,2023-06-05,03:30,1,1,2
28,2023-06-05T03:30:00+10:00,2023-06-05,03:30,0,1,1
55,2023-06-05T03:30:00+10:00,2023-06-05,03:30,1,0,1
108,2023-06-05T03:30:00+10:00,2023-06-05,03:30,1,0,1
20,2023-06-05T03:30:00+10:00,2023-06-05,03:30,2,0,2
52,2023-06-05T03:30:00+10:00,2023-06-05,03:30,0,1,1
117,2023-06-05T03:30:00+10:00,2023-06-05,03:30,0,2,2
30,2023-06-05T03:29:00+10:00,2023-06-05,03:29,0,2,2
56,2023-06-05T03:29:00+10:00,2023-06-05,03:29,2,0,2
62,2023-06-05T03:29:00+10:00,2023-06-05,03:29,0,1,1
47,2023-06-05T03:29:00+10:00,2023-06-05,03:29,0,1,1
55,2023-06-05T03:29:00+10:00,2023-06-05,03:29,1,1,2
79,2023-06-05T03:29:00+10:00,2023-06-05,03:29,0,1,1
4,2023-06-05T03:29:00+10:00,2023-06-05,03:29,1,0,1
6,2023-06-05T03:29:00+10:00,2023-06-05,03:29,1,0,1
17,2023-06-05T03:29:00+10:00,2023-06-05,03:29,1,0,1
5,2023-06-05T03:28:00+10:00,2023-06-05,03:28,0,1,1
62,2023-06-05T03:28:00+10:00,2023-06-05,03:28,2,0,2
28,2023-06-05T03:28:00+10:00,2023-06-05,03:28,0,1,1
47,2023-06-05T03:28:00+10:00,2023-06-05,03:28,1,2,3
30,2023-06-05T03:28:00+10:00,2023-06-05,03:28,0,4,4
51,2023-06-05T03:28:00+10:00,2023-06-05,03:28,1,0,1
5,2023-06-05T03:27:00+10:00,2023-06-05,03:27,1,0,1
47,2023-06-05T03:27:00+10:00,2023-06-05,03:27,2,0,2
61,2023-06-05T03:27:00+10:00,2023-06-05,03:27,2,0,2
24,2023-06-05T03:27:00+10:00,2023-06-05,03:27,0,1,1
58,2023-06-05T03:27:00+10:00,2023-06-05,03:27,1,0,1
62,2023-06-05T03:27:00+10:00,2023-06-05,03:27,0,5,5
3,2023-06-05T03:27:00+10:00,2023-06-05,03:27,1,0,1
55,2023-06-05T03:27:00+10:00,2023-06-05,03:27,2,2,4
30,2023-06-05T03:27:00+10:00,2023-06-05,03:27,0,4,4
6,2023-06-05T03:27:00+10:00,2023-06-05,03:27,2,1,3
3,2023-06-05T03:26:00+10:00,2023-06-05,03:26,2,0,2
5,2023-06-05T03:26:00+10:00,2023-06-05,03:26,0,2,2
21,2023-06-05T03:26:00+10:00,2023-06-05,03:26,0,1,1
47,2023-06-05T03:26:00+10:00,2023-06-05,03:26,0,2,2
24,2023-06-05T03:26:00+10:00,2023-06-05,03:26,0,1,1
69,2023-06-05T03:26:00+10:00,2023-06-05,03:26,1,0,1
67,2023-06-05T03:26:00+10:00,2023-06-05,03:26,0,1,1
41,2023-06-05T03:26:00+10:00,2023-06-05,03:26,2,0,2
17,2023-06-05T03:26:00+10:00,2023-06-05,03:26,0,1,1
48,2023-06-05T03:26:00+10:00,2023-06-05,03:26,2,0,2
62,2023-06-05T03:26:00+10:00,2023-06-05,03:26,1,0,1
79,2023-06-05T03:26:00+10:00,2023-06-05,03:26,1,0,1
5,2023-06-05T03:25:00+10:00,2023-06-05,03:25,1,1,2
6,2023-06-05T03:25:00+10:00,2023-06-05,03:25,0,1,1
28,2023-06-05T03:25:00+10:00,2023-06-05,03:25,0,1,1
41,2023-06-05T03:25:00+10:00,2023-06-05,03:25,2,0,2
54,2023-06-05T03:25:00+10:00,2023-06-05,03:25,1,0,1
61,2023-06-05T03:25:00+10:00,2023-06-05,03:25,1,0,1
79,2023-06-05T03:25:00+10:00,2023-06-05,03:25,0,1,1
3,2023-06-05T03:25:00+10:00,2023-06-05,03:25,1,0,1
23,2023-06-05T03:25:00+10:00,2023-06-05,03:25,0,2,2
30,2023-06-05T03:25:00+10:00,2023-06-05,03:25,0,1,1
53,2023-06-05T03:25:00+10:00,2023-06-05,03:25,0,2,2
109,2023-06-05T03:25:00+10:00,2023-06-05,03:25,2,0,2
55,2023-06-05T03:25:00+10:00,2023-06-05,03:25,2,3,5
66,2023-06-05T03:25:00+10:00,2023-06-05,03:25,1,0,1
84,2023-06-05T03:25:00+10:00,2023-06-05,03:25,4,2,6
27,2023-06-05T03:25:00+10:00,2023-06-05,03:25,1,0,1
42,2023-06-05T03:24:00+10:00,2023-06-05,03:24,1,0,1
61,2023-06-05T03:24:00+10:00,2023-06-05,03:24,0,1,1
52,2023-06-05T03:24:00+10:00,2023-06-05,03:24,1,0,1
72,2023-06-05T03:24:00+10:00,2023-06-05,03:24,1,1,2
79,2023-06-05T03:24:00+10:00,2023-06-05,03:24,1,1,2
28,2023-06-05T03:24:00+10:00,2023-06-05,03:24,0,1,1
45,2023-06-05T03:24:00+10:00,2023-06-05,03:24,0,1,1
3,2023-06-05T03:24:00+10:00,2023-06-05,03:24,0,5,5
26,2023-06-05T03:24:00+10:00,2023-06-05,03:24,2,0,2
62,2023-06-05T03:24:00+10:00,2023-06-05,03:24,0,1,1
5,2023-06-05T03:23:00+10:00,2023-06-05,03:23,1,0,1
55,2023-06-05T03:23:00+10:00,2023-06-05,03:23,6,0,6
23,2023-06-05T03:23:00+10:00,2023-06-05,03:23,1,0,1
62,2023-06-05T03:23:00+10:00,2023-06-05,03:23,1,0,1
72,2023-06-05T03:23:00+10:00,2023-06-05,03:23,0,1,1
3,2023-06-05T03:23:00+10:00,2023-06-05,03:23,3,1,4
45,2023-06-05T03:23:00+10:00,2023-06-05,03:23,2,0,2
1,2023-06-05T03:23:00+10:00,2023-06-05,03:23,0,2,2
12,2023-06-05T03:23:00+10:00,2023-06-05,03:23,2,0,2
19,2023-06-05T03:23:00+10:00,2023-06-05,03:23,0,1,1
35,2023-06-05T03:23:00+10:00,2023-06-05,03:23,2,1,3
28,2023-06-05T03:22:00+10:00,2023-06-05,03:22,0,2,2
54,2023-06-05T03:22:00+10:00,2023-06-05,03:22,0,1,1
66,2023-06-05T03:22:00+10:00,2023-06-05,03:22,1,0,1
1,2023-06-05T03:22:00+10:00,2023-06-05,03:22,0,2,2
30,2023-06-05T03:22:00+10:00,2023-06-05,03:22,2,0,2
62,2023-06-05T03:22:00+10:00,2023-06-05,03:22,0,2,2
3,2023-06-05T03:22:00+10:00,2023-06-05,03:22,0,1,1
36,2023-06-05T03:22:00+10:00,2023-06-05,03:22,3,0,3
41,2023-06-05T03:22:00+10:00,2023-06-05,03:22,0,1,1
47,2023-06-05T03:22:00+10:00,2023-06-05,03:22,0,1,1
49,2023-06-05T03:22:00+10:00,2023-06-05,03:22,1,0,1
19,2023-06-05T03:22:00+10:00,2023-06-05,03:22,2,0,2
48,2023-06-05T03:22:00+10:00,2023-06-05,03:22,0,2,2
66,2023-06-05T03:21:00+10:00,2023-06-05,03:21,1,0,1
71,2023-06-05T03:21:00+10:00,2023-06-05,03:21,0,2,2
30,2023-06-05T03:21:00+10:00,2023-06-05,03:21,3,2,5
49,2023-06-05T03:21:00+10:00,2023-06-05,03:21,2,0,2
3,2023-06-05T03:21:00+10:00,2023-06-05,03:21,3,0,3
28,2023-06-05T03:21:00+10:00,2023-06-05,03:21,0,1,1
41,2023-06-05T03:21:00+10:00,2023-06-05,03:21,2,0,2
54,2023-06-05T03:21:00+10:00,2023-06-05,03:21,2,0,2
58,2023-06-05T03:21:00+10:00,2023-06-05,03:21,0,1,1
5,2023-06-05T03:20:00+10:00,2023-06-05,03:20,0,1,1
84,2023-06-05T03:20:00+10:00,2023-06-05,03:20,1,0,1
117,2023-06-05T03:20:00+10:00,2023-06-05,03:20,0,2,2
47,2023-06-05T03:20:00+10:00,2023-06-05,03:20,0,1,1
108,2023-06-05T03:20:00+10:00,2023-06-05,03:20,1,1,2
24,2023-06-05T03:20:00+10:00,2023-06-05,03:20,1,1,2
30,2023-06-05T03:20:00+10:00,2023-06-05,03:20,0,1,1
52,2023-06-05T03:20:00+10:00,2023-06-05,03:20,0,2,2
3,2023-06-05T03:20:00+10:00,2023-06-05,03:20,1,5,6
79,2023-06-05T03:20:00+10:00,2023-06-05,03:20,0,1,1
4,2023-06-05T03:19:00+10:00,2023-06-05,03:19,0,2,2
5,2023-06-05T03:19:00+10:00,2023-06-05,03:19,1,1,2
17,2023-06-05T03:19:00+10:00,2023-06-05,03:19,1,0,1
19,2023-06-05T03:19:00+10:00,2023-06-05,03:19,0,1,1
67,2023-06-05T03:19:00+10:00,2023-06-05,03:19,1,0,1
36,2023-06-05T03:19:00+10:00,2023-06-05,03:19,0,2,2
55,2023-06-05T03:19:00+10:00,2023-06-05,03:19,5,1,6
30,2023-06-05T03:19:00+10:00,2023-06-05,03:19,7,0,7
62,2023-06-05T03:19:00+10:00,2023-06-05,03:19,0,1,1
3,2023-06-05T03:18:00+10:00,2023-06-05,03:18,1,2,3
4,2023-06-05T03:18:00+10:00,2023-06-05,03:18,1,0,1
6,2023-06-05T03:18:00+10:00,2023-06-05,03:18,1,0,1
35,2023-06-05T03:18:00+10:00,2023-06-05,03:18,2,3,5
58,2023-06-05T03:18:00+10:00,2023-06-05,03:18,0,1,1
1,2023-06-05T03:18:00+10:00,2023-06-05,03:18,0,1,1
17,2023-06-05T03:18:00+10:00,2023-06-05,03:18,0,1,1
27,2023-06-05T03:18:00+10:00,2023-06-05,03:18,1,0,1
28,2023-06-05T03:17:00+10:00,2023-06-05,03:17,0,1,1
55,2023-06-05T03:17:00+10:00,2023-06-05,03:17,0,1,1
5,2023-06-05T03:17:00+10:00,2023-06-05,03:17,0,1,1
61,2023-06-05T03:17:00+10:00,2023-06-05,03:17,1,1,2
3,2023-06-05T03:17:00+10:00,2023-06-05,03:17,0,2,2
12,2023-06-05T03:17:00+10:00,2023-06-05,03:17,0,2,2
30,2023-06-05T03:17:00+10:00,2023-06-05,03:17,1,0,1
21,2023-06-05T03:16:00+10:00,2023-06-05,03:16,1,0,1
61,2023-06-05T03:16:00+10:00,2023-06-05,03:16,1,1,2
19,2023-06-05T03:16:00+10:00,2023-06-05,03:16,1,0,1
24,2023-06-05T03:16:00+10:00,2023-06-05,03:16,0,1,1
52,2023-06-05T03:16:00+10:00,2023-06-05,03:16,1,0,1
5,2023-06-05T03:16:00+10:00,2023-06-05,03:16,0,1,1
37,2023-06-05T03:16:00+10:00,2023-06-05,03:16,1,0,1
54,2023-06-05T03:16:00+10:00,2023-06-05,03:16,0,2,2
66,2023-06-05T03:16:00+10:00,2023-06-05,03:16,0,1,1
35,2023-06-05T03:16:00+10:00,2023-06-05,03:16,0,1,1
28,2023-06-05T03:16:00+10:00,2023-06-05,03:16,0,1,1
55,2023-06-05T03:16:00+10:00,2023-06-05,03:16,1,0,1
23,2023-06-05T03:16:00+10:00,2023-06-05,03:16,0,4,4
21,2023-06-05T03:15:00+10:00,2023-06-05,03:15,2,0,2
41,2023-06-05T03:15:00+10:00,2023-06-05,03:15,2,3,5
24,2023-06-05T03:15:00+10:00,2023-06-05,03:15,0,1,1
30,2023-06-05T03:15:00+10:00,2023-06-05,03:15,0,2,2
3,2023-06-05T03:15:00+10:00,2023-06-05,03:15,1,1,2
5,2023-06-05T03:15:00+10:00,2023-06-05,03:15,0,1,1
84,2023-06-05T03:15:00+10:00,2023-06-05,03:15,1,0,1
109,2023-06-05T03:15:00+10:00,2023-06-05,03:15,1,0,1
45,2023-06-05T03:15:00+10:00,2023-06-05,03:15,0,2,2
47,2023-06-05T03:15:00+10:00,2023-06-05,03:15,4,0,4
55,2023-06-05T03:15:00+10:00,2023-06-05,03:15,0,3,3
12,2023-06-05T03:15:00+10:00,2023-06-05,03:15,0,1,1
62,2023-06-05T03:15:00+10:00,2023-06-05,03:15,0,1,1
3,2023-06-05T03:14:00+10:00,2023-06-05,03:14,1,2,3
4,2023-06-05T03:14:00+10:00,2023-06-05,03:14,0,1,1
6,2023-06-05T03:14:00+10:00,2023-06-05,03:14,0,1,1
61,2023-06-05T03:14:00+10:00,2023-06-05,03:14,1,0,1
5,2023-06-05T03:14:00+10:00,2023-06-05,03:14,0,1,1
28,2023-06-05T03:14:00+10:00,2023-06-05,03:14,0,1,1
35,2023-06-05T03:14:00+10:00,2023-06-05,03:14,2,1,3
21,2023-06-05T03:14:00+10:00,2023-06-05,03:14,0,2,2
24,2023-06-05T03:14:00+10:00,2023-06-05,03:14,1,0,1
48,2023-06-05T03:14:00+10:00,2023-06-05,03:14,0,1,1
49,2023-06-05T03:14:00+10:00,2023-06-05,03:14,0,2,2
62,2023-06-05T03:14:00+10:00,2023-06-05,03:14,0,1,1
54,2023-06-05T03:13:00+10:00,2023-06-05,03:13,1,0,1
55,2023-06-05T03:13:00+10:00,2023-06-05,03:13,0,2,2
61,2023-06-05T03:13:00+10:00,2023-06-05,03:13,0,2,2
5,2023-06-05T03:13:00+10:00,2023-06-05,03:13,1,1,2
26,2023-06-05T03:13:00+10:00,2023-06-05,03:13,3,1,4
1,2023-06-05T03:13:00+10:00,2023-06-05,03:13,0,3,3
20,2023-06-05T03:13:00+10:00,2023-06-05,03:13,0,1,1
67,2023-06-05T03:13:00+10:00,2023-06-05,03:13,2,0,2
3,2023-06-05T03:13:00+10:00,2023-06-05,03:13,2,3,5
2,2023-06-05T03:13:00+10:00,2023-06-05,03:13,0,2,2
4,2023-06-05T03:12:00+10:00,2023-06-05,03:12,1,0,1
14,2023-06-05T03:12:00+10:00,2023-06-05,03:12,1,0,1
28,2023-06-05T03:12:00+10:00,2023-06-05,03:12,0,1,1
3,2023-06-05T03:12:00+10:00,2023-06-05,03:12,2,0,2
36,2023-06-05T03:12:00+10:00,2023-06-05,03:12,1,0,1
42,2023-06-05T03:12:00+10:00,2023-06-05,03:12,1,0,1
55,2023-06-05T03:12:00+10:00,2023-06-05,03:12,0,1,1
24,2023-06-05T03:12:00+10:00,2023-06-05,03:12,1,0,1
49,2023-06-05T03:12:00+10:00,2023-06-05,03:12,0,2,2
26,2023-06-05T03:12:00+10:00,2023-06-05,03:12,1,0,1
54,2023-06-05T03:12:00+10:00,2023-06-05,03:12,3,0,3
61,2023-06-05T03:12:00+10:00,2023-06-05,03:12,0,1,1
3,2023-06-05T03:11:00+10:00,2023-06-05,03:11,1,1,2
28,2023-06-05T03:11:00+10:00,2023-06-05,03:11,2,0,2
62,2023-06-05T03:11:00+10:00,2023-06-05,03:11,2,0,2
12,2023-06-05T03:11:00+10:00,2023-06-05,03:11,0,1,1
56,2023-06-05T03:11:00+10:00,2023-06-05,03:11,0,1,1
47,2023-06-05T03:11:00+10:00,2023-06-05,03:11,2,0,2
55,2023-06-05T03:11:00+10:00,2023-06-05,03:11,0,1,1
61,2023-06-05T03:11:00+10:00,2023-06-05,03:11,3,1,4
1,2023-06-05T03:11:00+10:00,2023-06-05,03:11,2,0,2
20,2023-06-05T03:11:00+10:00,2023-06-05,03:11,1,0,1
51,2023-06-05T03:11:00+10:00,2023-06-05,03:11,1,0,1
58,2023-06-05T03:11:00+10:00,2023-06-05,03:11,0,1,1
55,2023-06-05T03:10:00+10:00,2023-06-05,03:10,1,0,1
49,2023-06-05T03:10:00+10:00,2023-06-05,03:10,2,0,2
51,2023-06-05T03:10:00+10:00,2023-06-05,03:10,0,1,1
3,2023-06-05T03:10:00+10:00,2023-06-05,03:10,0,1,1
26,2023-06-05T03:10:00+10:00,2023-06-05,03:10,0,2,2
28,2023-06-05T03:10:00+10:00,2023-06-05,03:10,0,1,1
54,2023-06-05T03:10:00+10:00,2023-06-05,03:10,1,0,1
84,2023-06-05T03:10:00+10:00,2023-06-05,03:10,1,2,3
1,2023-06-05T03:10:00+10:00,2023-06-05,03:10,0,3,3
14,2023-06-05T03:10:00+10:00,2023-06-05,03:10,0,2,2
47,2023-06-05T03:10:00+10:00,2023-06-05,03:10,0,1,1
2,2023-06-05T03:10:00+10:00,2023-06-05,03:10,1,0,1
17,2023-06-05T03:10:00+10:00,2023-06-05,03:10,0,1,1
30,2023-06-05T03:10:00+10:00,2023-06-05,03:10,0,1,1
109,2023-06-05T03:10:00+10:00,2023-06-05,03:10,1,0,1
3,2023-06-05T03:09:00+10:00,2023-06-05,03:09,1,1,2
5,2023-06-05T03:09:00+10:00,2023-06-05,03:09,1,0,1
66,2023-06-05T03:09:00+10:00,2023-06-05,03:09,1,0,1
20,2023-06-05T03:09:00+10:00,2023-06-05,03:09,0,1,1
30,2023-06-05T03:09:00+10:00,2023-06-05,03:09,0,2,2
48,2023-06-05T03:09:00+10:00,2023-06-05,03:09,3,0,3
79,2023-06-05T03:09:00+10:00,2023-06-05,03:09,1,0,1
65,2023-06-05T03:09:00+10:00,2023-06-05,03:09,0,1,1
51,2023-06-05T03:09:00+10:00,2023-06-05,03:09,0,1,1
52,2023-06-05T03:09:00+10:00,2023-06-05,03:09,1,0,1
62,2023-06-05T03:09:00+10:00,2023-06-05,03:09,1,0,1
3,2023-06-05T03:08:00+10:00,2023-06-05,03:08,1,1,2
5,2023-06-05T03:08:00+10:00,2023-06-05,03:08,1,0,1
37,2023-06-05T03:08:00+10:00,2023-06-05,03:08,2,0,2
61,2023-06-05T03:08:00+10:00,2023-06-05,03:08,1,0,1
66,2023-06-05T03:08:00+10:00,2023-06-05,03:08,1,0,1
42,2023-06-05T03:08:00+10:00,2023-06-05,03:08,0,1,1
47,2023-06-05T03:08:00+10:00,2023-06-05,03:08,1,3,4
55,2023-06-05T03:08:00+10:00,2023-06-05,03:08,1,0,1
62,2023-06-05T03:08:00+10:00,2023-06-05,03:08,1,0,1
41,2023-06-05T03:08:00+10:00,2023-06-05,03:08,0,1,1
30,2023-06-05T03:08:00+10:00,2023-06-05,03:08,0,1,1
48,2023-06-05T03:08:00+10:00,2023-06-05,03:08,1,0,1
51,2023-06-05T03:08:00+10:00,2023-06-05,03:08,0,1,1
58,2023-06-05T03:08:00+10:00,2023-06-05,03:08,1,0,1
4,2023-06-05T03:07:00+10:00,2023-06-05,03:07,0,2,2
42,2023-06-05T03:07:00+10:00,2023-06-05,03:07,1,0,1
47,2023-06-05T03:07:00+10:00,2023-06-05,03:07,1,0,1
55,2023-06-05T03:07:00+10:00,2023-06-05,03:07,0,1,1
2,2023-06-05T03:07:00+10:00,2023-06-05,03:07,0,2,2
57,2023-06-05T03:07:00+10:00,2023-06-05,03:07,0,2,2
3,2023-06-05T03:07:00+10:00,2023-06-05,03:07,0,1,1
87,2023-06-05T03:07:00+10:00,2023-06-05,03:07,0,1,1
45,2023-06-05T03:07:00+10:00,2023-06-05,03:07,0,2,2
30,2023-06-05T03:07:00+10:00,2023-06-05,03:07,2,2,4
51,2023-06-05T03:07:00+10:00,2023-06-05,03:07,1,0,1
3,2023-06-05T03:06:00+10:00,2023-06-05,03:06,0,1,1
26,2023-06-05T03:06:00+10:00,2023-06-05,03:06,0,2,2
20,2023-06-05T03:06:00+10:00,2023-06-05,03:06,1,1,2
24,2023-06-05T03:06:00+10:00,2023-06-05,03:06,1,0,1
5,2023-06-05T03:06:00+10:00,2023-06-05,03:06,0,1,1
28,2023-06-05T03:06:00+10:00,2023-06-05,03:06,0,1,1
41,2023-06-05T03:06:00+10:00,2023-06-05,03:06,0,2,2
54,2023-06-05T03:06:00+10:00,2023-06-05,03:06,0,2,2
55,2023-06-05T03:06:00+10:00,2023-06-05,03:06,0,1,1
17,2023-06-05T03:06:00+10:00,2023-06-05,03:06,2,1,3
71,2023-06-05T03:06:00+10:00,2023-06-05,03:06,0,1,1
55,2023-06-05T03:05:00+10:00,2023-06-05,03:05,2,2,4
84,2023-06-05T03:05:00+10:00,2023-06-05,03:05,3,1,4
19,2023-06-05T03:05:00+10:00,2023-06-05,03:05,0,2,2
52,2023-06-05T03:05:00+10:00,2023-06-05,03:05,0,1,1
79,2023-06-05T03:05:00+10:00,2023-06-05,03:05,0,1,1
49,2023-06-05T03:05:00+10:00,2023-06-05,03:05,2,0,2
62,2023-06-05T03:05:00+10:00,2023-06-05,03:05,0,3,3
5,2023-06-05T03:05:00+10:00,2023-06-05,03:05,1,3,4
26,2023-06-05T03:05:00+10:00,2023-06-05,03:05,1,0,1
2,2023-06-05T03:05:00+10:00,2023-06-05,03:05,1,0,1
20,2023-06-05T03:05:00+10:00,2023-06-05,03:05,0,2,2
24,2023-06-05T03:05:00+10:00,2023-06-05,03:05,0,1,1
117,2023-06-05T03:05:00+10:00,2023-06-05,03:05,3,0,3
14,2023-06-05T03:04:00+10:00,2023-06-05,03:04,1,0,1
20,2023-06-05T03:04:00+10:00,2023-06-05,03:04,1,0,1
58,2023-06-05T03:04:00+10:00,2023-06-05,03:04,1,0,1
26,2023-06-05T03:04:00+10:00,2023-06-05,03:04,2,0,2
55,2023-06-05T03:04:00+10:00,2023-06-05,03:04,1,1,2
108,2023-06-05T03:04:00+10:00,2023-06-05,03:04,0,2,2
24,2023-06-05T03:04:00+10:00,2023-06-05,03:04,6,0,6
27,2023-06-05T03:04:00+10:00,2023-06-05,03:04,0,1,1
30,2023-06-05T03:04:00+10:00,2023-06-05,03:04,0,1,1
62,2023-06-05T03:04:00+10:00,2023-06-05,03:04,2,1,3
71,2023-06-05T03:03:00+10:00,2023-06-05,03:03,1,0,1
24,2023-06-05T03:03:00+10:00,2023-06-05,03:03,0,1,1
35,2023-06-05T03:03:00+10:00,2023-06-05,03:03,0,2,2
3,2023-06-05T03:03:00+10:00,2023-06-05,03:03,1,0,1
21,2023-06-05T03:03:00+10:00,2023-06-05,03:03,2,0,2
79,2023-06-05T03:03:00+10:00,2023-06-05,03:03,0,2,2
44,2023-06-05T03:03:00+10:00,2023-06-05,03:03,0,1,1
55,2023-06-05T03:03:00+10:00,2023-06-05,03:03,2,1,3
9,2023-06-05T03:03:00+10:00,2023-06-05,03:03,1,0,1
20,2023-06-05T03:03:00+10:00,2023-06-05,03:03,1,4,5
4,2023-06-05T03:02:00+10:00,2023-06-05,03:02,1,0,1
55,2023-06-05T03:02:00+10:00,2023-06-05,03:02,2,1,3
53,2023-06-05T03:02:00+10:00,2023-06-05,03:02,1,0,1
66,2023-06-05T03:02:00+10:00,2023-06-05,03:02,1,0,1
67,2023-06-05T03:02:00+10:00,2023-06-05,03:02,0,1,1
3,2023-06-05T03:02:00+10:00,2023-06-05,03:02,2,2,4
5,2023-06-05T03:02:00+10:00,2023-06-05,03:02,1,3,4
28,2023-06-05T03:02:00+10:00,2023-06-05,03:02,0,1,1
41,2023-06-05T03:02:00+10:00,2023-06-05,03:02,1,3,4
20,2023-06-05T03:02:00+10:00,2023-06-05,03:02,1,0,1
62,2023-06-05T03:02:00+10:00,2023-06-05,03:02,1,0,1
79,2023-06-05T03:02:00+10:00,2023-06-05,03:02,0,1,1
30,2023-06-05T03:01:00+10:00,2023-06-05,03:01,1,0,1
3,2023-06-05T03:01:00+10:00,2023-06-05,03:01,1,0,1
21,2023-06-05T03:01:00+10:00,2023-06-05,03:01,2,0,2
55,2023-06-05T03:01:00+10:00,2023-06-05,03:01,1,6,7
2,2023-06-05T03:01:00+10:00,2023-06-05,03:01,0,1,1
19,2023-06-05T03:01:00+10:00,2023-06-05,03:01,0,1,1
35,2023-06-05T03:01:00+10:00,2023-06-05,03:01,1,0,1
51,2023-06-05T03:01:00+10:00,2023-06-05,03:01,0,1,1
72,2023-06-05T03:01:00+10:00,2023-06-05,03:01,2,1,3
55,2023-06-05T03:00:00+10:00,2023-06-05,03:00,1,5,6
87,2023-06-05T03:00:00+10:00,2023-06-05,03:00,1,0,1
20,2023-06-05T03:00:00+10:00,2023-06-05,03:00,1,0,1
79,2023-06-05T03:00:00+10:00,2023-06-05,03:00,1,0,1
109,2023-06-05T03:00:00+10:00,2023-06-05,03:00,2,0,2
3,2023-06-05T03:00:00+10:00,2023-06-05,03:00,3,1,4
14,2023-06-05T03:00:00+10:00,2023-06-05,03:00,0,1,1
84,2023-06-05T03:00:00+10:00,2023-06-05,03:00,0,2,2
107,2023-06-05T03:00:00+10:00,2023-06-05,03:00,0,1,1
49,2023-06-05T03:00:00+10:00,2023-06-05,03:00,0,1,1
117,2023-06-05T03:00:00+10:00,2023-06-05,03:00,0,1,1
72,2023-06-05T02:59:00+10:00,2023-06-05,02:59,1,3,4
5,2023-06-05T02:59:00+10:00,2023-06-05,02:59,1,0,1
28,2023-06-05T02:59:00+10:00,2023-06-05,02:59,0,1,1
55,2023-06-05T02:59:00+10:00,2023-06-05,02:59,0,8,8
2,2023-06-05T02:59:00+10:00,2023-06-05,02:59,0,1,1
19,2023-06-05T02:59:00+10:00,2023-06-05,02:59,0,1,1
53,2023-06-05T02:59:00+10:00,2023-06-05,02:59,1,0,1
58,2023-06-05T02:59:00+10:00,2023-06-05,02:59,0,1,1
55,2023-06-05T02:58:00+10:00,2023-06-05,02:58,1,1,2
49,2023-06-05T02:58:00+10:00,2023-06-05,02:58,0,2,2
20,2023-06-05T02:58:00+10:00,2023-06-05,02:58,0,2,2
51,2023-06-05T02:58:00+10:00,2023-06-05,02:58,0,1,1
3,2023-06-05T02:58:00+10:00,2023-06-05,02:58,2,0,2
4,2023-06-05T02:58:00+10:00,2023-06-05,02:58,0,1,1
19,2023-06-05T02:58:00+10:00,2023-06-05,02:58,1,0,1
35,2023-06-05T02:58:00+10:00,2023-06-05,02:58,3,0,3
3,2023-06-05T02:57:00+10:00,2023-06-05,02:57,4,2,6
28,2023-06-05T02:57:00+10:00,2023-06-05,02:57,0,1,1
47,2023-06-05T02:57:00+10:00,2023-06-05,02:57,0,1,1
54,2023-06-05T02:57:00+10:00,2023-06-05,02:57,2,1,3
1,2023-06-05T02:57:00+10:00,2023-06-05,02:57,1,0,1
30,2023-06-05T02:56:00+10:00,2023-06-05,02:56,0,4,4
58,2023-06-05T02:56:00+10:00,2023-06-05,02:56,0,1,1
36,2023-06-05T02:56:00+10:00,2023-06-05,02:56,0,1,1
49,2023-06-05T02:56:00+10:00,2023-06-05,02:56,0,2,2
56,2023-06-05T02:56:00+10:00,2023-06-05,02:56,4,0,4
79,2023-06-05T02:56:00+10:00,2023-06-05,02:56,0,1,1
5,2023-06-05T02:56:00+10:00,2023-06-05,02:56,0,1,1
21,2023-06-05T02:56:00+10:00,2023-06-05,02:56,2,0,2
45,2023-06-05T02:56:00+10:00,2023-06-05,02:56,1,0,1
55,2023-06-05T02:56:00+10:00,2023-06-05,02:56,3,2,5
65,2023-06-05T02:56:00+10:00,2023-06-05,02:56,0,2,2
69,2023-06-05T02:56:00+10:00,2023-06-05,02:56,0,1,1
2,2023-06-05T02:56:00+10:00,2023-06-05,02:56,1,0,1
26,2023-06-05T02:55:00+10:00,2023-06-05,02:55,0,7,7
6,2023-06-05T02:55:00+10:00,2023-06-05,02:55,1,0,1
55,2023-06-05T02:55:00+10:00,2023-06-05,02:55,4,0,4
84,2023-06-05T02:55:00+10:00,2023-06-05,02:55,0,1,1
49,2023-06-05T02:55:00+10:00,2023-06-05,02:55,0,2,2
3,2023-06-05T02:55:00+10:00,2023-06-05,02:55,1,0,1
4,2023-06-05T02:55:00+10:00,2023-06-05,02:55,2,0,2
58,2023-06-05T02:55:00+10:00,2023-06-05,02:55,1,2,3
37,2023-06-05T02:54:00+10:00,2023-06-05,02:54,0,1,1
55,2023-06-05T02:54:00+10:00,2023-06-05,02:54,0,1,1
24,2023-06-05T02:54:00+10:00,2023-06-05,02:54,0,2,2
30,2023-06-05T02:54:00+10:00,2023-06-05,02:54,4,0,4
58,2023-06-05T02:54:00+10:00,2023-06-05,02:54,4,1,5
41,2023-06-05T02:54:00+10:00,2023-06-05,02:54,0,1,1
62,2023-06-05T02:54:00+10:00,2023-06-05,02:54,1,0,1
3,2023-06-05T02:54:00+10:00,2023-06-05,02:54,3,1,4
5,2023-06-05T02:54:00+10:00,2023-06-05,02:54,1,0,1
57,2023-06-05T02:54:00+10:00,2023-06-05,02:54,0,2,2
5,2023-06-05T02:53:00+10:00,2023-06-05,02:53,1,2,3
41,2023-06-05T02:53:00+10:00,2023-06-05,02:53,1,0,1
54,2023-06-05T02:53:00+10:00,2023-06-05,02:53,0,3,3
1,2023-06-05T02:53:00+10:00,2023-06-05,02:53,1,0,1
2,2023-06-05T02:53:00+10:00,2023-06-05,02:53,0,1,1
30,2023-06-05T02:53:00+10:00,2023-06-05,02:53,2,2,4
47,2023-06-05T02:53:00+10:00,2023-06-05,02:53,2,0,2
55,2023-06-05T02:53:00+10:00,2023-06-05,02:53,1,0,1
66,2023-06-05T02:53:00+10:00,2023-06-05,02:53,0,4,4
49,2023-06-05T02:53:00+10:00,2023-06-05,02:53,2,0,2
52,2023-06-05T02:53:00+10:00,2023-06-05,02:53,0,1,1
6,2023-06-05T02:53:00+10:00,2023-06-05,02:53,1,0,1
29,2023-06-05T02:53:00+10:00,2023-06-05,02:53,0,1,1
35,2023-06-05T02:53:00+10:00,2023-06-05,02:53,1,0,1
3,2023-06-05T02:52:00+10:00,2023-06-05,02:52,2,0,2
54,2023-06-05T02:52:00+10:00,2023-06-05,02:52,0,2,2
49,2023-06-05T02:52:00+10:00,2023-06-05,02:52,0,5,5
14,2023-06-05T02:52:00+10:00,2023-06-05,02:52,0,1,1
26,2023-06-05T02:52:00+10:00,2023-06-05,02:52,1,0,1
51,2023-06-05T02:52:00+10:00,2023-06-05,02:52,0,1,1
56,2023-06-05T02:52:00+10:00,2023-06-05,02:52,0,1,1
58,2023-06-05T02:52:00+10:00,2023-06-05,02:52,1,4,5
62,2023-06-05T02:52:00+10:00,2023-06-05,02:52,2,0,2
24,2023-06-05T02:52:00+10:00,2023-06-05,02:52,1,0,1
53,2023-06-05T02:52:00+10:00,2023-06-05,02:52,0,1,1
41,2023-06-05T02:51:00+10:00,2023-06-05,02:51,0,1,1
47,2023-06-05T02:51:00+10:00,2023-06-05,02:51,1,3,4
65,2023-06-05T02:51:00+10:00,2023-06-05,02:51,0,1,1
51,2023-06-05T02:51:00+10:00,2023-06-05,02:51,0,1,1
62,2023-06-05T02:51:00+10:00,2023-06-05,02:51,1,0,1
4,2023-06-05T02:51:00+10:00,2023-06-05,02:51,0,1,1
21,2023-06-05T02:51:00+10:00,2023-06-05,02:51,0,1,1
36,2023-06-05T02:51:00+10:00,2023-06-05,02:51,0,1,1
23,2023-06-05T02:51:00+10:00,2023-06-05,02:51,5,1,6
5,2023-06-05T02:51:00+10:00,2023-06-05,02:51,1,3,4
55,2023-06-05T02:51:00+10:00,2023-06-05,02:51,2,1,3
35,2023-06-05T02:51:00+10:00,2023-06-05,02:51,0,4,4
58,2023-06-05T02:51:00+10:00,2023-06-05,02:51,5,4,9
3,2023-06-05T02:50:00+10:00,2023-06-05,02:50,0,1,1
41,2023-06-05T02:50:00+10:00,2023-06-05,02:50,1,0,1
42,2023-06-05T02:50:00+10:00,2023-06-05,02:50,1,0,1
61,2023-06-05T02:50:00+10:00,2023-06-05,02:50,1,0,1
84,2023-06-05T02:50:00+10:00,2023-06-05,02:50,1,2,3
35,2023-06-05T02:50:00+10:00,2023-06-05,02:50,0,1,1
21,2023-06-05T02:50:00+10:00,2023-06-05,02:50,0,1,1
31,2023-06-05T02:50:00+10:00,2023-06-05,02:50,0,1,1
47,2023-06-05T02:50:00+10:00,2023-06-05,02:50,1,0,1
54,2023-06-05T02:50:00+10:00,2023-06-05,02:50,1,0,1
5,2023-06-05T02:50:00+10:00,2023-06-05,02:50,1,0,1
24,2023-06-05T02:50:00+10:00,2023-06-05,02:50,0,1,1
58,2023-06-05T02:50:00+10:00,2023-06-05,02:50,0,1,1
54,2023-06-05T02:49:00+10:00,2023-06-05,02:49,0,1,1
55,2023-06-05T02:49:00+10:00,2023-06-05,02:49,1,1,2
9,2023-06-05T02:49:00+10:00,2023-06-05,02:49,1,0,1
62,2023-06-05T02:49:00+10:00,2023-06-05,02:49,1,0,1
45,2023-06-05T02:49:00+10:00,2023-06-05,02:49,0,1,1
26,2023-06-05T02:49:00+10:00,2023-06-05,02:49,0,1,1
61,2023-06-05T02:49:00+10:00,2023-06-05,02:49,0,1,1
49,2023-06-05T02:49:00+10:00,2023-06-05,02:49,2,0,2
56,2023-06-05T02:49:00+10:00,2023-06-05,02:49,1,1,2
4,2023-06-05T02:48:00+10:00,2023-06-05,02:48,0,1,1
26,2023-06-05T02:48:00+10:00,2023-06-05,02:48,2,0,2
6,2023-06-05T02:48:00+10:00,2023-06-05,02:48,0,5,5
21,2023-06-05T02:48:00+10:00,2023-06-05,02:48,2,2,4
55,2023-06-05T02:48:00+10:00,2023-06-05,02:48,1,2,3
65,2023-06-05T02:47:00+10:00,2023-06-05,02:47,0,1,1
66,2023-06-05T02:47:00+10:00,2023-06-05,02:47,0,1,1
20,2023-06-05T02:47:00+10:00,2023-06-05,02:47,2,0,2
21,2023-06-05T02:47:00+10:00,2023-06-05,02:47,0,2,2
28,2023-06-05T02:47:00+10:00,2023-06-05,02:47,0,1,1
47,2023-06-05T02:47:00+10:00,2023-06-05,02:47,4,0,4
55,2023-06-05T02:47:00+10:00,2023-06-05,02:47,0,1,1
5,2023-06-05T02:47:00+10:00,2023-06-05,02:47,0,1,1
41,2023-06-05T02:47:00+10:00,2023-06-05,02:47,1,1,2
30,2023-06-05T02:47:00+10:00,2023-06-05,02:47,1,1,2
62,2023-06-05T02:47:00+10:00,2023-06-05,02:47,1,1,2
21,2023-06-05T02:46:00+10:00,2023-06-05,02:46,3,0,3
41,2023-06-05T02:46:00+10:00,2023-06-05,02:46,1,0,1
2,2023-06-05T02:46:00+10:00,2023-06-05,02:46,1,0,1
53,2023-06-05T02:46:00+10:00,2023-06-05,02:46,1,0,1
79,2023-06-05T02:46:00+10:00,2023-06-05,02:46,0,1,1
3,2023-06-05T02:46:00+10:00,2023-06-05,02:46,0,1,1
4,2023-06-05T02:46:00+10:00,2023-06-05,02:46,3,0,3
45,2023-06-05T02:46:00+10:00,2023-06-05,02:46,1,0,1
50,2023-06-05T02:46:00+10:00,2023-06-05,02:46,1,0,1
66,2023-06-05T02:46:00+10:00,2023-06-05,02:46,1,0,1
51,2023-06-05T02:46:00+10:00,2023-06-05,02:46,1,0,1
62,2023-06-05T02:46:00+10:00,2023-06-05,02:46,2,0,2
42,2023-06-05T02:46:00+10:00,2023-06-05,02:46,1,0,1
55,2023-06-05T02:46:00+10:00,2023-06-05,02:46,0,1,1
30,2023-06-05T02:46:00+10:00,2023-06-05,02:46,0,1,1
52,2023-06-05T02:46:00+10:00,2023-06-05,02:46,1,0,1
54,2023-06-05T02:45:00+10:00,2023-06-05,02:45,1,0,1
66,2023-06-05T02:45:00+10:00,2023-06-05,02:45,2,0,2
84,2023-06-05T02:45:00+10:00,2023-06-05,02:45,1,4,5
30,2023-06-05T02:45:00+10:00,2023-06-05,02:45,3,0,3
26,2023-06-05T02:45:00+10:00,2023-06-05,02:45,0,2,2
79,2023-06-05T02:45:00+10:00,2023-06-05,02:45,1,0,1
21,2023-06-05T02:45:00+10:00,2023-06-05,02:45,0,1,1
55,2023-06-05T02:45:00+10:00,2023-06-05,02:45,1,3,4
87,2023-06-05T02:45:00+10:00,2023-06-05,02:45,2,0,2
23,2023-06-05T02:45:00+10:00,2023-06-05,02:45,0,1,1
3,2023-06-05T02:44:00+10:00,2023-06-05,02:44,1,0,1
4,2023-06-05T02:44:00+10:00,2023-06-05,02:44,1,0,1
14,2023-06-05T02:44:00+10:00,2023-06-05,02:44,0,2,2
45,2023-06-05T02:44:00+10:00,2023-06-05,02:44,0,1,1
24,2023-06-05T02:44:00+10:00,2023-06-05,02:44,1,0,1
28,2023-06-05T02:44:00+10:00,2023-06-05,02:44,1,1,2
55,2023-06-05T02:44:00+10:00,2023-06-05,02:44,0,1,1
52,2023-06-05T02:44:00+10:00,2023-06-05,02:44,0,2,2
14,2023-06-05T02:43:00+10:00,2023-06-05,02:43,0,1,1
26,2023-06-05T02:43:00+10:00,2023-06-05,02:43,6,0,6
47,2023-06-05T02:43:00+10:00,2023-06-05,02:43,0,1,1
30,2023-06-05T02:43:00+10:00,2023-06-05,02:43,2,1,3
52,2023-06-05T02:43:00+10:00,2023-06-05,02:43,0,1,1
21,2023-06-05T02:43:00+10:00,2023-06-05,02:43,1,0,1
23,2023-06-05T02:43:00+10:00,2023-06-05,02:43,1,0,1
62,2023-06-05T02:43:00+10:00,2023-06-05,02:43,1,0,1
41,2023-06-05T02:43:00+10:00,2023-06-05,02:43,2,2,4
6,2023-06-05T02:42:00+10:00,2023-06-05,02:42,1,0,1
37,2023-06-05T02:42:00+10:00,2023-06-05,02:42,0,1,1
61,2023-06-05T02:42:00+10:00,2023-06-05,02:42,0,1,1
41,2023-06-05T02:42:00+10:00,2023-06-05,02:42,0,1,1
30,2023-06-05T02:42:00+10:00,2023-06-05,02:42,1,0,1
56,2023-06-05T02:42:00+10:00,2023-06-05,02:42,5,2,7
71,2023-06-05T02:42:00+10:00,2023-06-05,02:42,0,3,3
36,2023-06-05T02:41:00+10:00,2023-06-05,02:41,1,0,1
65,2023-06-05T02:41:00+10:00,2023-06-05,02:41,0,2,2
24,2023-06-05T02:41:00+10:00,2023-06-05,02:41,0,1,1
5,2023-06-05T02:41:00+10:00,2023-06-05,02:41,1,0,1
41,2023-06-05T02:41:00+10:00,2023-06-05,02:41,2,0,2
3,2023-06-05T02:41:00+10:00,2023-06-05,02:41,0,1,1
53,2023-06-05T02:41:00+10:00,2023-06-05,02:41,1,0,1
62,2023-06-05T02:41:00+10:00,2023-06-05,02:41,0,2,2
4,2023-06-05T02:40:00+10:00,2023-06-05,02:40,1,0,1
5,2023-06-05T02:40:00+10:00,2023-06-05,02:40,0,1,1
54,2023-06-05T02:40:00+10:00,2023-06-05,02:40,2,2,4
71,2023-06-05T02:40:00+10:00,2023-06-05,02:40,1,1,2
49,2023-06-05T02:40:00+10:00,2023-06-05,02:40,0,1,1
51,2023-06-05T02:40:00+10:00,2023-06-05,02:40,6,0,6
35,2023-06-05T02:40:00+10:00,2023-06-05,02:40,1,0,1
117,2023-06-05T02:40:00+10:00,2023-06-05,02:40,1,0,1
6,2023-06-05T02:40:00+10:00,2023-06-05,02:40,2,1,3
65,2023-06-05T02:40:00+10:00,2023-06-05,02:40,0,1,1
2,2023-06-05T02:40:00+10:00,2023-06-05,02:40,1,0,1
30,2023-06-05T02:40:00+10:00,2023-06-05,02:40,0,2,2
62,2023-06-05T02:40:00+10:00,2023-06-05,02:40,3,2,5
109,2023-06-05T02:40:00+10:00,2023-06-05,02:40,0,1,1
4,2023-06-05T02:39:00+10:00,2023-06-05,02:39,0,1,1
29,2023-06-05T02:39:00+10:00,2023-06-05,02:39,1,0,1
61,2023-06-05T02:39:00+10:00,2023-06-05,02:39,0,2,2
108,2023-06-05T02:39:00+10:00,2023-06-05,02:39,1,0,1
52,2023-06-05T02:39:00+10:00,2023-06-05,02:39,1,0,1
62,2023-06-05T02:39:00+10:00,2023-06-05,02:39,2,0,2
37,2023-06-05T02:39:00+10:00,2023-06-05,02:39,3,0,3
40,2023-06-05T02:39:00+10:00,2023-06-05,02:39,0,2,2
41,2023-06-05T02:39:00+10:00,2023-06-05,02:39,1,0,1
54,2023-06-05T02:39:00+10:00,2023-06-05,02:39,1,0,1
71,2023-06-05T02:39:00+10:00,2023-06-05,02:39,0,1,1
24,2023-06-05T02:39:00+10:00,2023-06-05,02:39,0,1,1
3,2023-06-05T02:39:00+10:00,2023-06-05,02:39,0,2,2
5,2023-06-05T02:39:00+10:00,2023-06-05,02:39,1,0,1
66,2023-06-05T02:39:00+10:00,2023-06-05,02:39,0,1,1
2,2023-06-05T02:39:00+10:00,2023-06-05,02:39,0,1,1
19,2023-06-05T02:39:00+10:00,2023-06-05,02:39,1,0,1
40,2023-06-05T02:38:00+10:00,2023-06-05,02:38,2,0,2
71,2023-06-05T02:38:00+10:00,2023-06-05,02:38,1,0,1
1,2023-06-05T02:38:00+10:00,2023-06-05,02:38,2,0,2
30,2023-06-05T02:38:00+10:00,2023-06-05,02:38,1,1,2
49,2023-06-05T02:38:00+10:00,2023-06-05,02:38,2,0,2
5,2023-06-05T02:38:00+10:00,2023-06-05,02:38,0,1,1
21,2023-06-05T02:38:00+10:00,2023-06-05,02:38,2,1,3
26,2023-06-05T02:38:00+10:00,2023-06-05,02:38,0,1,1
55,2023-06-05T02:38:00+10:00,2023-06-05,02:38,3,0,3
56,2023-06-05T02:38:00+10:00,2023-06-05,02:38,2,0,2
3,2023-06-05T02:38:00+10:00,2023-06-05,02:38,2,1,3
45,2023-06-05T02:38:00+10:00,2023-06-05,02:38,0,1,1
54,2023-06-05T02:38:00+10:00,2023-06-05,02:38,1,0,1
24,2023-06-05T02:38:00+10:00,2023-06-05,02:38,1,0,1
62,2023-06-05T02:38:00+10:00,2023-06-05,02:38,0,1,1
21,2023-06-05T02:37:00+10:00,2023-06-05,02:37,0,1,1
26,2023-06-05T02:37:00+10:00,2023-06-05,02:37,1,1,2
3,2023-06-05T02:37:00+10:00,2023-06-05,02:37,2,0,2
45,2023-06-05T02:37:00+10:00,2023-06-05,02:37,0,3,3
47,2023-06-05T02:37:00+10:00,2023-06-05,02:37,2,0,2
69,2023-06-05T02:37:00+10:00,2023-06-05,02:37,1,0,1
30,2023-06-05T02:37:00+10:00,2023-06-05,02:37,0,1,1
14,2023-06-05T02:37:00+10:00,2023-06-05,02:37,1,0,1
36,2023-06-05T02:37:00+10:00,2023-06-05,02:37,0,1,1
41,2023-06-05T02:37:00+10:00,2023-06-05,02:37,0,2,2
42,2023-06-05T02:37:00+10:00,2023-06-05,02:37,0,3,3
48,2023-06-05T02:37:00+10:00,2023-06-05,02:37,2,0,2
21,2023-06-05T02:36:00+10:00,2023-06-05,02:36,0,2,2
26,2023-06-05T02:36:00+10:00,2023-06-05,02:36,1,0,1
2,2023-06-05T02:36:00+10:00,2023-06-05,02:36,1,3,4
35,2023-06-05T02:36:00+10:00,2023-06-05,02:36,0,1,1
3,2023-06-05T02:36:00+10:00,2023-06-05,02:36,4,0,4
71,2023-06-05T02:36:00+10:00,2023-06-05,02:36,0,2,2
20,2023-06-05T02:36:00+10:00,2023-06-05,02:36,0,2,2
62,2023-06-05T02:36:00+10:00,2023-06-05,02:36,3,2,5
79,2023-06-05T02:36:00+10:00,2023-06-05,02:36,0,1,1
4,2023-06-05T02:36:00+10:00,2023-06-05,02:36,0,2,2
3,2023-06-05T02:35:00+10:00,2023-06-05,02:35,2,0,2
40,2023-06-05T02:35:00+10:00,2023-06-05,02:35,1,0,1
42,2023-06-05T02:35:00+10:00,2023-06-05,02:35,1,0,1
19,2023-06-05T02:35:00+10:00,2023-06-05,02:35,0,1,1
72,2023-06-05T02:35:00+10:00,2023-06-05,02:35,4,0,4
6,2023-06-05T02:35:00+10:00,2023-06-05,02:35,1,0,1
4,2023-06-05T02:35:00+10:00,2023-06-05,02:35,1,1,2
26,2023-06-05T02:35:00+10:00,2023-06-05,02:35,1,0,1
28,2023-06-05T02:35:00+10:00,2023-06-05,02:35,1,0,1
55,2023-06-05T02:35:00+10:00,2023-06-05,02:35,2,0,2
84,2023-06-05T02:35:00+10:00,2023-06-05,02:35,1,0,1
6,2023-06-05T02:34:00+10:00,2023-06-05,02:34,2,0,2
87,2023-06-05T02:34:00+10:00,2023-06-05,02:34,0,1,1
27,2023-06-05T02:34:00+10:00,2023-06-05,02:34,0,1,1
36,2023-06-05T02:34:00+10:00,2023-06-05,02:34,0,1,1
55,2023-06-05T02:34:00+10:00,2023-06-05,02:34,1,0,1
66,2023-06-05T02:34:00+10:00,2023-06-05,02:34,2,0,2
3,2023-06-05T02:34:00+10:00,2023-06-05,02:34,1,0,1
47,2023-06-05T02:34:00+10:00,2023-06-05,02:34,2,0,2
1,2023-06-05T02:34:00+10:00,2023-06-05,02:34,1,0,1
35,2023-06-05T02:34:00+10:00,2023-06-05,02:34,1,0,1
4,2023-06-05T02:33:00+10:00,2023-06-05,02:33,0,1,1
1,2023-06-05T02:33:00+10:00,2023-06-05,02:33,0,4,4
62,2023-06-05T02:33:00+10:00,2023-06-05,02:33,1,3,4
55,2023-06-05T02:33:00+10:00,2023-06-05,02:33,2,0,2
35,2023-06-05T02:33:00+10:00,2023-06-05,02:33,1,1,2
67,2023-06-05T02:33:00+10:00,2023-06-05,02:33,0,1,1
72,2023-06-05T02:33:00+10:00,2023-06-05,02:33,3,0,3
5,2023-06-05T02:33:00+10:00,2023-06-05,02:33,0,1,1
45,2023-06-05T02:33:00+10:00,2023-06-05,02:33,1,2,3
54,2023-06-05T02:33:00+10:00,2023-06-05,02:33,1,0,1
108,2023-06-05T02:33:00+10:00,2023-06-05,02:33,0,1,1
2,2023-06-05T02:33:00+10:00,2023-06-05,02:33,1,0,1
108,2023-06-05T02:32:00+10:00,2023-06-05,02:32,0,1,1
2,2023-06-05T02:32:00+10:00,2023-06-05,02:32,0,1,1
12,2023-06-05T02:32:00+10:00,2023-06-05,02:32,0,1,1
35,2023-06-05T02:32:00+10:00,2023-06-05,02:32,2,0,2
56,2023-06-05T02:32:00+10:00,2023-06-05,02:32,2,0,2
67,2023-06-05T02:32:00+10:00,2023-06-05,02:32,1,1,2
4,2023-06-05T02:32:00+10:00,2023-06-05,02:32,1,0,1
5,2023-06-05T02:32:00+10:00,2023-06-05,02:32,0,1,1
26,2023-06-05T02:32:00+10:00,2023-06-05,02:32,0,2,2
23,2023-06-05T02:32:00+10:00,2023-06-05,02:32,1,0,1
30,2023-06-05T02:32:00+10:00,2023-06-05,02:32,0,1,1
3,2023-06-05T02:31:00+10:00,2023-06-05,02:31,1,0,1
5,2023-06-05T02:31:00+10:00,2023-06-05,02:31,0,1,1
26,2023-06-05T02:31:00+10:00,2023-06-05,02:31,0,2,2
87,2023-06-05T02:31:00+10:00,2023-06-05,02:31,2,0,2
20,2023-06-05T02:31:00+10:00,2023-06-05,02:31,1,0,1
24,2023-06-05T02:31:00+10:00,2023-06-05,02:31,1,0,1
52,2023-06-05T02:31:00+10:00,2023-06-05,02:31,0,3,3
56,2023-06-05T02:31:00+10:00,2023-06-05,02:31,1,0,1
55,2023-06-05T02:31:00+10:00,2023-06-05,02:31,2,0,2
11,2023-06-05T02:31:00+10:00,2023-06-05,02:31,1,0,1
49,2023-06-05T02:31:00+10:00,2023-06-05,02:31,0,1,1
51,2023-06-05T02:31:00+10:00,2023-06-05,02:31,0,1,1
35,2023-06-05T02:31:00+10:00,2023-06-05,02:31,2,2,4
14,2023-06-05T02:30:00+10:00,2023-06-05,02:30,1,0,1
54,2023-06-05T02:30:00+10:00,2023-06-05,02:30,1,0,1
62,2023-06-05T02:30:00+10:00,2023-06-05,02:30,1,1,2
5,2023-06-05T02:30:00+10:00,2023-06-05,02:30,0,2,2
84,2023-06-05T02:30:00+10:00,2023-06-05,02:30,0,3,3
107,2023-06-05T02:30:00+10:00,2023-06-05,02:30,1,0,1
11,2023-06-05T02:30:00+10:00,2023-06-05,02:30,1,1,2
30,2023-06-05T02:30:00+10:00,2023-06-05,02:30,0,2,2
109,2023-06-05T02:30:00+10:00,2023-06-05,02:30,0,2,2
28,2023-06-05T02:30:00+10:00,2023-06-05,02:30,1,0,1
1,2023-06-05T02:30:00+10:00,2023-06-05,02:30,0,1,1
35,2023-06-05T02:30:00+10:00,2023-06-05,02:30,2,1,3
28,2023-06-05T02:29:00+10:00,2023-06-05,02:29,1,0,1
41,2023-06-05T02:29:00+10:00,2023-06-05,02:29,3,0,3
108,2023-06-05T02:29:00+10:00,2023-06-05,02:29,1,0,1
29,2023-06-05T02:29:00+10:00,2023-06-05,02:29,1,0,1
54,2023-06-05T02:29:00+10:00,2023-06-05,02:29,0,2,2
55,2023-06-05T02:29:00+10:00,2023-06-05,02:29,0,1,1
1,2023-06-05T02:29:00+10:00,2023-06-05,02:29,1,0,1
24,2023-06-05T02:29:00+10:00,2023-06-05,02:29,1,0,1
26,2023-06-05T02:29:00+10:00,2023-06-05,02:29,0,1,1
40,2023-06-05T02:29:00+10:00,2023-06-05,02:29,0,1,1
58,2023-06-05T02:29:00+10:00,2023-06-05,02:29,0,2,2
41,2023-06-05T02:28:00+10:00,2023-06-05,02:28,0,3,3
3,2023-06-05T02:28:00+10:00,2023-06-05,02:28,0,1,1
37,2023-06-05T02:28:00+10:00,2023-06-05,02:28,0,3,3
55,2023-06-05T02:28:00+10:00,2023-06-05,02:28,2,2,4
12,2023-06-05T02:28:00+10:00,2023-06-05,02:28,1,0,1
19,2023-06-05T02:28:00+10:00,2023-06-05,02:28,1,0,1
20,2023-06-05T02:28:00+10:00,2023-06-05,02:28,3,0,3
30,2023-06-05T02:28:00+10:00,2023-06-05,02:28,0,2,2
79,2023-06-05T02:28:00+10:00,2023-06-05,02:28,1,0,1
24,2023-06-05T02:28:00+10:00,2023-06-05,02:28,2,1,3
62,2023-06-05T02:28:00+10:00,2023-06-05,02:28,2,1,3
72,2023-06-05T02:28:00+10:00,2023-06-05,02:28,1,2,3
41,2023-06-05T02:27:00+10:00,2023-06-05,02:27,2,0,2
55,2023-06-05T02:27:00+10:00,2023-06-05,02:27,1,0,1
24,2023-06-05T02:27:00+10:00,2023-06-05,02:27,0,2,2
30,2023-06-05T02:27:00+10:00,2023-06-05,02:27,0,3,3
56,2023-06-05T02:27:00+10:00,2023-06-05,02:27,3,0,3
5,2023-06-05T02:27:00+10:00,2023-06-05,02:27,0,2,2
4,2023-06-05T02:27:00+10:00,2023-06-05,02:27,0,1,1
21,2023-06-05T02:27:00+10:00,2023-06-05,02:27,0,1,1
71,2023-06-05T02:27:00+10:00,2023-06-05,02:27,0,3,3
11,2023-06-05T02:27:00+10:00,2023-06-05,02:27,1,0,1
20,2023-06-05T02:27:00+10:00,2023-06-05,02:27,0,1,1
5,2023-06-05T02:26:00+10:00,2023-06-05,02:26,0,1,1
58,2023-06-05T02:26:00+10:00,2023-06-05,02:26,1,0,1
79,2023-06-05T02:26:00+10:00,2023-06-05,02:26,1,0,1
49,2023-06-05T02:26:00+10:00,2023-06-05,02:26,0,2,2
4,2023-06-05T02:26:00+10:00,2023-06-05,02:26,0,1,1
26,2023-06-05T02:26:00+10:00,2023-06-05,02:26,1,0,1
65,2023-06-05T02:26:00+10:00,2023-06-05,02:26,0,1,1
1,2023-06-05T02:26:00+10:00,2023-06-05,02:26,0,3,3
20,2023-06-05T02:26:00+10:00,2023-06-05,02:26,1,0,1
55,2023-06-05T02:25:00+10:00,2023-06-05,02:25,0,3,3
57,2023-06-05T02:25:00+10:00,2023-06-05,02:25,1,0,1
4,2023-06-05T02:25:00+10:00,2023-06-05,02:25,1,0,1
19,2023-06-05T02:25:00+10:00,2023-06-05,02:25,3,0,3
3,2023-06-05T02:25:00+10:00,2023-06-05,02:25,0,1,1
5,2023-06-05T02:25:00+10:00,2023-06-05,02:25,1,0,1
84,2023-06-05T02:25:00+10:00,2023-06-05,02:25,0,1,1
107,2023-06-05T02:25:00+10:00,2023-06-05,02:25,1,1,2
26,2023-06-05T02:24:00+10:00,2023-06-05,02:24,0,2,2
47,2023-06-05T02:24:00+10:00,2023-06-05,02:24,0,2,2
108,2023-06-05T02:24:00+10:00,2023-06-05,02:24,1,0,1
2,2023-06-05T02:24:00+10:00,2023-06-05,02:24,0,2,2
30,2023-06-05T02:24:00+10:00,2023-06-05,02:24,2,3,5
3,2023-06-05T02:24:00+10:00,2023-06-05,02:24,4,0,4
65,2023-06-05T02:24:00+10:00,2023-06-05,02:24,1,0,1
62,2023-06-05T02:24:00+10:00,2023-06-05,02:24,1,0,1
45,2023-06-05T02:24:00+10:00,2023-06-05,02:24,0,1,1
55,2023-06-05T02:24:00+10:00,2023-06-05,02:24,1,2,3
72,2023-06-05T02:24:00+10:00,2023-06-05,02:24,0,1,1
79,2023-06-05T02:24:00+10:00,2023-06-05,02:24,1,0,1
3,2023-06-05T02:23:00+10:00,2023-06-05,02:23,0,1,1
5,2023-06-05T02:23:00+10:00,2023-06-05,02:23,0,2,2
47,2023-06-05T02:23:00+10:00,2023-06-05,02:23,2,1,3
72,2023-06-05T02:23:00+10:00,2023-06-05,02:23,1,6,7
6,2023-06-05T02:23:00+10:00,2023-06-05,02:23,1,0,1
28,2023-06-05T02:23:00+10:00,2023-06-05,02:23,1,1,2
66,2023-06-05T02:23:00+10:00,2023-06-05,02:23,1,0,1
19,2023-06-05T02:23:00+10:00,2023-06-05,02:23,1,0,1
35,2023-06-05T02:23:00+10:00,2023-06-05,02:23,0,1,1
49,2023-06-05T02:23:00+10:00,2023-06-05,02:23,0,1,1
79,2023-06-05T02:23:00+10:00,2023-06-05,02:23,1,0,1
3,2023-06-05T02:22:00+10:00,2023-06-05,02:22,0,3,3
35,2023-06-05T02:22:00+10:00,2023-06-05,02:22,0,1,1
26,2023-06-05T02:22:00+10:00,2023-06-05,02:22,1,0,1
31,2023-06-05T02:22:00+10:00,2023-06-05,02:22,1,0,1
5,2023-06-05T02:22:00+10:00,2023-06-05,02:22,0,1,1
37,2023-06-05T02:22:00+10:00,2023-06-05,02:22,1,0,1
1,2023-06-05T02:22:00+10:00,2023-06-05,02:22,0,1,1
2,2023-06-05T02:22:00+10:00,2023-06-05,02:22,0,2,2
30,2023-06-05T02:22:00+10:00,2023-06-05,02:22,2,0,2
50,2023-06-05T02:21:00+10:00,2023-06-05,02:21,0,1,1
54,2023-06-05T02:21:00+10:00,2023-06-05,02:21,0,1,1
66,2023-06-05T02:21:00+10:00,2023-06-05,02:21,1,0,1
24,2023-06-05T02:21:00+10:00,2023-06-05,02:21,2,0,2
26,2023-06-05T02:21:00+10:00,2023-06-05,02:21,1,0,1
108,2023-06-05T02:21:00+10:00,2023-06-05,02:21,0,2,2
30,2023-06-05T02:21:00+10:00,2023-06-05,02:21,0,1,1
4,2023-06-05T02:21:00+10:00,2023-06-05,02:21,1,0,1
6,2023-06-05T02:21:00+10:00,2023-06-05,02:21,0,1,1
31,2023-06-05T02:21:00+10:00,2023-06-05,02:21,2,1,3
41,2023-06-05T02:21:00+10:00,2023-06-05,02:21,1,0,1
55,2023-06-05T02:21:00+10:00,2023-06-05,02:21,2,0,2
49,2023-06-05T02:21:00+10:00,2023-06-05,02:21,0,1,1
79,2023-06-05T02:21:00+10:00,2023-06-05,02:21,1,0,1
21,2023-06-05T02:20:00+10:00,2023-06-05,02:20,0,2,2
6,2023-06-05T02:20:00+10:00,2023-06-05,02:20,0,2,2
84,2023-06-05T02:20:00+10:00,2023-06-05,02:20,0,4,4
35,2023-06-05T02:20:00+10:00,2023-06-05,02:20,1,0,1
49,2023-06-05T02:20:00+10:00,2023-06-05,02:20,0,1,1
56,2023-06-05T02:20:00+10:00,2023-06-05,02:20,1,0,1
79,2023-06-05T02:20:00+10:00,2023-06-05,02:20,0,4,4
3,2023-06-05T02:20:00+10:00,2023-06-05,02:20,0,1,1
26,2023-06-05T02:20:00+10:00,2023-06-05,02:20,0,3,3
28,2023-06-05T02:20:00+10:00,2023-06-05,02:20,0,1,1
47,2023-06-05T02:20:00+10:00,2023-06-05,02:20,1,0,1
55,2023-06-05T02:20:00+10:00,2023-06-05,02:20,0,2,2
108,2023-06-05T02:19:00+10:00,2023-06-05,02:19,3,0,3
3,2023-06-05T02:19:00+10:00,2023-06-05,02:19,1,0,1
29,2023-06-05T02:19:00+10:00,2023-06-05,02:19,0,1,1
11,2023-06-05T02:19:00+10:00,2023-06-05,02:19,0,1,1
30,2023-06-05T02:19:00+10:00,2023-06-05,02:19,0,1,1
51,2023-06-05T02:19:00+10:00,2023-06-05,02:19,2,0,2
5,2023-06-05T02:19:00+10:00,2023-06-05,02:19,1,0,1
21,2023-06-05T02:18:00+10:00,2023-06-05,02:18,1,1,2
47,2023-06-05T02:18:00+10:00,2023-06-05,02:18,2,0,2
55,2023-06-05T02:18:00+10:00,2023-06-05,02:18,0,3,3
6,2023-06-05T02:18:00+10:00,2023-06-05,02:18,1,0,1
30,2023-06-05T02:18:00+10:00,2023-06-05,02:18,1,0,1
48,2023-06-05T02:18:00+10:00,2023-06-05,02:18,1,0,1
26,2023-06-05T02:18:00+10:00,2023-06-05,02:18,0,1,1
58,2023-06-05T02:18:00+10:00,2023-06-05,02:18,0,1,1
62,2023-06-05T02:18:00+10:00,2023-06-05,02:18,1,0,1
55,2023-06-05T02:17:00+10:00,2023-06-05,02:17,2,0,2
66,2023-06-05T02:17:00+10:00,2023-06-05,02:17,2,0,2
52,2023-06-05T02:17:00+10:00,2023-06-05,02:17,1,2,3
58,2023-06-05T02:17:00+10:00,2023-06-05,02:17,0,4,4
62,2023-06-05T02:17:00+10:00,2023-06-05,02:17,2,2,4
30,2023-06-05T02:17:00+10:00,2023-06-05,02:17,5,1,6
35,2023-06-05T02:17:00+10:00,2023-06-05,02:17,0,1,1
5,2023-06-05T02:17:00+10:00,2023-06-05,02:17,4,1,5
28,2023-06-05T02:17:00+10:00,2023-06-05,02:17,1,0,1
75,2023-06-05T02:17:00+10:00,2023-06-05,02:17,1,0,1
1,2023-06-05T02:17:00+10:00,2023-06-05,02:17,0,3,3
17,2023-06-05T02:17:00+10:00,2023-06-05,02:17,1,0,1
56,2023-06-05T02:17:00+10:00,2023-06-05,02:17,0,2,2
79,2023-06-05T02:17:00+10:00,2023-06-05,02:17,0,2,2
55,2023-06-05T02:16:00+10:00,2023-06-05,02:16,2,0,2
62,2023-06-05T02:16:00+10:00,2023-06-05,02:16,1,0,1
3,2023-06-05T02:16:00+10:00,2023-06-05,02:16,2,2,4
36,2023-06-05T02:16:00+10:00,2023-06-05,02:16,1,0,1
26,2023-06-05T02:16:00+10:00,2023-06-05,02:16,0,1,1
37,2023-06-05T02:16:00+10:00,2023-06-05,02:16,0,3,3
41,2023-06-05T02:16:00+10:00,2023-06-05,02:16,2,0,2
47,2023-06-05T02:16:00+10:00,2023-06-05,02:16,0,1,1
26,2023-06-05T02:15:00+10:00,2023-06-05,02:15,0,1,1
84,2023-06-05T02:15:00+10:00,2023-06-05,02:15,2,2,4
3,2023-06-05T02:15:00+10:00,2023-06-05,02:15,0,2,2
41,2023-06-05T02:15:00+10:00,2023-06-05,02:15,0,6,6
55,2023-06-05T02:15:00+10:00,2023-06-05,02:15,0,1,1
2,2023-06-05T02:15:00+10:00,2023-06-05,02:15,1,0,1
19,2023-06-05T02:15:00+10:00,2023-06-05,02:15,1,0,1
20,2023-06-05T02:15:00+10:00,2023-06-05,02:15,0,2,2
6,2023-06-05T02:15:00+10:00,2023-06-05,02:15,0,1,1
35,2023-06-05T02:15:00+10:00,2023-06-05,02:15,0,2,2
49,2023-06-05T02:15:00+10:00,2023-06-05,02:15,1,0,1
51,2023-06-05T02:15:00+10:00,2023-06-05,02:15,0,1,1
26,2023-06-05T02:14:00+10:00,2023-06-05,02:14,0,1,1
71,2023-06-05T02:14:00+10:00,2023-06-05,02:14,0,1,1
35,2023-06-05T02:14:00+10:00,2023-06-05,02:14,0,1,1
49,2023-06-05T02:14:00+10:00,2023-06-05,02:14,2,1,3
3,2023-06-05T02:14:00+10:00,2023-06-05,02:14,0,9,9
5,2023-06-05T02:14:00+10:00,2023-06-05,02:14,2,0,2
108,2023-06-05T02:14:00+10:00,2023-06-05,02:14,2,0,2
21,2023-06-05T02:13:00+10:00,2023-06-05,02:13,0,2,2
58,2023-06-05T02:13:00+10:00,2023-06-05,02:13,0,2,2
26,2023-06-05T02:13:00+10:00,2023-06-05,02:13,0,1,1
19,2023-06-05T02:13:00+10:00,2023-06-05,02:13,2,0,2
62,2023-06-05T02:13:00+10:00,2023-06-05,02:13,1,1,2
3,2023-06-05T02:13:00+10:00,2023-06-05,02:13,1,1,2
47,2023-06-05T02:13:00+10:00,2023-06-05,02:13,0,4,4
27,2023-06-05T02:13:00+10:00,2023-06-05,02:13,2,0,2
57,2023-06-05T02:13:00+10:00,2023-06-05,02:13,0,1,1
47,2023-06-05T02:12:00+10:00,2023-06-05,02:12,0,1,1
1,2023-06-05T02:12:00+10:00,2023-06-05,02:12,1,0,1
26,2023-06-05T02:12:00+10:00,2023-06-05,02:12,0,1,1
55,2023-06-05T02:12:00+10:00,2023-06-05,02:12,2,1,3
65,2023-06-05T02:12:00+10:00,2023-06-05,02:12,0,2,2
48,2023-06-05T02:12:00+10:00,2023-06-05,02:12,1,0,1
3,2023-06-05T02:12:00+10:00,2023-06-05,02:12,1,0,1
41,2023-06-05T02:12:00+10:00,2023-06-05,02:12,1,4,5
61,2023-06-05T02:12:00+10:00,2023-06-05,02:12,1,0,1
58,2023-06-05T02:12:00+10:00,2023-06-05,02:12,0,2,2
62,2023-06-05T02:12:00+10:00,2023-06-05,02:12,2,0,2
79,2023-06-05T02:12:00+10:00,2023-06-05,02:12,0,1,1
21,2023-06-05T02:11:00+10:00,2023-06-05,02:11,0,1,1
36,2023-06-05T02:11:00+10:00,2023-06-05,02:11,1,0,1
67,2023-06-05T02:11:00+10:00,2023-06-05,02:11,0,2,2
26,2023-06-05T02:11:00+10:00,2023-06-05,02:11,1,2,3
31,2023-06-05T02:11:00+10:00,2023-06-05,02:11,1,0,1
45,2023-06-05T02:11:00+10:00,2023-06-05,02:11,0,1,1
48,2023-06-05T02:11:00+10:00,2023-06-05,02:11,0,1,1
49,2023-06-05T02:11:00+10:00,2023-06-05,02:11,0,2,2
62,2023-06-05T02:11:00+10:00,2023-06-05,02:11,2,1,3
3,2023-06-05T02:11:00+10:00,2023-06-05,02:11,2,0,2
29,2023-06-05T02:11:00+10:00,2023-06-05,02:11,0,3,3
55,2023-06-05T02:11:00+10:00,2023-06-05,02:11,0,1,1
20,2023-06-05T02:11:00+10:00,2023-06-05,02:11,1,0,1
24,2023-06-05T02:11:00+10:00,2023-06-05,02:11,2,0,2
3,2023-06-05T02:10:00+10:00,2023-06-05,02:10,2,1,3
6,2023-06-05T02:10:00+10:00,2023-06-05,02:10,1,0,1
65,2023-06-05T02:10:00+10:00,2023-06-05,02:10,0,1,1
48,2023-06-05T02:10:00+10:00,2023-06-05,02:10,0,1,1
49,2023-06-05T02:10:00+10:00,2023-06-05,02:10,2,0,2
56,2023-06-05T02:10:00+10:00,2023-06-05,02:10,2,0,2
30,2023-06-05T02:10:00+10:00,2023-06-05,02:10,0,1,1
58,2023-06-05T02:10:00+10:00,2023-06-05,02:10,2,0,2
62,2023-06-05T02:10:00+10:00,2023-06-05,02:10,0,1,1
4,2023-06-05T02:10:00+10:00,2023-06-05,02:10,0,1,1
5,2023-06-05T02:10:00+10:00,2023-06-05,02:10,1,2,3
26,2023-06-05T02:10:00+10:00,2023-06-05,02:10,1,0,1
61,2023-06-05T02:10:00+10:00,2023-06-05,02:10,0,1,1
84,2023-06-05T02:10:00+10:00,2023-06-05,02:10,2,3,5
2,2023-06-05T02:10:00+10:00,2023-06-05,02:10,0,4,4
19,2023-06-05T02:10:00+10:00,2023-06-05,02:10,2,0,2
20,2023-06-05T02:10:00+10:00,2023-06-05,02:10,0,3,3
52,2023-06-05T02:10:00+10:00,2023-06-05,02:10,0,4,4
79,2023-06-05T02:10:00+10:00,2023-06-05,02:10,0,1,1
109,2023-06-05T02:10:00+10:00,2023-06-05,02:10,0,1,1
3,2023-06-05T02:09:00+10:00,2023-06-05,02:09,0,1,1
26,2023-06-05T02:09:00+10:00,2023-06-05,02:09,1,1,2
19,2023-06-05T02:09:00+10:00,2023-06-05,02:09,2,0,2
62,2023-06-05T02:09:00+10:00,2023-06-05,02:09,1,0,1
5,2023-06-05T02:09:00+10:00,2023-06-05,02:09,1,1,2
41,2023-06-05T02:09:00+10:00,2023-06-05,02:09,3,0,3
45,2023-06-05T02:09:00+10:00,2023-06-05,02:09,0,1,1
55,2023-06-05T02:09:00+10:00,2023-06-05,02:09,0,1,1
30,2023-06-05T02:09:00+10:00,2023-06-05,02:09,0,3,3
5,2023-06-05T02:08:00+10:00,2023-06-05,02:08,2,0,2
28,2023-06-05T02:08:00+10:00,2023-06-05,02:08,0,1,1
30,2023-06-05T02:08:00+10:00,2023-06-05,02:08,0,2,2
79,2023-06-05T02:08:00+10:00,2023-06-05,02:08,0,1,1
4,2023-06-05T02:08:00+10:00,2023-06-05,02:08,0,4,4
66,2023-06-05T02:08:00+10:00,2023-06-05,02:08,1,0,1
24,2023-06-05T02:08:00+10:00,2023-06-05,02:08,0,5,5
45,2023-06-05T02:08:00+10:00,2023-06-05,02:08,2,0,2
55,2023-06-05T02:08:00+10:00,2023-06-05,02:08,0,4,4
21,2023-06-05T02:07:00+10:00,2023-06-05,02:07,0,1,1
55,2023-06-05T02:07:00+10:00,2023-06-05,02:07,2,2,4
9,2023-06-05T02:07:00+10:00,2023-06-05,02:07,1,1,2
62,2023-06-05T02:07:00+10:00,2023-06-05,02:07,0,2,2
4,2023-06-05T02:07:00+10:00,2023-06-05,02:07,2,0,2
28,2023-06-05T02:07:00+10:00,2023-06-05,02:07,0,1,1
108,2023-06-05T02:07:00+10:00,2023-06-05,02:07,1,0,1
24,2023-06-05T02:07:00+10:00,2023-06-05,02:07,1,0,1
35,2023-06-05T02:07:00+10:00,2023-06-05,02:07,1,0,1
72,2023-06-05T02:07:00+10:00,2023-06-05,02:07,1,0,1
3,2023-06-05T02:07:00+10:00,2023-06-05,02:07,2,0,2
14,2023-06-05T02:07:00+10:00,2023-06-05,02:07,0,1,1
26,2023-06-05T02:07:00+10:00,2023-06-05,02:07,1,0,1
47,2023-06-05T02:07:00+10:00,2023-06-05,02:07,0,1,1
54,2023-06-05T02:07:00+10:00,2023-06-05,02:07,1,1,2
65,2023-06-05T02:07:00+10:00,2023-06-05,02:07,0,3,3
78,2023-06-05T02:07:00+10:00,2023-06-05,02:07,2,0,2
19,2023-06-05T02:07:00+10:00,2023-06-05,02:07,3,1,4
49,2023-06-05T02:07:00+10:00,2023-06-05,02:07,0,2,2
5,2023-06-05T02:06:00+10:00,2023-06-05,02:06,1,1,2
26,2023-06-05T02:06:00+10:00,2023-06-05,02:06,0,2,2
47,2023-06-05T02:06:00+10:00,2023-06-05,02:06,0,1,1
66,2023-06-05T02:06:00+10:00,2023-06-05,02:06,0,1,1
55,2023-06-05T02:06:00+10:00,2023-06-05,02:06,1,2,3
77,2023-06-05T02:06:00+10:00,2023-06-05,02:06,2,0,2
30,2023-06-05T02:06:00+10:00,2023-06-05,02:06,0,1,1
3,2023-06-05T02:06:00+10:00,2023-06-05,02:06,1,2,3
49,2023-06-05T02:06:00+10:00,2023-06-05,02:06,0,3,3
72,2023-06-05T02:06:00+10:00,2023-06-05,02:06,3,0,3
79,2023-06-05T02:06:00+10:00,2023-06-05,02:06,1,0,1
3,2023-06-05T02:05:00+10:00,2023-06-05,02:05,5,0,5
45,2023-06-05T02:05:00+10:00,2023-06-05,02:05,0,3,3
30,2023-06-05T02:05:00+10:00,2023-06-05,02:05,1,2,3
49,2023-06-05T02:05:00+10:00,2023-06-05,02:05,0,2,2
47,2023-06-05T02:05:00+10:00,2023-06-05,02:05,1,1,2
107,2023-06-05T02:05:00+10:00,2023-06-05,02:05,3,0,3
12,2023-06-05T02:05:00+10:00,2023-06-05,02:05,1,0,1
19,2023-06-05T02:05:00+10:00,2023-06-05,02:05,1,2,3
24,2023-06-05T02:05:00+10:00,2023-06-05,02:05,2,3,5
26,2023-06-05T02:05:00+10:00,2023-06-05,02:05,0,2,2
55,2023-06-05T02:05:00+10:00,2023-06-05,02:05,2,2,4
59,2023-06-05T02:05:00+10:00,2023-06-05,02:05,0,6,6
84,2023-06-05T02:05:00+10:00,2023-06-05,02:05,0,1,1
58,2023-06-05T02:05:00+10:00,2023-06-05,02:05,0,2,2
4,2023-06-05T02:04:00+10:00,2023-06-05,02:04,2,0,2
5,2023-06-05T02:04:00+10:00,2023-06-05,02:04,0,1,1
37,2023-06-05T02:04:00+10:00,2023-06-05,02:04,4,0,4
65,2023-06-05T02:04:00+10:00,2023-06-05,02:04,0,1,1
1,2023-06-05T02:04:00+10:00,2023-06-05,02:04,0,1,1
47,2023-06-05T02:04:00+10:00,2023-06-05,02:04,0,1,1
51,2023-06-05T02:04:00+10:00,2023-06-05,02:04,1,1,2
26,2023-06-05T02:04:00+10:00,2023-06-05,02:04,1,0,1
55,2023-06-05T02:04:00+10:00,2023-06-05,02:04,1,1,2
24,2023-06-05T02:04:00+10:00,2023-06-05,02:04,1,0,1
11,2023-06-05T02:03:00+10:00,2023-06-05,02:03,1,0,1
3,2023-06-05T02:03:00+10:00,2023-06-05,02:03,0,1,1
4,2023-06-05T02:03:00+10:00,2023-06-05,02:03,0,1,1
5,2023-06-05T02:03:00+10:00,2023-06-05,02:03,1,0,1
6,2023-06-05T02:03:00+10:00,2023-06-05,02:03,0,1,1
55,2023-06-05T02:03:00+10:00,2023-06-05,02:03,2,0,2
66,2023-06-05T02:03:00+10:00,2023-06-05,02:03,1,0,1
62,2023-06-05T02:03:00+10:00,2023-06-05,02:03,1,1,2
41,2023-06-05T02:02:00+10:00,2023-06-05,02:02,2,0,2
70,2023-06-05T02:02:00+10:00,2023-06-05,02:02,0,1,1
20,2023-06-05T02:02:00+10:00,2023-06-05,02:02,3,0,3
54,2023-06-05T02:02:00+10:00,2023-06-05,02:02,1,0,1
55,2023-06-05T02:02:00+10:00,2023-06-05,02:02,1,0,1
35,2023-06-05T02:02:00+10:00,2023-06-05,02:02,1,0,1
48,2023-06-05T02:02:00+10:00,2023-06-05,02:02,0,3,3
49,2023-06-05T02:02:00+10:00,2023-06-05,02:02,2,0,2
51,2023-06-05T02:02:00+10:00,2023-06-05,02:02,2,0,2
3,2023-06-05T02:02:00+10:00,2023-06-05,02:02,2,3,5
21,2023-06-05T02:02:00+10:00,2023-06-05,02:02,1,0,1
26,2023-06-05T02:02:00+10:00,2023-06-05,02:02,0,1,1
37,2023-06-05T02:02:00+10:00,2023-06-05,02:02,3,0,3
47,2023-06-05T02:02:00+10:00,2023-06-05,02:02,5,0,5
30,2023-06-05T02:02:00+10:00,2023-06-05,02:02,0,1,1
26,2023-06-05T02:01:00+10:00,2023-06-05,02:01,2,2,4
36,2023-06-05T02:01:00+10:00,2023-06-05,02:01,1,0,1
2,2023-06-05T02:01:00+10:00,2023-06-05,02:01,1,0,1
62,2023-06-05T02:01:00+10:00,2023-06-05,02:01,1,0,1
79,2023-06-05T02:01:00+10:00,2023-06-05,02:01,1,0,1
41,2023-06-05T02:01:00+10:00,2023-06-05,02:01,0,4,4
54,2023-06-05T02:01:00+10:00,2023-06-05,02:01,1,2,3
30,2023-06-05T02:01:00+10:00,2023-06-05,02:01,0,4,4
49,2023-06-05T02:01:00+10:00,2023-06-05,02:01,0,1,1
55,2023-06-05T02:01:00+10:00,2023-06-05,02:01,1,1,2
24,2023-06-05T02:01:00+10:00,2023-06-05,02:01,2,0,2
85,2023-06-05T02:01:00+10:00,2023-06-05,02:01,1,0,1
55,2023-06-05T02:00:00+10:00,2023-06-05,02:00,4,8,12
59,2023-06-05T02:00:00+10:00,2023-06-05,02:00,1,2,3
107,2023-06-05T02:00:00+10:00,2023-06-05,02:00,0,1,1
108,2023-06-05T02:00:00+10:00,2023-06-05,02:00,0,1,1
62,2023-06-05T02:00:00+10:00,2023-06-05,02:00,2,0,2
3,2023-06-05T02:00:00+10:00,2023-06-05,02:00,1,0,1
84,2023-06-05T02:00:00+10:00,2023-06-05,02:00,1,2,3
1,2023-06-05T02:00:00+10:00,2023-06-05,02:00,2,0,2
109,2023-06-05T02:00:00+10:00,2023-06-05,02:00,0,2,2
28,2023-06-05T02:00:00+10:00,2023-06-05,02:00,0,1,1
54,2023-06-05T02:00:00+10:00,2023-06-05,02:00,1,0,1
2,2023-06-05T02:00:00+10:00,2023-06-05,02:00,0,1,1
10,2023-06-05T02:00:00+10:00,2023-06-05,02:00,1,0,1
48,2023-06-05T02:00:00+10:00,2023-06-05,02:00,0,1,1
51,2023-06-05T02:00:00+10:00,2023-06-05,02:00,0,2,2
86,2023-06-05T02:00:00+10:00,2023-06-05,02:00,0,2,2
117,2023-06-05T02:00:00+10:00,2023-06-05,02:00,0,1,1
3,2023-06-05T01:59:00+10:00,2023-06-05,01:59,1,0,1
69,2023-06-05T01:59:00+10:00,2023-06-05,01:59,1,0,1
27,2023-06-05T01:59:00+10:00,2023-06-05,01:59,1,0,1
46,2023-06-05T01:59:00+10:00,2023-06-05,01:59,1,0,1
49,2023-06-05T01:59:00+10:00,2023-06-05,01:59,2,0,2
72,2023-06-05T01:59:00+10:00,2023-06-05,01:59,0,5,5
42,2023-06-05T01:59:00+10:00,2023-06-05,01:59,1,0,1
55,2023-06-05T01:59:00+10:00,2023-06-05,01:59,1,1,2
26,2023-06-05T01:59:00+10:00,2023-06-05,01:59,3,0,3
24,2023-06-05T01:59:00+10:00,2023-06-05,01:59,0,1,1
51,2023-06-05T01:59:00+10:00,2023-06-05,01:59,1,0,1
108,2023-06-05T01:58:00+10:00,2023-06-05,01:58,0,2,2
12,2023-06-05T01:58:00+10:00,2023-06-05,01:58,0,1,1
30,2023-06-05T01:58:00+10:00,2023-06-05,01:58,1,2,3
3,2023-06-05T01:58:00+10:00,2023-06-05,01:58,0,1,1
5,2023-06-05T01:58:00+10:00,2023-06-05,01:58,1,0,1
45,2023-06-05T01:58:00+10:00,2023-06-05,01:58,0,2,2
54,2023-06-05T01:58:00+10:00,2023-06-05,01:58,0,2,2
66,2023-06-05T01:58:00+10:00,2023-06-05,01:58,0,2,2
23,2023-06-05T01:58:00+10:00,2023-06-05,01:58,1,1,2
72,2023-06-05T01:58:00+10:00,2023-06-05,01:58,7,1,8
26,2023-06-05T01:58:00+10:00,2023-06-05,01:58,0,2,2
24,2023-06-05T01:58:00+10:00,2023-06-05,01:58,1,0,1
35,2023-06-05T01:58:00+10:00,2023-06-05,01:58,0,2,2
47,2023-06-05T01:57:00+10:00,2023-06-05,01:57,2,0,2
24,2023-06-05T01:57:00+10:00,2023-06-05,01:57,0,1,1
55,2023-06-05T01:57:00+10:00,2023-06-05,01:57,1,2,3
5,2023-06-05T01:57:00+10:00,2023-06-05,01:57,1,1,2
21,2023-06-05T01:57:00+10:00,2023-06-05,01:57,0,3,3
26,2023-06-05T01:57:00+10:00,2023-06-05,01:57,1,0,1
28,2023-06-05T01:57:00+10:00,2023-06-05,01:57,1,0,1
61,2023-06-05T01:57:00+10:00,2023-06-05,01:57,2,0,2
1,2023-06-05T01:57:00+10:00,2023-06-05,01:57,2,0,2
9,2023-06-05T01:57:00+10:00,2023-06-05,01:57,0,1,1
72,2023-06-05T01:57:00+10:00,2023-06-05,01:57,0,2,2
41,2023-06-05T01:56:00+10:00,2023-06-05,01:56,0,2,2
55,2023-06-05T01:56:00+10:00,2023-06-05,01:56,1,0,1
65,2023-06-05T01:56:00+10:00,2023-06-05,01:56,1,0,1
20,2023-06-05T01:56:00+10:00,2023-06-05,01:56,1,0,1
30,2023-06-05T01:56:00+10:00,2023-06-05,01:56,0,4,4
46,2023-06-05T01:56:00+10:00,2023-06-05,01:56,2,0,2
61,2023-06-05T01:56:00+10:00,2023-06-05,01:56,0,2,2
66,2023-06-05T01:56:00+10:00,2023-06-05,01:56,2,0,2
1,2023-06-05T01:56:00+10:00,2023-06-05,01:56,0,1,1
2,2023-06-05T01:56:00+10:00,2023-06-05,01:56,0,3,3
9,2023-06-05T01:56:00+10:00,2023-06-05,01:56,0,1,1
62,2023-06-05T01:56:00+10:00,2023-06-05,01:56,1,0,1
68,2023-06-05T01:56:00+10:00,2023-06-05,01:56,1,1,2
3,2023-06-05T01:56:00+10:00,2023-06-05,01:56,0,1,1
26,2023-06-05T01:56:00+10:00,2023-06-05,01:56,3,1,4
48,2023-06-05T01:56:00+10:00,2023-06-05,01:56,3,0,3
52,2023-06-05T01:56:00+10:00,2023-06-05,01:56,2,0,2
6,2023-06-05T01:55:00+10:00,2023-06-05,01:55,1,0,1
28,2023-06-05T01:55:00+10:00,2023-06-05,01:55,0,1,1
42,2023-06-05T01:55:00+10:00,2023-06-05,01:55,0,3,3
59,2023-06-05T01:55:00+10:00,2023-06-05,01:55,4,1,5
84,2023-06-05T01:55:00+10:00,2023-06-05,01:55,3,2,5
107,2023-06-05T01:55:00+10:00,2023-06-05,01:55,1,1,2
4,2023-06-05T01:55:00+10:00,2023-06-05,01:55,3,0,3
40,2023-06-05T01:55:00+10:00,2023-06-05,01:55,1,0,1
61,2023-06-05T01:55:00+10:00,2023-06-05,01:55,0,1,1
66,2023-06-05T01:55:00+10:00,2023-06-05,01:55,1,0,1
77,2023-06-05T01:55:00+10:00,2023-06-05,01:55,1,0,1
62,2023-06-05T01:55:00+10:00,2023-06-05,01:55,2,1,3
45,2023-06-05T01:55:00+10:00,2023-06-05,01:55,0,1,1
17,2023-06-05T01:55:00+10:00,2023-06-05,01:55,1,0,1
30,2023-06-05T01:55:00+10:00,2023-06-05,01:55,2,0,2
49,2023-06-05T01:55:00+10:00,2023-06-05,01:55,1,0,1
58,2023-06-05T01:55:00+10:00,2023-06-05,01:55,1,0,1
109,2023-06-05T01:55:00+10:00,2023-06-05,01:55,0,1,1
50,2023-06-05T01:54:00+10:00,2023-06-05,01:54,1,1,2
62,2023-06-05T01:54:00+10:00,2023-06-05,01:54,1,0,1
5,2023-06-05T01:54:00+10:00,2023-06-05,01:54,0,1,1
21,2023-06-05T01:54:00+10:00,2023-06-05,01:54,0,1,1
47,2023-06-05T01:54:00+10:00,2023-06-05,01:54,0,2,2
66,2023-06-05T01:54:00+10:00,2023-06-05,01:54,2,0,2
39,2023-06-05T01:54:00+10:00,2023-06-05,01:54,1,0,1
55,2023-06-05T01:54:00+10:00,2023-06-05,01:54,0,2,2
27,2023-06-05T01:54:00+10:00,2023-06-05,01:54,1,0,1
53,2023-06-05T01:54:00+10:00,2023-06-05,01:54,0,6,6
3,2023-06-05T01:53:00+10:00,2023-06-05,01:53,0,1,1
26,2023-06-05T01:53:00+10:00,2023-06-05,01:53,0,1,1
42,2023-06-05T01:53:00+10:00,2023-06-05,01:53,0,1,1
30,2023-06-05T01:53:00+10:00,2023-06-05,01:53,0,1,1
6,2023-06-05T01:53:00+10:00,2023-06-05,01:53,1,1,2
55,2023-06-05T01:53:00+10:00,2023-06-05,01:53,6,0,6
51,2023-06-05T01:53:00+10:00,2023-06-05,01:53,0,1,1
41,2023-06-05T01:53:00+10:00,2023-06-05,01:53,1,0,1
47,2023-06-05T01:53:00+10:00,2023-06-05,01:53,0,2,2
24,2023-06-05T01:53:00+10:00,2023-06-05,01:53,0,2,2
45,2023-06-05T01:52:00+10:00,2023-06-05,01:52,1,0,1
30,2023-06-05T01:52:00+10:00,2023-06-05,01:52,1,0,1
68,2023-06-05T01:52:00+10:00,2023-06-05,01:52,1,1,2
6,2023-06-05T01:52:00+10:00,2023-06-05,01:52,1,1,2
21,2023-06-05T01:52:00+10:00,2023-06-05,01:52,0,1,1
47,2023-06-05T01:52:00+10:00,2023-06-05,01:52,0,1,1
3,2023-06-05T01:52:00+10:00,2023-06-05,01:52,2,3,5
55,2023-06-05T01:52:00+10:00,2023-06-05,01:52,0,1,1
65,2023-06-05T01:52:00+10:00,2023-06-05,01:52,0,2,2
12,2023-06-05T01:52:00+10:00,2023-06-05,01:52,0,3,3
62,2023-06-05T01:52:00+10:00,2023-06-05,01:52,1,1,2
79,2023-06-05T01:52:00+10:00,2023-06-05,01:52,1,0,1
6,2023-06-05T01:51:00+10:00,2023-06-05,01:51,1,0,1
54,2023-06-05T01:51:00+10:00,2023-06-05,01:51,1,2,3
62,2023-06-05T01:51:00+10:00,2023-06-05,01:51,1,0,1
4,2023-06-05T01:51:00+10:00,2023-06-05,01:51,1,0,1
55,2023-06-05T01:51:00+10:00,2023-06-05,01:51,0,3,3
66,2023-06-05T01:51:00+10:00,2023-06-05,01:51,2,0,2
1,2023-06-05T01:51:00+10:00,2023-06-05,01:51,0,1,1
35,2023-06-05T01:51:00+10:00,2023-06-05,01:51,2,1,3
46,2023-06-05T01:51:00+10:00,2023-06-05,01:51,0,1,1
51,2023-06-05T01:51:00+10:00,2023-06-05,01:51,1,1,2
72,2023-06-05T01:51:00+10:00,2023-06-05,01:51,1,1,2
3,2023-06-05T01:51:00+10:00,2023-06-05,01:51,1,0,1
49,2023-06-05T01:51:00+10:00,2023-06-05,01:51,2,2,4
3,2023-06-05T01:50:00+10:00,2023-06-05,01:50,8,1,9
47,2023-06-05T01:50:00+10:00,2023-06-05,01:50,2,0,2
55,2023-06-05T01:50:00+10:00,2023-06-05,01:50,0,2,2
66,2023-06-05T01:50:00+10:00,2023-06-05,01:50,3,0,3
77,2023-06-05T01:50:00+10:00,2023-06-05,01:50,2,0,2
107,2023-06-05T01:50:00+10:00,2023-06-05,01:50,1,0,1
30,2023-06-05T01:50:00+10:00,2023-06-05,01:50,6,2,8
51,2023-06-05T01:50:00+10:00,2023-06-05,01:50,0,1,1
117,2023-06-05T01:50:00+10:00,2023-06-05,01:50,0,2,2
54,2023-06-05T01:50:00+10:00,2023-06-05,01:50,1,0,1
59,2023-06-05T01:50:00+10:00,2023-06-05,01:50,4,1,5
11,2023-06-05T01:50:00+10:00,2023-06-05,01:50,0,2,2
62,2023-06-05T01:50:00+10:00,2023-06-05,01:50,2,1,3
84,2023-06-05T01:50:00+10:00,2023-06-05,01:50,2,1,3
19,2023-06-05T01:50:00+10:00,2023-06-05,01:50,1,0,1
49,2023-06-05T01:50:00+10:00,2023-06-05,01:50,2,3,5
3,2023-06-05T01:49:00+10:00,2023-06-05,01:49,1,6,7
5,2023-06-05T01:49:00+10:00,2023-06-05,01:49,0,1,1
6,2023-06-05T01:49:00+10:00,2023-06-05,01:49,1,1,2
26,2023-06-05T01:49:00+10:00,2023-06-05,01:49,0,2,2
45,2023-06-05T01:49:00+10:00,2023-06-05,01:49,1,0,1
47,2023-06-05T01:49:00+10:00,2023-06-05,01:49,0,3,3
54,2023-06-05T01:49:00+10:00,2023-06-05,01:49,2,0,2
1,2023-06-05T01:49:00+10:00,2023-06-05,01:49,0,1,1
35,2023-06-05T01:49:00+10:00,2023-06-05,01:49,1,0,1
14,2023-06-05T01:49:00+10:00,2023-06-05,01:49,1,0,1
42,2023-06-05T01:49:00+10:00,2023-06-05,01:49,1,0,1
55,2023-06-05T01:49:00+10:00,2023-06-05,01:49,0,1,1
69,2023-06-05T01:49:00+10:00,2023-06-05,01:49,1,1,2
77,2023-06-05T01:49:00+10:00,2023-06-05,01:49,1,0,1
30,2023-06-05T01:49:00+10:00,2023-06-05,01:49,0,4,4
49,2023-06-05T01:49:00+10:00,2023-06-05,01:49,1,0,1
53,2023-06-05T01:49:00+10:00,2023-06-05,01:49,1,0,1
5,2023-06-05T01:48:00+10:00,2023-06-05,01:48,0,1,1
69,2023-06-05T01:48:00+10:00,2023-06-05,01:48,1,1,2
1,2023-06-05T01:48:00+10:00,2023-06-05,01:48,1,0,1
26,2023-06-05T01:48:00+10:00,2023-06-05,01:48,1,0,1
47,2023-06-05T01:48:00+10:00,2023-06-05,01:48,1,0,1
65,2023-06-05T01:48:00+10:00,2023-06-05,01:48,3,0,3
30,2023-06-05T01:48:00+10:00,2023-06-05,01:48,0,1,1
49,2023-06-05T01:48:00+10:00,2023-06-05,01:48,1,1,2
58,2023-06-05T01:48:00+10:00,2023-06-05,01:48,1,0,1
62,2023-06-05T01:48:00+10:00,2023-06-05,01:48,1,1,2
3,2023-06-05T01:48:00+10:00,2023-06-05,01:48,2,2,4
14,2023-06-05T01:48:00+10:00,2023-06-05,01:48,0,1,1
37,2023-06-05T01:48:00+10:00,2023-06-05,01:48,0,2,2
41,2023-06-05T01:48:00+10:00,2023-06-05,01:48,1,0,1
45,2023-06-05T01:48:00+10:00,2023-06-05,01:48,0,6,6
66,2023-06-05T01:48:00+10:00,2023-06-05,01:48,0,2,2
71,2023-06-05T01:48:00+10:00,2023-06-05,01:48,0,1,1
35,2023-06-05T01:48:00+10:00,2023-06-05,01:48,2,1,3
4,2023-06-05T01:47:00+10:00,2023-06-05,01:47,0,1,1
30,2023-06-05T01:47:00+10:00,2023-06-05,01:47,0,2,2
54,2023-06-05T01:47:00+10:00,2023-06-05,01:47,0,1,1
18,2023-06-05T01:47:00+10:00,2023-06-05,01:47,0,1,1
27,2023-06-05T01:47:00+10:00,2023-06-05,01:47,1,0,1
49,2023-06-05T01:47:00+10:00,2023-06-05,01:47,1,1,2
53,2023-06-05T01:47:00+10:00,2023-06-05,01:47,1,0,1
62,2023-06-05T01:47:00+10:00,2023-06-05,01:47,1,0,1
79,2023-06-05T01:47:00+10:00,2023-06-05,01:47,0,1,1
26,2023-06-05T01:47:00+10:00,2023-06-05,01:47,0,2,2
41,2023-06-05T01:47:00+10:00,2023-06-05,01:47,2,3,5
55,2023-06-05T01:47:00+10:00,2023-06-05,01:47,0,2,2
19,2023-06-05T01:47:00+10:00,2023-06-05,01:47,0,2,2
46,2023-06-05T01:47:00+10:00,2023-06-05,01:47,1,0,1
58,2023-06-05T01:47:00+10:00,2023-06-05,01:47,2,0,2
6,2023-06-05T01:46:00+10:00,2023-06-05,01:46,0,1,1
14,2023-06-05T01:46:00+10:00,2023-06-05,01:46,0,2,2
1,2023-06-05T01:46:00+10:00,2023-06-05,01:46,2,0,2
72,2023-06-05T01:46:00+10:00,2023-06-05,01:46,1,1,2
3,2023-06-05T01:46:00+10:00,2023-06-05,01:46,1,0,1
26,2023-06-05T01:46:00+10:00,2023-06-05,01:46,1,1,2
31,2023-06-05T01:46:00+10:00,2023-06-05,01:46,0,1,1
45,2023-06-05T01:46:00+10:00,2023-06-05,01:46,1,0,1
55,2023-06-05T01:46:00+10:00,2023-06-05,01:46,3,3,6
24,2023-06-05T01:46:00+10:00,2023-06-05,01:46,0,3,3
51,2023-06-05T01:46:00+10:00,2023-06-05,01:46,0,1,1
28,2023-06-05T01:46:00+10:00,2023-06-05,01:46,0,1,1
66,2023-06-05T01:46:00+10:00,2023-06-05,01:46,0,1,1
19,2023-06-05T01:46:00+10:00,2023-06-05,01:46,1,0,1
49,2023-06-05T01:46:00+10:00,2023-06-05,01:46,1,1,2
56,2023-06-05T01:46:00+10:00,2023-06-05,01:46,3,1,4
62,2023-06-05T01:46:00+10:00,2023-06-05,01:46,0,1,1
14,2023-06-05T01:45:00+10:00,2023-06-05,01:45,1,0,1
28,2023-06-05T01:45:00+10:00,2023-06-05,01:45,1,0,1
55,2023-06-05T01:45:00+10:00,2023-06-05,01:45,0,4,4
84,2023-06-05T01:45:00+10:00,2023-06-05,01:45,1,2,3
24,2023-06-05T01:45:00+10:00,2023-06-05,01:45,0,1,1
49,2023-06-05T01:45:00+10:00,2023-06-05,01:45,0,3,3
79,2023-06-05T01:45:00+10:00,2023-06-05,01:45,3,1,4
3,2023-06-05T01:45:00+10:00,2023-06-05,01:45,4,1,5
6,2023-06-05T01:45:00+10:00,2023-06-05,01:45,2,0,2
21,2023-06-05T01:45:00+10:00,2023-06-05,01:45,1,0,1
54,2023-06-05T01:45:00+10:00,2023-06-05,01:45,0,1,1
59,2023-06-05T01:45:00+10:00,2023-06-05,01:45,2,0,2
66,2023-06-05T01:45:00+10:00,2023-06-05,01:45,2,0,2
107,2023-06-05T01:45:00+10:00,2023-06-05,01:45,0,1,1
108,2023-06-05T01:45:00+10:00,2023-06-05,01:45,0,2,2
9,2023-06-05T01:45:00+10:00,2023-06-05,01:45,1,0,1
52,2023-06-05T01:45:00+10:00,2023-06-05,01:45,2,0,2
53,2023-06-05T01:45:00+10:00,2023-06-05,01:45,2,0,2
62,2023-06-05T01:45:00+10:00,2023-06-05,01:45,0,1,1
72,2023-06-05T01:45:00+10:00,2023-06-05,01:45,1,4,5
109,2023-06-05T01:45:00+10:00,2023-06-05,01:45,1,0,1
4,2023-06-05T01:45:00+10:00,2023-06-05,01:45,1,0,1
1,2023-06-05T01:45:00+10:00,2023-06-05,01:45,1,0,1
19,2023-06-05T01:45:00+10:00,2023-06-05,01:45,1,0,1
21,2023-06-05T01:44:00+10:00,2023-06-05,01:44,3,2,5
24,2023-06-05T01:44:00+10:00,2023-06-05,01:44,1,0,1
55,2023-06-05T01:44:00+10:00,2023-06-05,01:44,1,4,5
66,2023-06-05T01:44:00+10:00,2023-06-05,01:44,1,1,2
51,2023-06-05T01:44:00+10:00,2023-06-05,01:44,3,1,4
58,2023-06-05T01:44:00+10:00,2023-06-05,01:44,0,1,1
62,2023-06-05T01:44:00+10:00,2023-06-05,01:44,1,1,2
72,2023-06-05T01:44:00+10:00,2023-06-05,01:44,1,0,1
42,2023-06-05T01:44:00+10:00,2023-06-05,01:44,0,1,1
47,2023-06-05T01:44:00+10:00,2023-06-05,01:44,4,0,4
54,2023-06-05T01:44:00+10:00,2023-06-05,01:44,0,1,1
61,2023-06-05T01:44:00+10:00,2023-06-05,01:44,0,2,2
26,2023-06-05T01:43:00+10:00,2023-06-05,01:43,1,0,1
31,2023-06-05T01:43:00+10:00,2023-06-05,01:43,1,0,1
55,2023-06-05T01:43:00+10:00,2023-06-05,01:43,2,4,6
21,2023-06-05T01:43:00+10:00,2023-06-05,01:43,0,2,2
41,2023-06-05T01:43:00+10:00,2023-06-05,01:43,1,0,1
61,2023-06-05T01:43:00+10:00,2023-06-05,01:43,2,2,4
1,2023-06-05T01:43:00+10:00,2023-06-05,01:43,1,0,1
30,2023-06-05T01:43:00+10:00,2023-06-05,01:43,1,0,1
35,2023-06-05T01:43:00+10:00,2023-06-05,01:43,1,0,1
72,2023-06-05T01:43:00+10:00,2023-06-05,01:43,2,5,7
5,2023-06-05T01:43:00+10:00,2023-06-05,01:43,1,1,2
6,2023-06-05T01:43:00+10:00,2023-06-05,01:43,0,1,1
3,2023-06-05T01:42:00+10:00,2023-06-05,01:42,2,0,2
5,2023-06-05T01:42:00+10:00,2023-06-05,01:42,0,1,1
69,2023-06-05T01:42:00+10:00,2023-06-05,01:42,1,0,1
2,2023-06-05T01:42:00+10:00,2023-06-05,01:42,0,6,6
14,2023-06-05T01:42:00+10:00,2023-06-05,01:42,0,1,1
21,2023-06-05T01:42:00+10:00,2023-06-05,01:42,9,0,9
28,2023-06-05T01:42:00+10:00,2023-06-05,01:42,2,0,2
41,2023-06-05T01:42:00+10:00,2023-06-05,01:42,1,0,1
55,2023-06-05T01:42:00+10:00,2023-06-05,01:42,0,2,2
61,2023-06-05T01:42:00+10:00,2023-06-05,01:42,1,0,1
72,2023-06-05T01:42:00+10:00,2023-06-05,01:42,0,1,1
6,2023-06-05T01:42:00+10:00,2023-06-05,01:42,0,2,2
26,2023-06-05T01:41:00+10:00,2023-06-05,01:41,1,3,4
54,2023-06-05T01:41:00+10:00,2023-06-05,01:41,3,0,3
55,2023-06-05T01:41:00+10:00,2023-06-05,01:41,2,2,4
108,2023-06-05T01:41:00+10:00,2023-06-05,01:41,1,0,1
12,2023-06-05T01:41:00+10:00,2023-06-05,01:41,0,1,1
24,2023-06-05T01:41:00+10:00,2023-06-05,01:41,2,0,2
35,2023-06-05T01:41:00+10:00,2023-06-05,01:41,0,1,1
51,2023-06-05T01:41:00+10:00,2023-06-05,01:41,0,2,2
41,2023-06-05T01:41:00+10:00,2023-06-05,01:41,1,3,4
69,2023-06-05T01:41:00+10:00,2023-06-05,01:41,0,1,1
53,2023-06-05T01:41:00+10:00,2023-06-05,01:41,0,2,2
3,2023-06-05T01:41:00+10:00,2023-06-05,01:41,3,0,3
4,2023-06-05T01:41:00+10:00,2023-06-05,01:41,0,2,2
42,2023-06-05T01:41:00+10:00,2023-06-05,01:41,0,1,1
79,2023-06-05T01:41:00+10:00,2023-06-05,01:41,0,1,1
4,2023-06-05T01:40:00+10:00,2023-06-05,01:40,0,1,1
45,2023-06-05T01:40:00+10:00,2023-06-05,01:40,2,0,2
65,2023-06-05T01:40:00+10:00,2023-06-05,01:40,0,2,2
67,2023-06-05T01:40:00+10:00,2023-06-05,01:40,1,0,1
54,2023-06-05T01:40:00+10:00,2023-06-05,01:40,1,0,1
55,2023-06-05T01:40:00+10:00,2023-06-05,01:40,1,4,5
84,2023-06-05T01:40:00+10:00,2023-06-05,01:40,3,2,5
107,2023-06-05T01:40:00+10:00,2023-06-05,01:40,2,0,2
108,2023-06-05T01:40:00+10:00,2023-06-05,01:40,0,1,1
19,2023-06-05T01:40:00+10:00,2023-06-05,01:40,2,0,2
24,2023-06-05T01:40:00+10:00,2023-06-05,01:40,0,1,1
3,2023-06-05T01:40:00+10:00,2023-06-05,01:40,1,1,2
21,2023-06-05T01:40:00+10:00,2023-06-05,01:40,0,1,1
41,2023-06-05T01:40:00+10:00,2023-06-05,01:40,3,2,5
59,2023-06-05T01:40:00+10:00,2023-06-05,01:40,8,7,15
61,2023-06-05T01:40:00+10:00,2023-06-05,01:40,0,1,1
35,2023-06-05T01:40:00+10:00,2023-06-05,01:40,1,0,1
79,2023-06-05T01:40:00+10:00,2023-06-05,01:40,0,1,1
4,2023-06-05T01:39:00+10:00,2023-06-05,01:39,1,1,2
41,2023-06-05T01:39:00+10:00,2023-06-05,01:39,0,2,2
35,2023-06-05T01:39:00+10:00,2023-06-05,01:39,1,0,1
5,2023-06-05T01:39:00+10:00,2023-06-05,01:39,1,2,3
6,2023-06-05T01:39:00+10:00,2023-06-05,01:39,1,1,2
26,2023-06-05T01:39:00+10:00,2023-06-05,01:39,1,1,2
30,2023-06-05T01:39:00+10:00,2023-06-05,01:39,9,0,9
3,2023-06-05T01:39:00+10:00,2023-06-05,01:39,0,2,2
28,2023-06-05T01:39:00+10:00,2023-06-05,01:39,1,0,1
37,2023-06-05T01:39:00+10:00,2023-06-05,01:39,1,0,1
58,2023-06-05T01:39:00+10:00,2023-06-05,01:39,1,2,3
55,2023-06-05T01:38:00+10:00,2023-06-05,01:38,2,0,2
77,2023-06-05T01:38:00+10:00,2023-06-05,01:38,1,0,1
108,2023-06-05T01:38:00+10:00,2023-06-05,01:38,1,0,1
19,2023-06-05T01:38:00+10:00,2023-06-05,01:38,4,7,11
30,2023-06-05T01:38:00+10:00,2023-06-05,01:38,0,1,1
48,2023-06-05T01:38:00+10:00,2023-06-05,01:38,3,0,3
49,2023-06-05T01:38:00+10:00,2023-06-05,01:38,0,2,2
58,2023-06-05T01:38:00+10:00,2023-06-05,01:38,0,1,1
62,2023-06-05T01:38:00+10:00,2023-06-05,01:38,1,0,1
4,2023-06-05T01:38:00+10:00,2023-06-05,01:38,0,1,1
65,2023-06-05T01:38:00+10:00,2023-06-05,01:38,0,1,1
2,2023-06-05T01:38:00+10:00,2023-06-05,01:38,0,2,2
72,2023-06-05T01:38:00+10:00,2023-06-05,01:38,0,1,1
26,2023-06-05T01:38:00+10:00,2023-06-05,01:38,0,2,2
41,2023-06-05T01:38:00+10:00,2023-06-05,01:38,1,1,2
39,2023-06-05T01:37:00+10:00,2023-06-05,01:37,0,1,1
44,2023-06-05T01:37:00+10:00,2023-06-05,01:37,0,1,1
66,2023-06-05T01:37:00+10:00,2023-06-05,01:37,0,1,1
24,2023-06-05T01:37:00+10:00,2023-06-05,01:37,1,0,1
35,2023-06-05T01:37:00+10:00,2023-06-05,01:37,1,1,2
72,2023-06-05T01:37:00+10:00,2023-06-05,01:37,1,0,1
79,2023-06-05T01:37:00+10:00,2023-06-05,01:37,1,1,2
41,2023-06-05T01:37:00+10:00,2023-06-05,01:37,1,3,4
47,2023-06-05T01:37:00+10:00,2023-06-05,01:37,0,1,1
27,2023-06-05T01:37:00+10:00,2023-06-05,01:37,0,2,2
49,2023-06-05T01:37:00+10:00,2023-06-05,01:37,0,2,2
62,2023-06-05T01:37:00+10:00,2023-06-05,01:37,1,0,1
4,2023-06-05T01:37:00+10:00,2023-06-05,01:37,3,1,4
6,2023-06-05T01:37:00+10:00,2023-06-05,01:37,2,0,2
45,2023-06-05T01:37:00+10:00,2023-06-05,01:37,1,1,2
55,2023-06-05T01:37:00+10:00,2023-06-05,01:37,0,1,1
61,2023-06-05T01:37:00+10:00,2023-06-05,01:37,1,0,1
56,2023-06-05T01:37:00+10:00,2023-06-05,01:37,1,0,1
3,2023-06-05T01:36:00+10:00,2023-06-05,01:36,3,4,7
5,2023-06-05T01:36:00+10:00,2023-06-05,01:36,0,1,1
21,2023-06-05T01:36:00+10:00,2023-06-05,01:36,1,1,2
41,2023-06-05T01:36:00+10:00,2023-06-05,01:36,0,2,2
47,2023-06-05T01:36:00+10:00,2023-06-05,01:36,2,1,3
55,2023-06-05T01:36:00+10:00,2023-06-05,01:36,5,2,7
65,2023-06-05T01:36:00+10:00,2023-06-05,01:36,0,1,1
1,2023-06-05T01:36:00+10:00,2023-06-05,01:36,1,0,1
49,2023-06-05T01:36:00+10:00,2023-06-05,01:36,4,0,4
72,2023-06-05T01:36:00+10:00,2023-06-05,01:36,1,0,1
4,2023-06-05T01:36:00+10:00,2023-06-05,01:36,2,1,3
26,2023-06-05T01:36:00+10:00,2023-06-05,01:36,1,1,2
45,2023-06-05T01:36:00+10:00,2023-06-05,01:36,0,1,1
54,2023-06-05T01:36:00+10:00,2023-06-05,01:36,0,1,1
66,2023-06-05T01:36:00+10:00,2023-06-05,01:36,0,1,1
108,2023-06-05T01:36:00+10:00,2023-06-05,01:36,0,1,1
2,2023-06-05T01:36:00+10:00,2023-06-05,01:36,0,1,1
9,2023-06-05T01:36:00+10:00,2023-06-05,01:36,0,1,1
19,2023-06-05T01:36:00+10:00,2023-06-05,01:36,0,1,1
41,2023-06-05T01:35:00+10:00,2023-06-05,01:35,0,2,2
55,2023-06-05T01:35:00+10:00,2023-06-05,01:35,1,0,1
59,2023-06-05T01:35:00+10:00,2023-06-05,01:35,1,0,1
66,2023-06-05T01:35:00+10:00,2023-06-05,01:35,5,0,5
108,2023-06-05T01:35:00+10:00,2023-06-05,01:35,1,0,1
24,2023-06-05T01:35:00+10:00,2023-06-05,01:35,0,1,1
30,2023-06-05T01:35:00+10:00,2023-06-05,01:35,1,0,1
35,2023-06-05T01:35:00+10:00,2023-06-05,01:35,2,0,2
109,2023-06-05T01:35:00+10:00,2023-06-05,01:35,2,1,3
3,2023-06-05T01:35:00+10:00,2023-06-05,01:35,1,0,1
54,2023-06-05T01:35:00+10:00,2023-06-05,01:35,0,3,3
84,2023-06-05T01:35:00+10:00,2023-06-05,01:35,2,1,3
79,2023-06-05T01:35:00+10:00,2023-06-05,01:35,1,0,1
62,2023-06-05T01:35:00+10:00,2023-06-05,01:35,2,0,2
72,2023-06-05T01:35:00+10:00,2023-06-05,01:35,2,0,2
117,2023-06-05T01:35:00+10:00,2023-06-05,01:35,1,0,1
6,2023-06-05T01:34:00+10:00,2023-06-05,01:34,0,1,1
26,2023-06-05T01:34:00+10:00,2023-06-05,01:34,1,0,1
55,2023-06-05T01:34:00+10:00,2023-06-05,01:34,0,4,4
58,2023-06-05T01:34:00+10:00,2023-06-05,01:34,1,0,1
21,2023-06-05T01:34:00+10:00,2023-06-05,01:34,0,2,2
19,2023-06-05T01:34:00+10:00,2023-06-05,01:34,0,1,1
30,2023-06-05T01:34:00+10:00,2023-06-05,01:34,5,0,5
35,2023-06-05T01:34:00+10:00,2023-06-05,01:34,1,3,4
52,2023-06-05T01:34:00+10:00,2023-06-05,01:34,1,0,1
62,2023-06-05T01:34:00+10:00,2023-06-05,01:34,1,0,1
65,2023-06-05T01:34:00+10:00,2023-06-05,01:34,0,1,1
71,2023-06-05T01:34:00+10:00,2023-06-05,01:34,0,1,1
49,2023-06-05T01:34:00+10:00,2023-06-05,01:34,1,0,1
67,2023-06-05T01:34:00+10:00,2023-06-05,01:34,0,1,1
72,2023-06-05T01:34:00+10:00,2023-06-05,01:34,1,0,1
3,2023-06-05T01:33:00+10:00,2023-06-05,01:33,0,2,2
40,2023-06-05T01:33:00+10:00,2023-06-05,01:33,1,0,1
71,2023-06-05T01:33:00+10:00,2023-06-05,01:33,1,0,1
87,2023-06-05T01:33:00+10:00,2023-06-05,01:33,3,0,3
26,2023-06-05T01:33:00+10:00,2023-06-05,01:33,3,3,6
55,2023-06-05T01:33:00+10:00,2023-06-05,01:33,5,0,5
49,2023-06-05T01:33:00+10:00,2023-06-05,01:33,0,1,1
62,2023-06-05T01:33:00+10:00,2023-06-05,01:33,0,1,1
4,2023-06-05T01:33:00+10:00,2023-06-05,01:33,0,1,1
5,2023-06-05T01:33:00+10:00,2023-06-05,01:33,1,0,1
14,2023-06-05T01:33:00+10:00,2023-06-05,01:33,1,0,1
2,2023-06-05T01:33:00+10:00,2023-06-05,01:33,0,1,1
19,2023-06-05T01:33:00+10:00,2023-06-05,01:33,0,1,1
30,2023-06-05T01:33:00+10:00,2023-06-05,01:33,6,0,6
35,2023-06-05T01:33:00+10:00,2023-06-05,01:33,0,1,1
3,2023-06-05T01:32:00+10:00,2023-06-05,01:32,3,0,3
8,2023-06-05T01:32:00+10:00,2023-06-05,01:32,1,0,1
47,2023-06-05T01:32:00+10:00,2023-06-05,01:32,2,0,2
54,2023-06-05T01:32:00+10:00,2023-06-05,01:32,1,0,1
55,2023-06-05T01:32:00+10:00,2023-06-05,01:32,2,0,2
66,2023-06-05T01:32:00+10:00,2023-06-05,01:32,1,2,3
19,2023-06-05T01:32:00+10:00,2023-06-05,01:32,0,1,1
30,2023-06-05T01:32:00+10:00,2023-06-05,01:32,1,0,1
58,2023-06-05T01:32:00+10:00,2023-06-05,01:32,0,1,1
62,2023-06-05T01:32:00+10:00,2023-06-05,01:32,2,1,3
79,2023-06-05T01:32:00+10:00,2023-06-05,01:32,1,0,1
5,2023-06-05T01:32:00+10:00,2023-06-05,01:32,1,0,1
26,2023-06-05T01:32:00+10:00,2023-06-05,01:32,1,0,1
40,2023-06-05T01:32:00+10:00,2023-06-05,01:32,0,1,1
41,2023-06-05T01:32:00+10:00,2023-06-05,01:32,3,2,5
61,2023-06-05T01:32:00+10:00,2023-06-05,01:32,1,0,1
24,2023-06-05T01:32:00+10:00,2023-06-05,01:32,1,0,1
26,2023-06-05T01:31:00+10:00,2023-06-05,01:31,1,2,3
55,2023-06-05T01:31:00+10:00,2023-06-05,01:31,4,0,4
65,2023-06-05T01:31:00+10:00,2023-06-05,01:31,0,1,1
66,2023-06-05T01:31:00+10:00,2023-06-05,01:31,2,0,2
19,2023-06-05T01:31:00+10:00,2023-06-05,01:31,0,5,5
52,2023-06-05T01:31:00+10:00,2023-06-05,01:31,0,1,1
58,2023-06-05T01:31:00+10:00,2023-06-05,01:31,1,2,3
3,2023-06-05T01:31:00+10:00,2023-06-05,01:31,1,2,3
35,2023-06-05T01:31:00+10:00,2023-06-05,01:31,0,1,1
49,2023-06-05T01:31:00+10:00,2023-06-05,01:31,2,0,2
6,2023-06-05T01:31:00+10:00,2023-06-05,01:31,0,2,2
37,2023-06-05T01:31:00+10:00,2023-06-05,01:31,0,2,2
40,2023-06-05T01:31:00+10:00,2023-06-05,01:31,0,2,2
41,2023-06-05T01:31:00+10:00,2023-06-05,01:31,2,4,6
54,2023-06-05T01:31:00+10:00,2023-06-05,01:31,0,3,3
3,2023-06-05T01:30:00+10:00,2023-06-05,01:30,2,0,2
5,2023-06-05T01:30:00+10:00,2023-06-05,01:30,0,1,1
41,2023-06-05T01:30:00+10:00,2023-06-05,01:30,1,0,1
107,2023-06-05T01:30:00+10:00,2023-06-05,01:30,0,1,1
19,2023-06-05T01:30:00+10:00,2023-06-05,01:30,0,2,2
30,2023-06-05T01:30:00+10:00,2023-06-05,01:30,0,1,1
49,2023-06-05T01:30:00+10:00,2023-06-05,01:30,2,0,2
55,2023-06-05T01:30:00+10:00,2023-06-05,01:30,1,0,1
66,2023-06-05T01:30:00+10:00,2023-06-05,01:30,1,0,1
84,2023-06-05T01:30:00+10:00,2023-06-05,01:30,0,6,6
53,2023-06-05T01:30:00+10:00,2023-06-05,01:30,0,1,1
62,2023-06-05T01:30:00+10:00,2023-06-05,01:30,4,0,4
109,2023-06-05T01:30:00+10:00,2023-06-05,01:30,0,1,1
42,2023-06-05T01:30:00+10:00,2023-06-05,01:30,0,4,4
59,2023-06-05T01:30:00+10:00,2023-06-05,01:30,1,0,1
56,2023-06-05T01:30:00+10:00,2023-06-05,01:30,3,0,3
79,2023-06-05T01:30:00+10:00,2023-06-05,01:30,0,3,3
28,2023-06-05T01:29:00+10:00,2023-06-05,01:29,1,0,1
19,2023-06-05T01:29:00+10:00,2023-06-05,01:29,1,3,4
35,2023-06-05T01:29:00+10:00,2023-06-05,01:29,1,0,1
51,2023-06-05T01:29:00+10:00,2023-06-05,01:29,1,0,1
62,2023-06-05T01:29:00+10:00,2023-06-05,01:29,4,0,4
72,2023-06-05T01:29:00+10:00,2023-06-05,01:29,0,1,1
41,2023-06-05T01:29:00+10:00,2023-06-05,01:29,5,2,7
45,2023-06-05T01:29:00+10:00,2023-06-05,01:29,0,2,2
66,2023-06-05T01:29:00+10:00,2023-06-05,01:29,1,0,1
2,2023-06-05T01:29:00+10:00,2023-06-05,01:29,1,0,1
4,2023-06-05T01:28:00+10:00,2023-06-05,01:28,0,1,1
87,2023-06-05T01:28:00+10:00,2023-06-05,01:28,2,0,2
30,2023-06-05T01:28:00+10:00,2023-06-05,01:28,0,1,1
5,2023-06-05T01:28:00+10:00,2023-06-05,01:28,1,1,2
21,2023-06-05T01:28:00+10:00,2023-06-05,01:28,0,6,6
47,2023-06-05T01:28:00+10:00,2023-06-05,01:28,2,3,5
54,2023-06-05T01:28:00+10:00,2023-06-05,01:28,0,1,1
66,2023-06-05T01:28:00+10:00,2023-06-05,01:28,0,2,2
2,2023-06-05T01:28:00+10:00,2023-06-05,01:28,1,0,1
9,2023-06-05T01:28:00+10:00,2023-06-05,01:28,1,0,1
58,2023-06-05T01:28:00+10:00,2023-06-05,01:28,1,0,1
72,2023-06-05T01:28:00+10:00,2023-06-05,01:28,1,0,1
79,2023-06-05T01:28:00+10:00,2023-06-05,01:28,0,2,2
3,2023-06-05T01:28:00+10:00,2023-06-05,01:28,0,3,3
41,2023-06-05T01:28:00+10:00,2023-06-05,01:28,4,0,4
55,2023-06-05T01:28:00+10:00,2023-06-05,01:28,3,3,6
49,2023-06-05T01:27:00+10:00,2023-06-05,01:27,0,2,2
42,2023-06-05T01:27:00+10:00,2023-06-05,01:27,0,1,1
66,2023-06-05T01:27:00+10:00,2023-06-05,01:27,3,0,3
17,2023-06-05T01:27:00+10:00,2023-06-05,01:27,1,0,1
30,2023-06-05T01:27:00+10:00,2023-06-05,01:27,2,0,2
72,2023-06-05T01:27:00+10:00,2023-06-05,01:27,1,0,1
3,2023-06-05T01:27:00+10:00,2023-06-05,01:27,4,1,5
6,2023-06-05T01:27:00+10:00,2023-06-05,01:27,3,0,3
26,2023-06-05T01:27:00+10:00,2023-06-05,01:27,0,1,1
37,2023-06-05T01:27:00+10:00,2023-06-05,01:27,0,1,1
47,2023-06-05T01:27:00+10:00,2023-06-05,01:27,0,1,1
54,2023-06-05T01:27:00+10:00,2023-06-05,01:27,0,2,2
55,2023-06-05T01:27:00+10:00,2023-06-05,01:27,1,0,1
87,2023-06-05T01:27:00+10:00,2023-06-05,01:27,0,1,1
27,2023-06-05T01:27:00+10:00,2023-06-05,01:27,1,0,1
52,2023-06-05T01:27:00+10:00,2023-06-05,01:27,0,1,1
5,2023-06-05T01:26:00+10:00,2023-06-05,01:26,0,1,1
26,2023-06-05T01:26:00+10:00,2023-06-05,01:26,1,0,1
41,2023-06-05T01:26:00+10:00,2023-06-05,01:26,0,1,1
55,2023-06-05T01:26:00+10:00,2023-06-05,01:26,4,6,10
56,2023-06-05T01:26:00+10:00,2023-06-05,01:26,1,0,1
62,2023-06-05T01:26:00+10:00,2023-06-05,01:26,1,2,3
4,2023-06-05T01:26:00+10:00,2023-06-05,01:26,1,0,1
28,2023-06-05T01:26:00+10:00,2023-06-05,01:26,3,1,4
11,2023-06-05T01:26:00+10:00,2023-06-05,01:26,0,1,1
53,2023-06-05T01:26:00+10:00,2023-06-05,01:26,0,1,1
72,2023-06-05T01:26:00+10:00,2023-06-05,01:26,0,1,1
3,2023-06-05T01:26:00+10:00,2023-06-05,01:26,3,3,6
19,2023-06-05T01:26:00+10:00,2023-06-05,01:26,0,1,1
20,2023-06-05T01:26:00+10:00,2023-06-05,01:26,0,2,2
24,2023-06-05T01:26:00+10:00,2023-06-05,01:26,0,4,4
46,2023-06-05T01:26:00+10:00,2023-06-05,01:26,0,1,1
48,2023-06-05T01:26:00+10:00,2023-06-05,01:26,0,3,3
67,2023-06-05T01:26:00+10:00,2023-06-05,01:26,0,1,1
26,2023-06-05T01:25:00+10:00,2023-06-05,01:25,1,1,2
41,2023-06-05T01:25:00+10:00,2023-06-05,01:25,1,2,3
55,2023-06-05T01:25:00+10:00,2023-06-05,01:25,0,5,5
61,2023-06-05T01:25:00+10:00,2023-06-05,01:25,1,0,1
84,2023-06-05T01:25:00+10:00,2023-06-05,01:25,5,0,5
107,2023-06-05T01:25:00+10:00,2023-06-05,01:25,0,2,2
52,2023-06-05T01:25:00+10:00,2023-06-05,01:25,1,0,1
109,2023-06-05T01:25:00+10:00,2023-06-05,01:25,0,2,2
45,2023-06-05T01:25:00+10:00,2023-06-05,01:25,1,1,2
59,2023-06-05T01:25:00+10:00,2023-06-05,01:25,1,2,3
19,2023-06-05T01:25:00+10:00,2023-06-05,01:25,1,0,1
24,2023-06-05T01:25:00+10:00,2023-06-05,01:25,1,0,1
3,2023-06-05T01:25:00+10:00,2023-06-05,01:25,0,2,2
4,2023-06-05T01:25:00+10:00,2023-06-05,01:25,1,0,1
5,2023-06-05T01:25:00+10:00,2023-06-05,01:25,1,2,3
47,2023-06-05T01:25:00+10:00,2023-06-05,01:25,0,1,1
65,2023-06-05T01:25:00+10:00,2023-06-05,01:25,0,1,1
11,2023-06-05T01:25:00+10:00,2023-06-05,01:25,1,0,1
20,2023-06-05T01:25:00+10:00,2023-06-05,01:25,0,2,2
30,2023-06-05T01:25:00+10:00,2023-06-05,01:25,1,3,4
49,2023-06-05T01:25:00+10:00,2023-06-05,01:25,2,2,4
53,2023-06-05T01:25:00+10:00,2023-06-05,01:25,0,1,1
62,2023-06-05T01:25:00+10:00,2023-06-05,01:25,1,2,3
3,2023-06-05T01:24:00+10:00,2023-06-05,01:24,1,0,1
4,2023-06-05T01:24:00+10:00,2023-06-05,01:24,1,1,2
5,2023-06-05T01:24:00+10:00,2023-06-05,01:24,0,1,1
28,2023-06-05T01:24:00+10:00,2023-06-05,01:24,0,2,2
45,2023-06-05T01:24:00+10:00,2023-06-05,01:24,0,1,1
54,2023-06-05T01:24:00+10:00,2023-06-05,01:24,0,2,2
55,2023-06-05T01:24:00+10:00,2023-06-05,01:24,5,4,9
30,2023-06-05T01:24:00+10:00,2023-06-05,01:24,7,2,9
42,2023-06-05T01:24:00+10:00,2023-06-05,01:24,0,3,3
1,2023-06-05T01:24:00+10:00,2023-06-05,01:24,2,0,2
35,2023-06-05T01:24:00+10:00,2023-06-05,01:24,0,1,1
21,2023-06-05T01:24:00+10:00,2023-06-05,01:24,0,2,2
41,2023-06-05T01:24:00+10:00,2023-06-05,01:24,0,1,1
20,2023-06-05T01:24:00+10:00,2023-06-05,01:24,0,1,1
27,2023-06-05T01:24:00+10:00,2023-06-05,01:24,1,0,1
62,2023-06-05T01:24:00+10:00,2023-06-05,01:24,0,2,2
3,2023-06-05T01:23:00+10:00,2023-06-05,01:23,0,2,2
47,2023-06-05T01:23:00+10:00,2023-06-05,01:23,1,1,2
24,2023-06-05T01:23:00+10:00,2023-06-05,01:23,2,0,2
79,2023-06-05T01:23:00+10:00,2023-06-05,01:23,0,1,1
5,2023-06-05T01:23:00+10:00,2023-06-05,01:23,0,1,1
26,2023-06-05T01:23:00+10:00,2023-06-05,01:23,0,3,3
41,2023-06-05T01:23:00+10:00,2023-06-05,01:23,0,1,1
61,2023-06-05T01:23:00+10:00,2023-06-05,01:23,2,0,2
49,2023-06-05T01:23:00+10:00,2023-06-05,01:23,0,2,2
51,2023-06-05T01:23:00+10:00,2023-06-05,01:23,0,1,1
42,2023-06-05T01:23:00+10:00,2023-06-05,01:23,0,6,6
45,2023-06-05T01:23:00+10:00,2023-06-05,01:23,0,2,2
55,2023-06-05T01:23:00+10:00,2023-06-05,01:23,1,0,1
19,2023-06-05T01:23:00+10:00,2023-06-05,01:23,0,1,1
72,2023-06-05T01:23:00+10:00,2023-06-05,01:23,1,0,1
4,2023-06-05T01:22:00+10:00,2023-06-05,01:22,0,2,2
41,2023-06-05T01:22:00+10:00,2023-06-05,01:22,3,1,4
49,2023-06-05T01:22:00+10:00,2023-06-05,01:22,2,0,2
58,2023-06-05T01:22:00+10:00,2023-06-05,01:22,1,1,2
3,2023-06-05T01:22:00+10:00,2023-06-05,01:22,1,0,1
6,2023-06-05T01:22:00+10:00,2023-06-05,01:22,0,1,1
5,2023-06-05T01:22:00+10:00,2023-06-05,01:22,0,3,3
54,2023-06-05T01:22:00+10:00,2023-06-05,01:22,0,2,2
55,2023-06-05T01:22:00+10:00,2023-06-05,01:22,4,2,6
24,2023-06-05T01:22:00+10:00,2023-06-05,01:22,0,1,1
30,2023-06-05T01:22:00+10:00,2023-06-05,01:22,2,0,2
62,2023-06-05T01:22:00+10:00,2023-06-05,01:22,1,0,1
3,2023-06-05T01:21:00+10:00,2023-06-05,01:21,0,2,2
4,2023-06-05T01:21:00+10:00,2023-06-05,01:21,1,0,1
26,2023-06-05T01:21:00+10:00,2023-06-05,01:21,1,1,2
41,2023-06-05T01:21:00+10:00,2023-06-05,01:21,0,5,5
42,2023-06-05T01:21:00+10:00,2023-06-05,01:21,1,0,1
30,2023-06-05T01:21:00+10:00,2023-06-05,01:21,7,0,7
46,2023-06-05T01:21:00+10:00,2023-06-05,01:21,2,0,2
67,2023-06-05T01:21:00+10:00,2023-06-05,01:21,1,0,1
21,2023-06-05T01:21:00+10:00,2023-06-05,01:21,0,1,1
47,2023-06-05T01:21:00+10:00,2023-06-05,01:21,2,2,4
19,2023-06-05T01:21:00+10:00,2023-06-05,01:21,0,1,1
49,2023-06-05T01:21:00+10:00,2023-06-05,01:21,2,0,2
52,2023-06-05T01:21:00+10:00,2023-06-05,01:21,0,1,1
79,2023-06-05T01:21:00+10:00,2023-06-05,01:21,1,0,1
37,2023-06-05T01:21:00+10:00,2023-06-05,01:21,0,1,1
54,2023-06-05T01:21:00+10:00,2023-06-05,01:21,2,1,3
55,2023-06-05T01:21:00+10:00,2023-06-05,01:21,0,10,10
48,2023-06-05T01:21:00+10:00,2023-06-05,01:21,0,1,1
56,2023-06-05T01:21:00+10:00,2023-06-05,01:21,0,1,1
58,2023-06-05T01:21:00+10:00,2023-06-05,01:21,0,1,1
62,2023-06-05T01:21:00+10:00,2023-06-05,01:21,0,1,1
24,2023-06-05T01:20:00+10:00,2023-06-05,01:20,0,5,5
21,2023-06-05T01:20:00+10:00,2023-06-05,01:20,1,5,6
55,2023-06-05T01:20:00+10:00,2023-06-05,01:20,1,4,5
61,2023-06-05T01:20:00+10:00,2023-06-05,01:20,1,0,1
66,2023-06-05T01:20:00+10:00,2023-06-05,01:20,2,1,3
84,2023-06-05T01:20:00+10:00,2023-06-05,01:20,4,2,6
20,2023-06-05T01:20:00+10:00,2023-06-05,01:20,1,0,1
23,2023-06-05T01:20:00+10:00,2023-06-05,01:20,0,1,1
30,2023-06-05T01:20:00+10:00,2023-06-05,01:20,5,0,5
53,2023-06-05T01:20:00+10:00,2023-06-05,01:20,1,1,2
3,2023-06-05T01:20:00+10:00,2023-06-05,01:20,1,0,1
5,2023-06-05T01:20:00+10:00,2023-06-05,01:20,1,0,1
26,2023-06-05T01:20:00+10:00,2023-06-05,01:20,1,0,1
59,2023-06-05T01:20:00+10:00,2023-06-05,01:20,0,4,4
48,2023-06-05T01:19:00+10:00,2023-06-05,01:19,0,1,1
49,2023-06-05T01:19:00+10:00,2023-06-05,01:19,2,0,2
79,2023-06-05T01:19:00+10:00,2023-06-05,01:19,4,1,5
21,2023-06-05T01:19:00+10:00,2023-06-05,01:19,0,1,1
1,2023-06-05T01:19:00+10:00,2023-06-05,01:19,2,0,2
19,2023-06-05T01:19:00+10:00,2023-06-05,01:19,0,1,1
20,2023-06-05T01:19:00+10:00,2023-06-05,01:19,0,1,1
27,2023-06-05T01:19:00+10:00,2023-06-05,01:19,2,0,2
51,2023-06-05T01:19:00+10:00,2023-06-05,01:19,1,0,1
5,2023-06-05T01:19:00+10:00,2023-06-05,01:19,1,2,3
47,2023-06-05T01:19:00+10:00,2023-06-05,01:19,0,2,2
55,2023-06-05T01:19:00+10:00,2023-06-05,01:19,1,1,2
23,2023-06-05T01:19:00+10:00,2023-06-05,01:19,0,2,2
30,2023-06-05T01:19:00+10:00,2023-06-05,01:19,0,1,1
53,2023-06-05T01:19:00+10:00,2023-06-05,01:19,1,0,1
56,2023-06-05T01:19:00+10:00,2023-06-05,01:19,0,2,2
58,2023-06-05T01:19:00+10:00,2023-06-05,01:19,1,0,1
41,2023-06-05T01:18:00+10:00,2023-06-05,01:18,0,2,2
47,2023-06-05T01:18:00+10:00,2023-06-05,01:18,0,1,1
55,2023-06-05T01:18:00+10:00,2023-06-05,01:18,4,1,5
53,2023-06-05T01:18:00+10:00,2023-06-05,01:18,0,1,1
72,2023-06-05T01:18:00+10:00,2023-06-05,01:18,0,3,3
3,2023-06-05T01:18:00+10:00,2023-06-05,01:18,0,6,6
21,2023-06-05T01:18:00+10:00,2023-06-05,01:18,2,0,2
66,2023-06-05T01:18:00+10:00,2023-06-05,01:18,0,1,1
1,2023-06-05T01:18:00+10:00,2023-06-05,01:18,0,1,1
62,2023-06-05T01:18:00+10:00,2023-06-05,01:18,0,1,1
79,2023-06-05T01:18:00+10:00,2023-06-05,01:18,0,1,1
4,2023-06-05T01:18:00+10:00,2023-06-05,01:18,2,4,6
6,2023-06-05T01:18:00+10:00,2023-06-05,01:18,1,0,1
45,2023-06-05T01:18:00+10:00,2023-06-05,01:18,0,2,2
19,2023-06-05T01:18:00+10:00,2023-06-05,01:18,0,1,1
24,2023-06-05T01:18:00+10:00,2023-06-05,01:18,2,0,2
57,2023-06-05T01:18:00+10:00,2023-06-05,01:18,1,0,1
58,2023-06-05T01:18:00+10:00,2023-06-05,01:18,1,0,1
26,2023-06-05T01:17:00+10:00,2023-06-05,01:17,1,0,1
41,2023-06-05T01:17:00+10:00,2023-06-05,01:17,2,0,2
45,2023-06-05T01:17:00+10:00,2023-06-05,01:17,1,1,2
48,2023-06-05T01:17:00+10:00,2023-06-05,01:17,0,2,2
62,2023-06-05T01:17:00+10:00,2023-06-05,01:17,1,1,2
72,2023-06-05T01:17:00+10:00,2023-06-05,01:17,4,0,4
66,2023-06-05T01:17:00+10:00,2023-06-05,01:17,2,0,2
70,2023-06-05T01:17:00+10:00,2023-06-05,01:17,1,0,1
1,2023-06-05T01:17:00+10:00,2023-06-05,01:17,0,1,1
49,2023-06-05T01:17:00+10:00,2023-06-05,01:17,3,2,5
67,2023-06-05T01:17:00+10:00,2023-06-05,01:17,0,1,1
3,2023-06-05T01:17:00+10:00,2023-06-05,01:17,2,1,3
29,2023-06-05T01:17:00+10:00,2023-06-05,01:17,0,1,1
42,2023-06-05T01:17:00+10:00,2023-06-05,01:17,0,2,2
54,2023-06-05T01:17:00+10:00,2023-06-05,01:17,0,1,1
2,2023-06-05T01:17:00+10:00,2023-06-05,01:17,0,2,2
20,2023-06-05T01:17:00+10:00,2023-06-05,01:17,1,0,1
24,2023-06-05T01:17:00+10:00,2023-06-05,01:17,2,2,4
35,2023-06-05T01:17:00+10:00,2023-06-05,01:17,0,2,2
56,2023-06-05T01:17:00+10:00,2023-06-05,01:17,7,1,8
58,2023-06-05T01:17:00+10:00,2023-06-05,01:17,0,3,3
76,2023-06-05T01:17:00+10:00,2023-06-05,01:17,1,0,1
26,2023-06-05T01:16:00+10:00,2023-06-05,01:16,1,0,1
36,2023-06-05T01:16:00+10:00,2023-06-05,01:16,0,1,1
37,2023-06-05T01:16:00+10:00,2023-06-05,01:16,0,2,2
42,2023-06-05T01:16:00+10:00,2023-06-05,01:16,0,3,3
54,2023-06-05T01:16:00+10:00,2023-06-05,01:16,1,0,1
35,2023-06-05T01:16:00+10:00,2023-06-05,01:16,0,1,1
41,2023-06-05T01:16:00+10:00,2023-06-05,01:16,0,2,2
47,2023-06-05T01:16:00+10:00,2023-06-05,01:16,1,0,1
55,2023-06-05T01:16:00+10:00,2023-06-05,01:16,0,10,10
77,2023-06-05T01:16:00+10:00,2023-06-05,01:16,1,0,1
20,2023-06-05T01:16:00+10:00,2023-06-05,01:16,0,2,2
30,2023-06-05T01:16:00+10:00,2023-06-05,01:16,0,11,11
51,2023-06-05T01:16:00+10:00,2023-06-05,01:16,1,0,1
62,2023-06-05T01:16:00+10:00,2023-06-05,01:16,1,0,1
72,2023-06-05T01:16:00+10:00,2023-06-05,01:16,2,0,2
79,2023-06-05T01:16:00+10:00,2023-06-05,01:16,1,1,2
4,2023-06-05T01:15:00+10:00,2023-06-05,01:15,1,0,1
31,2023-06-05T01:15:00+10:00,2023-06-05,01:15,0,1,1
59,2023-06-05T01:15:00+10:00,2023-06-05,01:15,1,1,2
109,2023-06-05T01:15:00+10:00,2023-06-05,01:15,0,2,2
41,2023-06-05T01:15:00+10:00,2023-06-05,01:15,1,0,1
55,2023-06-05T01:15:00+10:00,2023-06-05,01:15,1,5,6
84,2023-06-05T01:15:00+10:00,2023-06-05,01:15,1,3,4
23,2023-06-05T01:15:00+10:00,2023-06-05,01:15,0,3,3
24,2023-06-05T01:15:00+10:00,2023-06-05,01:15,5,0,5
62,2023-06-05T01:15:00+10:00,2023-06-05,01:15,1,1,2
72,2023-06-05T01:15:00+10:00,2023-06-05,01:15,1,2,3
26,2023-06-05T01:15:00+10:00,2023-06-05,01:15,2,0,2
37,2023-06-05T01:15:00+10:00,2023-06-05,01:15,0,2,2
42,2023-06-05T01:15:00+10:00,2023-06-05,01:15,0,2,2
44,2023-06-05T01:15:00+10:00,2023-06-05,01:15,1,0,1
47,2023-06-05T01:15:00+10:00,2023-06-05,01:15,0,2,2
70,2023-06-05T01:15:00+10:00,2023-06-05,01:15,0,1,1
49,2023-06-05T01:15:00+10:00,2023-06-05,01:15,1,1,2
51,2023-06-05T01:15:00+10:00,2023-06-05,01:15,0,2,2
6,2023-06-05T01:14:00+10:00,2023-06-05,01:14,0,1,1
26,2023-06-05T01:14:00+10:00,2023-06-05,01:14,0,5,5
29,2023-06-05T01:14:00+10:00,2023-06-05,01:14,1,0,1
39,2023-06-05T01:14:00+10:00,2023-06-05,01:14,1,2,3
55,2023-06-05T01:14:00+10:00,2023-06-05,01:14,2,1,3
35,2023-06-05T01:14:00+10:00,2023-06-05,01:14,0,1,1
4,2023-06-05T01:14:00+10:00,2023-06-05,01:14,0,1,1
31,2023-06-05T01:14:00+10:00,2023-06-05,01:14,0,2,2
41,2023-06-05T01:14:00+10:00,2023-06-05,01:14,4,1,5
2,2023-06-05T01:14:00+10:00,2023-06-05,01:14,0,9,9
30,2023-06-05T01:14:00+10:00,2023-06-05,01:14,0,2,2
3,2023-06-05T01:14:00+10:00,2023-06-05,01:14,3,0,3
21,2023-06-05T01:14:00+10:00,2023-06-05,01:14,2,1,3
42,2023-06-05T01:14:00+10:00,2023-06-05,01:14,0,3,3
54,2023-06-05T01:14:00+10:00,2023-06-05,01:14,0,4,4
62,2023-06-05T01:14:00+10:00,2023-06-05,01:14,5,1,6
26,2023-06-05T01:13:00+10:00,2023-06-05,01:13,0,1,1
2,2023-06-05T01:13:00+10:00,2023-06-05,01:13,0,1,1
35,2023-06-05T01:13:00+10:00,2023-06-05,01:13,0,2,2
56,2023-06-05T01:13:00+10:00,2023-06-05,01:13,1,0,1
62,2023-06-05T01:13:00+10:00,2023-06-05,01:13,0,1,1
21,2023-06-05T01:13:00+10:00,2023-06-05,01:13,2,1,3
47,2023-06-05T01:13:00+10:00,2023-06-05,01:13,4,0,4
55,2023-06-05T01:13:00+10:00,2023-06-05,01:13,0,2,2
77,2023-06-05T01:13:00+10:00,2023-06-05,01:13,1,1,2
68,2023-06-05T01:13:00+10:00,2023-06-05,01:13,1,0,1
3,2023-06-05T01:13:00+10:00,2023-06-05,01:13,2,2,4
4,2023-06-05T01:13:00+10:00,2023-06-05,01:13,1,0,1
28,2023-06-05T01:13:00+10:00,2023-06-05,01:13,0,1,1
61,2023-06-05T01:13:00+10:00,2023-06-05,01:13,2,0,2
49,2023-06-05T01:13:00+10:00,2023-06-05,01:13,0,1,1
51,2023-06-05T01:13:00+10:00,2023-06-05,01:13,1,0,1
79,2023-06-05T01:13:00+10:00,2023-06-05,01:13,1,0,1
36,2023-06-05T01:12:00+10:00,2023-06-05,01:12,3,0,3
42,2023-06-05T01:12:00+10:00,2023-06-05,01:12,1,1,2
55,2023-06-05T01:12:00+10:00,2023-06-05,01:12,1,3,4
35,2023-06-05T01:12:00+10:00,2023-06-05,01:12,0,1,1
5,2023-06-05T01:12:00+10:00,2023-06-05,01:12,1,1,2
26,2023-06-05T01:12:00+10:00,2023-06-05,01:12,1,1,2
45,2023-06-05T01:12:00+10:00,2023-06-05,01:12,2,3,5
78,2023-06-05T01:12:00+10:00,2023-06-05,01:12,0,2,2
48,2023-06-05T01:12:00+10:00,2023-06-05,01:12,2,0,2
58,2023-06-05T01:12:00+10:00,2023-06-05,01:12,1,0,1
3,2023-06-05T01:12:00+10:00,2023-06-05,01:12,1,0,1
6,2023-06-05T01:12:00+10:00,2023-06-05,01:12,0,1,1
54,2023-06-05T01:12:00+10:00,2023-06-05,01:12,0,2,2
30,2023-06-05T01:12:00+10:00,2023-06-05,01:12,0,2,2
62,2023-06-05T01:12:00+10:00,2023-06-05,01:12,4,1,5
3,2023-06-05T01:11:00+10:00,2023-06-05,01:11,4,5,9
39,2023-06-05T01:11:00+10:00,2023-06-05,01:11,0,1,1
41,2023-06-05T01:11:00+10:00,2023-06-05,01:11,2,1,3
61,2023-06-05T01:11:00+10:00,2023-06-05,01:11,2,0,2
19,2023-06-05T01:11:00+10:00,2023-06-05,01:11,3,1,4
56,2023-06-05T01:11:00+10:00,2023-06-05,01:11,1,0,1
58,2023-06-05T01:11:00+10:00,2023-06-05,01:11,0,4,4
21,2023-06-05T01:11:00+10:00,2023-06-05,01:11,2,0,2
37,2023-06-05T01:11:00+10:00,2023-06-05,01:11,1,0,1
24,2023-06-05T01:11:00+10:00,2023-06-05,01:11,0,2,2
30,2023-06-05T01:11:00+10:00,2023-06-05,01:11,0,1,1
48,2023-06-05T01:11:00+10:00,2023-06-05,01:11,2,2,4
72,2023-06-05T01:11:00+10:00,2023-06-05,01:11,0,1,1
4,2023-06-05T01:11:00+10:00,2023-06-05,01:11,0,2,2
5,2023-06-05T01:11:00+10:00,2023-06-05,01:11,2,0,2
6,2023-06-05T01:11:00+10:00,2023-06-05,01:11,0,2,2
29,2023-06-05T01:11:00+10:00,2023-06-05,01:11,1,0,1
55,2023-06-05T01:11:00+10:00,2023-06-05,01:11,3,2,5
2,2023-06-05T01:11:00+10:00,2023-06-05,01:11,0,1,1
4,2023-06-05T01:10:00+10:00,2023-06-05,01:10,3,0,3
28,2023-06-05T01:10:00+10:00,2023-06-05,01:10,2,0,2
41,2023-06-05T01:10:00+10:00,2023-06-05,01:10,0,1,1
61,2023-06-05T01:10:00+10:00,2023-06-05,01:10,2,0,2
12,2023-06-05T01:10:00+10:00,2023-06-05,01:10,1,0,1
20,2023-06-05T01:10:00+10:00,2023-06-05,01:10,1,0,1
49,2023-06-05T01:10:00+10:00,2023-06-05,01:10,0,2,2
109,2023-06-05T01:10:00+10:00,2023-06-05,01:10,1,0,1
3,2023-06-05T01:10:00+10:00,2023-06-05,01:10,0,1,1
21,2023-06-05T01:10:00+10:00,2023-06-05,01:10,0,1,1
26,2023-06-05T01:10:00+10:00,2023-06-05,01:10,0,1,1
47,2023-06-05T01:10:00+10:00,2023-06-05,01:10,2,0,2
55,2023-06-05T01:10:00+10:00,2023-06-05,01:10,5,1,6
84,2023-06-05T01:10:00+10:00,2023-06-05,01:10,0,1,1
56,2023-06-05T01:10:00+10:00,2023-06-05,01:10,1,0,1
62,2023-06-05T01:10:00+10:00,2023-06-05,01:10,3,1,4
67,2023-06-05T01:10:00+10:00,2023-06-05,01:10,1,0,1
117,2023-06-05T01:10:00+10:00,2023-06-05,01:10,0,1,1
42,2023-06-05T01:10:00+10:00,2023-06-05,01:10,0,1,1
59,2023-06-05T01:10:00+10:00,2023-06-05,01:10,5,2,7
66,2023-06-05T01:10:00+10:00,2023-06-05,01:10,2,2,4
52,2023-06-05T01:10:00+10:00,2023-06-05,01:10,0,2,2
58,2023-06-05T01:10:00+10:00,2023-06-05,01:10,1,0,1
3,2023-06-05T01:09:00+10:00,2023-06-05,01:09,6,0,6
54,2023-06-05T01:09:00+10:00,2023-06-05,01:09,0,1,1
66,2023-06-05T01:09:00+10:00,2023-06-05,01:09,0,1,1
23,2023-06-05T01:09:00+10:00,2023-06-05,01:09,0,2,2
48,2023-06-05T01:09:00+10:00,2023-06-05,01:09,1,0,1
79,2023-06-05T01:09:00+10:00,2023-06-05,01:09,2,0,2
5,2023-06-05T01:09:00+10:00,2023-06-05,01:09,0,1,1
21,2023-06-05T01:09:00+10:00,2023-06-05,01:09,3,4,7
45,2023-06-05T01:09:00+10:00,2023-06-05,01:09,0,2,2
55,2023-06-05T01:09:00+10:00,2023-06-05,01:09,2,2,4
24,2023-06-05T01:09:00+10:00,2023-06-05,01:09,1,0,1
72,2023-06-05T01:09:00+10:00,2023-06-05,01:09,1,0,1
4,2023-06-05T01:09:00+10:00,2023-06-05,01:09,1,0,1
1,2023-06-05T01:09:00+10:00,2023-06-05,01:09,2,0,2
20,2023-06-05T01:09:00+10:00,2023-06-05,01:09,0,2,2
58,2023-06-05T01:09:00+10:00,2023-06-05,01:09,2,0,2
27,2023-06-05T01:08:00+10:00,2023-06-05,01:08,1,0,1
30,2023-06-05T01:08:00+10:00,2023-06-05,01:08,0,2,2
35,2023-06-05T01:08:00+10:00,2023-06-05,01:08,0,3,3
79,2023-06-05T01:08:00+10:00,2023-06-05,01:08,0,2,2
42,2023-06-05T01:08:00+10:00,2023-06-05,01:08,1,0,1
47,2023-06-05T01:08:00+10:00,2023-06-05,01:08,0,5,5
49,2023-06-05T01:08:00+10:00,2023-06-05,01:08,2,0,2
58,2023-06-05T01:08:00+10:00,2023-06-05,01:08,0,1,1
62,2023-06-05T01:08:00+10:00,2023-06-05,01:08,1,2,3
6,2023-06-05T01:08:00+10:00,2023-06-05,01:08,1,0,1
45,2023-06-05T01:08:00+10:00,2023-06-05,01:08,2,0,2
54,2023-06-05T01:08:00+10:00,2023-06-05,01:08,1,0,1
55,2023-06-05T01:08:00+10:00,2023-06-05,01:08,1,0,1
23,2023-06-05T01:08:00+10:00,2023-06-05,01:08,1,0,1
24,2023-06-05T01:08:00+10:00,2023-06-05,01:08,1,3,4
3,2023-06-05T01:07:00+10:00,2023-06-05,01:07,1,3,4
5,2023-06-05T01:07:00+10:00,2023-06-05,01:07,1,0,1
47,2023-06-05T01:07:00+10:00,2023-06-05,01:07,1,0,1
54,2023-06-05T01:07:00+10:00,2023-06-05,01:07,0,2,2
61,2023-06-05T01:07:00+10:00,2023-06-05,01:07,0,1,1
24,2023-06-05T01:07:00+10:00,2023-06-05,01:07,1,2,3
27,2023-06-05T01:07:00+10:00,2023-06-05,01:07,0,1,1
30,2023-06-05T01:07:00+10:00,2023-06-05,01:07,1,3,4
49,2023-06-05T01:07:00+10:00,2023-06-05,01:07,2,0,2
62,2023-06-05T01:07:00+10:00,2023-06-05,01:07,2,0,2
4,2023-06-05T01:07:00+10:00,2023-06-05,01:07,2,0,2
52,2023-06-05T01:07:00+10:00,2023-06-05,01:07,0,3,3
58,2023-06-05T01:07:00+10:00,2023-06-05,01:07,1,0,1
67,2023-06-05T01:07:00+10:00,2023-06-05,01:07,0,1,1
79,2023-06-05T01:07:00+10:00,2023-06-05,01:07,0,3,3
6,2023-06-05T01:07:00+10:00,2023-06-05,01:07,1,0,1
21,2023-06-05T01:07:00+10:00,2023-06-05,01:07,0,1,1
66,2023-06-05T01:07:00+10:00,2023-06-05,01:07,4,0,4
87,2023-06-05T01:07:00+10:00,2023-06-05,01:07,0,1,1
1,2023-06-05T01:07:00+10:00,2023-06-05,01:07,0,1,1
12,2023-06-05T01:07:00+10:00,2023-06-05,01:07,0,1,1
17,2023-06-05T01:07:00+10:00,2023-06-05,01:07,2,0,2
18,2023-06-05T01:07:00+10:00,2023-06-05,01:07,0,1,1
19,2023-06-05T01:07:00+10:00,2023-06-05,01:07,0,1,1
35,2023-06-05T01:07:00+10:00,2023-06-05,01:07,0,1,1
4,2023-06-05T01:06:00+10:00,2023-06-05,01:06,2,0,2
5,2023-06-05T01:06:00+10:00,2023-06-05,01:06,0,3,3
37,2023-06-05T01:06:00+10:00,2023-06-05,01:06,0,1,1
47,2023-06-05T01:06:00+10:00,2023-06-05,01:06,1,0,1
9,2023-06-05T01:06:00+10:00,2023-06-05,01:06,0,1,1
35,2023-06-05T01:06:00+10:00,2023-06-05,01:06,1,0,1
62,2023-06-05T01:06:00+10:00,2023-06-05,01:06,1,1,2
26,2023-06-05T01:06:00+10:00,2023-06-05,01:06,0,1,1
36,2023-06-05T01:06:00+10:00,2023-06-05,01:06,3,0,3
54,2023-06-05T01:06:00+10:00,2023-06-05,01:06,1,0,1
27,2023-06-05T01:06:00+10:00,2023-06-05,01:06,0,1,1
49,2023-06-05T01:06:00+10:00,2023-06-05,01:06,0,1,1
58,2023-06-05T01:06:00+10:00,2023-06-05,01:06,3,2,5
67,2023-06-05T01:06:00+10:00,2023-06-05,01:06,1,0,1
3,2023-06-05T01:06:00+10:00,2023-06-05,01:06,1,3,4
6,2023-06-05T01:06:00+10:00,2023-06-05,01:06,0,3,3
21,2023-06-05T01:06:00+10:00,2023-06-05,01:06,1,0,1
42,2023-06-05T01:06:00+10:00,2023-06-05,01:06,0,6,6
55,2023-06-05T01:06:00+10:00,2023-06-05,01:06,1,0,1
61,2023-06-05T01:06:00+10:00,2023-06-05,01:06,2,1,3
30,2023-06-05T01:06:00+10:00,2023-06-05,01:06,2,0,2
48,2023-06-05T01:06:00+10:00,2023-06-05,01:06,2,0,2
56,2023-06-05T01:06:00+10:00,2023-06-05,01:06,1,0,1
5,2023-06-05T01:05:00+10:00,2023-06-05,01:05,1,0,1
55,2023-06-05T01:05:00+10:00,2023-06-05,01:05,6,2,8
108,2023-06-05T01:05:00+10:00,2023-06-05,01:05,1,1,2
30,2023-06-05T01:05:00+10:00,2023-06-05,01:05,1,0,1
58,2023-06-05T01:05:00+10:00,2023-06-05,01:05,1,0,1
62,2023-06-05T01:05:00+10:00,2023-06-05,01:05,1,0,1
109,2023-06-05T01:05:00+10:00,2023-06-05,01:05,0,2,2
6,2023-06-05T01:05:00+10:00,2023-06-05,01:05,0,1,1
84,2023-06-05T01:05:00+10:00,2023-06-05,01:05,2,4,6
3,2023-06-05T01:05:00+10:00,2023-06-05,01:05,0,2,2
21,2023-06-05T01:05:00+10:00,2023-06-05,01:05,0,1,1
44,2023-06-05T01:05:00+10:00,2023-06-05,01:05,1,0,1
47,2023-06-05T01:05:00+10:00,2023-06-05,01:05,4,0,4
59,2023-06-05T01:05:00+10:00,2023-06-05,01:05,5,2,7
17,2023-06-05T01:05:00+10:00,2023-06-05,01:05,0,1,1
27,2023-06-05T01:05:00+10:00,2023-06-05,01:05,2,0,2
117,2023-06-05T01:05:00+10:00,2023-06-05,01:05,5,0,5
3,2023-06-05T01:04:00+10:00,2023-06-05,01:04,0,1,1
26,2023-06-05T01:04:00+10:00,2023-06-05,01:04,3,1,4
41,2023-06-05T01:04:00+10:00,2023-06-05,01:04,5,1,6
66,2023-06-05T01:04:00+10:00,2023-06-05,01:04,1,0,1
35,2023-06-05T01:04:00+10:00,2023-06-05,01:04,1,0,1
51,2023-06-05T01:04:00+10:00,2023-06-05,01:04,2,0,2
56,2023-06-05T01:04:00+10:00,2023-06-05,01:04,0,1,1
62,2023-06-05T01:04:00+10:00,2023-06-05,01:04,6,1,7
79,2023-06-05T01:04:00+10:00,2023-06-05,01:04,1,3,4
5,2023-06-05T01:04:00+10:00,2023-06-05,01:04,1,0,1
21,2023-06-05T01:04:00+10:00,2023-06-05,01:04,0,3,3
39,2023-06-05T01:04:00+10:00,2023-06-05,01:04,1,0,1
55,2023-06-05T01:04:00+10:00,2023-06-05,01:04,0,2,2
65,2023-06-05T01:04:00+10:00,2023-06-05,01:04,1,0,1
17,2023-06-05T01:04:00+10:00,2023-06-05,01:04,0,2,2
58,2023-06-05T01:04:00+10:00,2023-06-05,01:04,1,0,1
54,2023-06-05T01:04:00+10:00,2023-06-05,01:04,1,0,1
108,2023-06-05T01:04:00+10:00,2023-06-05,01:04,1,0,1
23,2023-06-05T01:04:00+10:00,2023-06-05,01:04,2,0,2
27,2023-06-05T01:04:00+10:00,2023-06-05,01:04,2,0,2
48,2023-06-05T01:04:00+10:00,2023-06-05,01:04,0,1,1
55,2023-06-05T01:03:00+10:00,2023-06-05,01:03,1,5,6
30,2023-06-05T01:03:00+10:00,2023-06-05,01:03,1,2,3
62,2023-06-05T01:03:00+10:00,2023-06-05,01:03,1,0,1
26,2023-06-05T01:03:00+10:00,2023-06-05,01:03,1,3,4
9,2023-06-05T01:03:00+10:00,2023-06-05,01:03,0,1,1
23,2023-06-05T01:03:00+10:00,2023-06-05,01:03,2,1,3
46,2023-06-05T01:03:00+10:00,2023-06-05,01:03,2,0,2
52,2023-06-05T01:03:00+10:00,2023-06-05,01:03,0,4,4
58,2023-06-05T01:03:00+10:00,2023-06-05,01:03,3,0,3
3,2023-06-05T01:03:00+10:00,2023-06-05,01:03,0,1,1
4,2023-06-05T01:03:00+10:00,2023-06-05,01:03,0,3,3
28,2023-06-05T01:03:00+10:00,2023-06-05,01:03,1,0,1
41,2023-06-05T01:03:00+10:00,2023-06-05,01:03,1,0,1
54,2023-06-05T01:03:00+10:00,2023-06-05,01:03,0,2,2
65,2023-06-05T01:03:00+10:00,2023-06-05,01:03,0,2,2
66,2023-06-05T01:03:00+10:00,2023-06-05,01:03,1,1,2
87,2023-06-05T01:03:00+10:00,2023-06-05,01:03,1,0,1
108,2023-06-05T01:03:00+10:00,2023-06-05,01:03,0,1,1
79,2023-06-05T01:03:00+10:00,2023-06-05,01:03,2,3,5
3,2023-06-05T01:02:00+10:00,2023-06-05,01:02,2,0,2
28,2023-06-05T01:02:00+10:00,2023-06-05,01:02,1,0,1
45,2023-06-05T01:02:00+10:00,2023-06-05,01:02,0,1,1
35,2023-06-05T01:02:00+10:00,2023-06-05,01:02,2,0,2
67,2023-06-05T01:02:00+10:00,2023-06-05,01:02,0,1,1
79,2023-06-05T01:02:00+10:00,2023-06-05,01:02,2,0,2
4,2023-06-05T01:02:00+10:00,2023-06-05,01:02,1,0,1
37,2023-06-05T01:02:00+10:00,2023-06-05,01:02,5,0,5
61,2023-06-05T01:02:00+10:00,2023-06-05,01:02,1,0,1
65,2023-06-05T01:02:00+10:00,2023-06-05,01:02,0,2,2
66,2023-06-05T01:02:00+10:00,2023-06-05,01:02,1,0,1
108,2023-06-05T01:02:00+10:00,2023-06-05,01:02,0,1,1
30,2023-06-05T01:02:00+10:00,2023-06-05,01:02,4,0,4
48,2023-06-05T01:02:00+10:00,2023-06-05,01:02,1,0,1
49,2023-06-05T01:02:00+10:00,2023-06-05,01:02,0,2,2
26,2023-06-05T01:02:00+10:00,2023-06-05,01:02,1,0,1
47,2023-06-05T01:02:00+10:00,2023-06-05,01:02,1,3,4
55,2023-06-05T01:02:00+10:00,2023-06-05,01:02,3,0,3
19,2023-06-05T01:02:00+10:00,2023-06-05,01:02,0,4,4
52,2023-06-05T01:02:00+10:00,2023-06-05,01:02,0,3,3
62,2023-06-05T01:02:00+10:00,2023-06-05,01:02,1,0,1
3,2023-06-05T01:01:00+10:00,2023-06-05,01:01,3,0,3
21,2023-06-05T01:01:00+10:00,2023-06-05,01:01,0,1,1
26,2023-06-05T01:01:00+10:00,2023-06-05,01:01,1,0,1
45,2023-06-05T01:01:00+10:00,2023-06-05,01:01,0,1,1
24,2023-06-05T01:01:00+10:00,2023-06-05,01:01,1,0,1
30,2023-06-05T01:01:00+10:00,2023-06-05,01:01,0,1,1
58,2023-06-05T01:01:00+10:00,2023-06-05,01:01,0,2,2
62,2023-06-05T01:01:00+10:00,2023-06-05,01:01,0,2,2
41,2023-06-05T01:01:00+10:00,2023-06-05,01:01,0,1,1
44,2023-06-05T01:01:00+10:00,2023-06-05,01:01,1,0,1
47,2023-06-05T01:01:00+10:00,2023-06-05,01:01,1,1,2
54,2023-06-05T01:01:00+10:00,2023-06-05,01:01,0,2,2
19,2023-06-05T01:01:00+10:00,2023-06-05,01:01,0,2,2
48,2023-06-05T01:01:00+10:00,2023-06-05,01:01,3,4,7
79,2023-06-05T01:01:00+10:00,2023-06-05,01:01,3,0,3
6,2023-06-05T01:01:00+10:00,2023-06-05,01:01,0,1,1
42,2023-06-05T01:01:00+10:00,2023-06-05,01:01,0,2,2
55,2023-06-05T01:01:00+10:00,2023-06-05,01:01,0,2,2
66,2023-06-05T01:01:00+10:00,2023-06-05,01:01,1,0,1
23,2023-06-05T01:01:00+10:00,2023-06-05,01:01,2,0,2
52,2023-06-05T01:01:00+10:00,2023-06-05,01:01,0,2,2
21,2023-06-05T01:00:00+10:00,2023-06-05,01:00,0,5,5
45,2023-06-05T01:00:00+10:00,2023-06-05,01:00,0,1,1
55,2023-06-05T01:00:00+10:00,2023-06-05,01:00,3,0,3
59,2023-06-05T01:00:00+10:00,2023-06-05,01:00,8,2,10
107,2023-06-05T01:00:00+10:00,2023-06-05,01:00,1,0,1
19,2023-06-05T01:00:00+10:00,2023-06-05,01:00,0,3,3
67,2023-06-05T01:00:00+10:00,2023-06-05,01:00,0,1,1
109,2023-06-05T01:00:00+10:00,2023-06-05,01:00,1,0,1
3,2023-06-05T01:00:00+10:00,2023-06-05,01:00,1,4,5
23,2023-06-05T01:00:00+10:00,2023-06-05,01:00,8,0,8
24,2023-06-05T01:00:00+10:00,2023-06-05,01:00,1,0,1
52,2023-06-05T01:00:00+10:00,2023-06-05,01:00,2,0,2
62,2023-06-05T01:00:00+10:00,2023-06-05,01:00,3,1,4
72,2023-06-05T01:00:00+10:00,2023-06-05,01:00,2,1,3
5,2023-06-05T01:00:00+10:00,2023-06-05,01:00,1,2,3
26,2023-06-05T01:00:00+10:00,2023-06-05,01:00,1,4,5
37,2023-06-05T01:00:00+10:00,2023-06-05,01:00,0,1,1
84,2023-06-05T01:00:00+10:00,2023-06-05,01:00,2,4,6
30,2023-06-05T01:00:00+10:00,2023-06-05,01:00,1,0,1
58,2023-06-05T01:00:00+10:00,2023-06-05,01:00,1,0,1
5,2023-06-05T00:59:00+10:00,2023-06-05,00:59,0,1,1
40,2023-06-05T00:59:00+10:00,2023-06-05,00:59,1,0,1
61,2023-06-05T00:59:00+10:00,2023-06-05,00:59,0,1,1
66,2023-06-05T00:59:00+10:00,2023-06-05,00:59,0,1,1
24,2023-06-05T00:59:00+10:00,2023-06-05,00:59,0,1,1
62,2023-06-05T00:59:00+10:00,2023-06-05,00:59,0,1,1
26,2023-06-05T00:59:00+10:00,2023-06-05,00:59,2,0,2
36,2023-06-05T00:59:00+10:00,2023-06-05,00:59,1,0,1
49,2023-06-05T00:59:00+10:00,2023-06-05,00:59,1,0,1
56,2023-06-05T00:59:00+10:00,2023-06-05,00:59,1,0,1
3,2023-06-05T00:59:00+10:00,2023-06-05,00:59,7,0,7
39,2023-06-05T00:59:00+10:00,2023-06-05,00:59,4,1,5
41,2023-06-05T00:59:00+10:00,2023-06-05,00:59,1,0,1
44,2023-06-05T00:59:00+10:00,2023-06-05,00:59,1,0,1
47,2023-06-05T00:59:00+10:00,2023-06-05,00:59,0,3,3
55,2023-06-05T00:59:00+10:00,2023-06-05,00:59,0,5,5
20,2023-06-05T00:59:00+10:00,2023-06-05,00:59,2,0,2
30,2023-06-05T00:59:00+10:00,2023-06-05,00:59,1,0,1
35,2023-06-05T00:59:00+10:00,2023-06-05,00:59,0,3,3
67,2023-06-05T00:59:00+10:00,2023-06-05,00:59,1,0,1
79,2023-06-05T00:59:00+10:00,2023-06-05,00:59,1,1,2
21,2023-06-05T00:58:00+10:00,2023-06-05,00:58,1,1,2
28,2023-06-05T00:58:00+10:00,2023-06-05,00:58,1,0,1
54,2023-06-05T00:58:00+10:00,2023-06-05,00:58,1,2,3
2,2023-06-05T00:58:00+10:00,2023-06-05,00:58,0,1,1
9,2023-06-05T00:58:00+10:00,2023-06-05,00:58,0,1,1
30,2023-06-05T00:58:00+10:00,2023-06-05,00:58,1,0,1
3,2023-06-05T00:58:00+10:00,2023-06-05,00:58,3,2,5
26,2023-06-05T00:58:00+10:00,2023-06-05,00:58,0,3,3
5,2023-06-05T00:58:00+10:00,2023-06-05,00:58,0,3,3
55,2023-06-05T00:58:00+10:00,2023-06-05,00:58,3,1,4
66,2023-06-05T00:58:00+10:00,2023-06-05,00:58,4,3,7
19,2023-06-05T00:58:00+10:00,2023-06-05,00:58,0,2,2
52,2023-06-05T00:58:00+10:00,2023-06-05,00:58,0,1,1
58,2023-06-05T00:58:00+10:00,2023-06-05,00:58,0,4,4
72,2023-06-05T00:58:00+10:00,2023-06-05,00:58,1,0,1
3,2023-06-05T00:57:00+10:00,2023-06-05,00:57,0,4,4
6,2023-06-05T00:57:00+10:00,2023-06-05,00:57,0,1,1
21,2023-06-05T00:57:00+10:00,2023-06-05,00:57,0,2,2
30,2023-06-05T00:57:00+10:00,2023-06-05,00:57,0,3,3
65,2023-06-05T00:57:00+10:00,2023-06-05,00:57,1,0,1
66,2023-06-05T00:57:00+10:00,2023-06-05,00:57,2,0,2
45,2023-06-05T00:57:00+10:00,2023-06-05,00:57,0,2,2
19,2023-06-05T00:57:00+10:00,2023-06-05,00:57,2,2,4
48,2023-06-05T00:57:00+10:00,2023-06-05,00:57,0,1,1
49,2023-06-05T00:57:00+10:00,2023-06-05,00:57,0,3,3
53,2023-06-05T00:57:00+10:00,2023-06-05,00:57,1,4,5
58,2023-06-05T00:57:00+10:00,2023-06-05,00:57,0,1,1
62,2023-06-05T00:57:00+10:00,2023-06-05,00:57,0,1,1
79,2023-06-05T00:57:00+10:00,2023-06-05,00:57,0,3,3
4,2023-06-05T00:56:00+10:00,2023-06-05,00:56,1,0,1
6,2023-06-05T00:56:00+10:00,2023-06-05,00:56,2,0,2
26,2023-06-05T00:56:00+10:00,2023-06-05,00:56,1,0,1
41,2023-06-05T00:56:00+10:00,2023-06-05,00:56,3,1,4
47,2023-06-05T00:56:00+10:00,2023-06-05,00:56,0,1,1
61,2023-06-05T00:56:00+10:00,2023-06-05,00:56,0,1,1
10,2023-06-05T00:56:00+10:00,2023-06-05,00:56,0,1,1
24,2023-06-05T00:56:00+10:00,2023-06-05,00:56,1,3,4
51,2023-06-05T00:56:00+10:00,2023-06-05,00:56,0,1,1
52,2023-06-05T00:56:00+10:00,2023-06-05,00:56,1,2,3
67,2023-06-05T00:56:00+10:00,2023-06-05,00:56,0,1,1
3,2023-06-05T00:56:00+10:00,2023-06-05,00:56,0,5,5
21,2023-06-05T00:56:00+10:00,2023-06-05,00:56,1,1,2
42,2023-06-05T00:56:00+10:00,2023-06-05,00:56,1,0,1
66,2023-06-05T00:56:00+10:00,2023-06-05,00:56,1,1,2
1,2023-06-05T00:56:00+10:00,2023-06-05,00:56,0,1,1
20,2023-06-05T00:56:00+10:00,2023-06-05,00:56,0,2,2
48,2023-06-05T00:56:00+10:00,2023-06-05,00:56,1,0,1
49,2023-06-05T00:56:00+10:00,2023-06-05,00:56,0,2,2
53,2023-06-05T00:56:00+10:00,2023-06-05,00:56,0,1,1
79,2023-06-05T00:56:00+10:00,2023-06-05,00:56,0,1,1
54,2023-06-05T00:56:00+10:00,2023-06-05,00:56,1,0,1
2,2023-06-05T00:56:00+10:00,2023-06-05,00:56,0,3,3
17,2023-06-05T00:56:00+10:00,2023-06-05,00:56,0,1,1
62,2023-06-05T00:56:00+10:00,2023-06-05,00:56,1,3,4
6,2023-06-05T00:55:00+10:00,2023-06-05,00:55,0,2,2
42,2023-06-05T00:55:00+10:00,2023-06-05,00:55,3,0,3
55,2023-06-05T00:55:00+10:00,2023-06-05,00:55,1,3,4
61,2023-06-05T00:55:00+10:00,2023-06-05,00:55,3,1,4
77,2023-06-05T00:55:00+10:00,2023-06-05,00:55,1,0,1
84,2023-06-05T00:55:00+10:00,2023-06-05,00:55,0,3,3
17,2023-06-05T00:55:00+10:00,2023-06-05,00:55,1,0,1
30,2023-06-05T00:55:00+10:00,2023-06-05,00:55,0,4,4
58,2023-06-05T00:55:00+10:00,2023-06-05,00:55,1,0,1
26,2023-06-05T00:55:00+10:00,2023-06-05,00:55,1,0,1
41,2023-06-05T00:55:00+10:00,2023-06-05,00:55,2,0,2
54,2023-06-05T00:55:00+10:00,2023-06-05,00:55,0,4,4
59,2023-06-05T00:55:00+10:00,2023-06-05,00:55,6,3,9
66,2023-06-05T00:55:00+10:00,2023-06-05,00:55,0,2,2
52,2023-06-05T00:55:00+10:00,2023-06-05,00:55,1,0,1
53,2023-06-05T00:55:00+10:00,2023-06-05,00:55,0,1,1
28,2023-06-05T00:55:00+10:00,2023-06-05,00:55,1,0,1
44,2023-06-05T00:55:00+10:00,2023-06-05,00:55,1,0,1
45,2023-06-05T00:55:00+10:00,2023-06-05,00:55,1,0,1
47,2023-06-05T00:55:00+10:00,2023-06-05,00:55,1,1,2
19,2023-06-05T00:55:00+10:00,2023-06-05,00:55,8,3,11
109,2023-06-05T00:55:00+10:00,2023-06-05,00:55,1,1,2
37,2023-06-05T00:54:00+10:00,2023-06-05,00:54,2,0,2
55,2023-06-05T00:54:00+10:00,2023-06-05,00:54,3,2,5
24,2023-06-05T00:54:00+10:00,2023-06-05,00:54,7,0,7
79,2023-06-05T00:54:00+10:00,2023-06-05,00:54,0,1,1
4,2023-06-05T00:54:00+10:00,2023-06-05,00:54,1,1,2
21,2023-06-05T00:54:00+10:00,2023-06-05,00:54,0,4,4
28,2023-06-05T00:54:00+10:00,2023-06-05,00:54,1,0,1
41,2023-06-05T00:54:00+10:00,2023-06-05,00:54,1,0,1
42,2023-06-05T00:54:00+10:00,2023-06-05,00:54,0,2,2
45,2023-06-05T00:54:00+10:00,2023-06-05,00:54,1,0,1
47,2023-06-05T00:54:00+10:00,2023-06-05,00:54,1,1,2
65,2023-06-05T00:54:00+10:00,2023-06-05,00:54,0,1,1
66,2023-06-05T00:54:00+10:00,2023-06-05,00:54,1,0,1
19,2023-06-05T00:54:00+10:00,2023-06-05,00:54,3,3,6
52,2023-06-05T00:54:00+10:00,2023-06-05,00:54,0,2,2
62,2023-06-05T00:54:00+10:00,2023-06-05,00:54,2,1,3
3,2023-06-05T00:54:00+10:00,2023-06-05,00:54,3,1,4
54,2023-06-05T00:54:00+10:00,2023-06-05,00:54,0,1,1
30,2023-06-05T00:54:00+10:00,2023-06-05,00:54,9,0,9
5,2023-06-05T00:53:00+10:00,2023-06-05,00:53,0,1,1
21,2023-06-05T00:53:00+10:00,2023-06-05,00:53,8,0,8
26,2023-06-05T00:53:00+10:00,2023-06-05,00:53,2,0,2
41,2023-06-05T00:53:00+10:00,2023-06-05,00:53,0,5,5
2,2023-06-05T00:53:00+10:00,2023-06-05,00:53,1,0,1
24,2023-06-05T00:53:00+10:00,2023-06-05,00:53,2,0,2
27,2023-06-05T00:53:00+10:00,2023-06-05,00:53,1,0,1
49,2023-06-05T00:53:00+10:00,2023-06-05,00:53,1,0,1
4,2023-06-05T00:53:00+10:00,2023-06-05,00:53,0,2,2
66,2023-06-05T00:53:00+10:00,2023-06-05,00:53,2,0,2
10,2023-06-05T00:53:00+10:00,2023-06-05,00:53,0,1,1
56,2023-06-05T00:53:00+10:00,2023-06-05,00:53,0,1,1
58,2023-06-05T00:53:00+10:00,2023-06-05,00:53,0,1,1
3,2023-06-05T00:53:00+10:00,2023-06-05,00:53,1,4,5
47,2023-06-05T00:53:00+10:00,2023-06-05,00:53,0,2,2
55,2023-06-05T00:53:00+10:00,2023-06-05,00:53,3,3,6
65,2023-06-05T00:53:00+10:00,2023-06-05,00:53,1,1,2
30,2023-06-05T00:53:00+10:00,2023-06-05,00:53,3,3,6
3,2023-06-05T00:52:00+10:00,2023-06-05,00:52,1,0,1
41,2023-06-05T00:52:00+10:00,2023-06-05,00:52,5,0,5
47,2023-06-05T00:52:00+10:00,2023-06-05,00:52,0,1,1
75,2023-06-05T00:52:00+10:00,2023-06-05,00:52,2,0,2
5,2023-06-05T00:52:00+10:00,2023-06-05,00:52,0,2,2
2,2023-06-05T00:52:00+10:00,2023-06-05,00:52,2,0,2
23,2023-06-05T00:52:00+10:00,2023-06-05,00:52,0,2,2
24,2023-06-05T00:52:00+10:00,2023-06-05,00:52,0,2,2
30,2023-06-05T00:52:00+10:00,2023-06-05,00:52,6,1,7
51,2023-06-05T00:52:00+10:00,2023-06-05,00:52,0,3,3
4,2023-06-05T00:52:00+10:00,2023-06-05,00:52,1,0,1
26,2023-06-05T00:52:00+10:00,2023-06-05,00:52,0,1,1
54,2023-06-05T00:52:00+10:00,2023-06-05,00:52,0,2,2
55,2023-06-05T00:52:00+10:00,2023-06-05,00:52,0,2,2
61,2023-06-05T00:52:00+10:00,2023-06-05,00:52,3,1,4
27,2023-06-05T00:52:00+10:00,2023-06-05,00:52,1,0,1
49,2023-06-05T00:52:00+10:00,2023-06-05,00:52,2,0,2
29,2023-06-05T00:51:00+10:00,2023-06-05,00:51,0,1,1
41,2023-06-05T00:51:00+10:00,2023-06-05,00:51,1,0,1
45,2023-06-05T00:51:00+10:00,2023-06-05,00:51,0,1,1
54,2023-06-05T00:51:00+10:00,2023-06-05,00:51,3,2,5
19,2023-06-05T00:51:00+10:00,2023-06-05,00:51,0,1,1
30,2023-06-05T00:51:00+10:00,2023-06-05,00:51,1,0,1
51,2023-06-05T00:51:00+10:00,2023-06-05,00:51,1,0,1
21,2023-06-05T00:51:00+10:00,2023-06-05,00:51,3,0,3
26,2023-06-05T00:51:00+10:00,2023-06-05,00:51,2,1,3
37,2023-06-05T00:51:00+10:00,2023-06-05,00:51,1,5,6
66,2023-06-05T00:51:00+10:00,2023-06-05,00:51,2,2,4
46,2023-06-05T00:51:00+10:00,2023-06-05,00:51,1,0,1
3,2023-06-05T00:51:00+10:00,2023-06-05,00:51,1,2,3
4,2023-06-05T00:51:00+10:00,2023-06-05,00:51,3,0,3
5,2023-06-05T00:51:00+10:00,2023-06-05,00:51,0,1,1
47,2023-06-05T00:51:00+10:00,2023-06-05,00:51,0,3,3
55,2023-06-05T00:51:00+10:00,2023-06-05,00:51,6,1,7
69,2023-06-05T00:51:00+10:00,2023-06-05,00:51,1,0,1
2,2023-06-05T00:51:00+10:00,2023-06-05,00:51,0,1,1
67,2023-06-05T00:51:00+10:00,2023-06-05,00:51,0,2,2
3,2023-06-05T00:50:00+10:00,2023-06-05,00:50,4,0,4
26,2023-06-05T00:50:00+10:00,2023-06-05,00:50,1,1,2
41,2023-06-05T00:50:00+10:00,2023-06-05,00:50,0,1,1
62,2023-06-05T00:50:00+10:00,2023-06-05,00:50,4,2,6
79,2023-06-05T00:50:00+10:00,2023-06-05,00:50,0,1,1
42,2023-06-05T00:50:00+10:00,2023-06-05,00:50,0,2,2
45,2023-06-05T00:50:00+10:00,2023-06-05,00:50,0,1,1
54,2023-06-05T00:50:00+10:00,2023-06-05,00:50,2,1,3
55,2023-06-05T00:50:00+10:00,2023-06-05,00:50,5,0,5
65,2023-06-05T00:50:00+10:00,2023-06-05,00:50,0,1,1
75,2023-06-05T00:50:00+10:00,2023-06-05,00:50,1,0,1
84,2023-06-05T00:50:00+10:00,2023-06-05,00:50,2,0,2
1,2023-06-05T00:50:00+10:00,2023-06-05,00:50,0,1,1
24,2023-06-05T00:50:00+10:00,2023-06-05,00:50,2,2,4
35,2023-06-05T00:50:00+10:00,2023-06-05,00:50,0,2,2
46,2023-06-05T00:50:00+10:00,2023-06-05,00:50,1,0,1
117,2023-06-05T00:50:00+10:00,2023-06-05,00:50,1,0,1
59,2023-06-05T00:50:00+10:00,2023-06-05,00:50,11,5,16
66,2023-06-05T00:50:00+10:00,2023-06-05,00:50,2,0,2
58,2023-06-05T00:50:00+10:00,2023-06-05,00:50,1,2,3
109,2023-06-05T00:50:00+10:00,2023-06-05,00:50,0,1,1
6,2023-06-05T00:49:00+10:00,2023-06-05,00:49,3,0,3
29,2023-06-05T00:49:00+10:00,2023-06-05,00:49,1,2,3
41,2023-06-05T00:49:00+10:00,2023-06-05,00:49,0,1,1
45,2023-06-05T00:49:00+10:00,2023-06-05,00:49,0,2,2
54,2023-06-05T00:49:00+10:00,2023-06-05,00:49,2,2,4
48,2023-06-05T00:49:00+10:00,2023-06-05,00:49,0,1,1
62,2023-06-05T00:49:00+10:00,2023-06-05,00:49,4,0,4
21,2023-06-05T00:49:00+10:00,2023-06-05,00:49,0,1,1
47,2023-06-05T00:49:00+10:00,2023-06-05,00:49,0,3,3
9,2023-06-05T00:49:00+10:00,2023-06-05,00:49,0,1,1
24,2023-06-05T00:49:00+10:00,2023-06-05,00:49,2,0,2
35,2023-06-05T00:49:00+10:00,2023-06-05,00:49,0,1,1
58,2023-06-05T00:49:00+10:00,2023-06-05,00:49,0,1,1
72,2023-06-05T00:49:00+10:00,2023-06-05,00:49,1,0,1
3,2023-06-05T00:49:00+10:00,2023-06-05,00:49,0,1,1
4,2023-06-05T00:49:00+10:00,2023-06-05,00:49,0,2,2
8,2023-06-05T00:49:00+10:00,2023-06-05,00:49,0,1,1
26,2023-06-05T00:49:00+10:00,2023-06-05,00:49,0,2,2
55,2023-06-05T00:49:00+10:00,2023-06-05,00:49,1,0,1
66,2023-06-05T00:49:00+10:00,2023-06-05,00:49,2,0,2
14,2023-06-05T00:48:00+10:00,2023-06-05,00:48,0,1,1
42,2023-06-05T00:48:00+10:00,2023-06-05,00:48,0,2,2
47,2023-06-05T00:48:00+10:00,2023-06-05,00:48,0,1,1
55,2023-06-05T00:48:00+10:00,2023-06-05,00:48,2,3,5
35,2023-06-05T00:48:00+10:00,2023-06-05,00:48,3,2,5
51,2023-06-05T00:48:00+10:00,2023-06-05,00:48,2,0,2
79,2023-06-05T00:48:00+10:00,2023-06-05,00:48,1,0,1
31,2023-06-05T00:48:00+10:00,2023-06-05,00:48,0,1,1
41,2023-06-05T00:48:00+10:00,2023-06-05,00:48,2,0,2
19,2023-06-05T00:48:00+10:00,2023-06-05,00:48,6,0,6
62,2023-06-05T00:48:00+10:00,2023-06-05,00:48,1,0,1
3,2023-06-05T00:48:00+10:00,2023-06-05,00:48,2,1,3
26,2023-06-05T00:48:00+10:00,2023-06-05,00:48,0,2,2
28,2023-06-05T00:48:00+10:00,2023-06-05,00:48,1,0,1
44,2023-06-05T00:48:00+10:00,2023-06-05,00:48,0,1,1
45,2023-06-05T00:48:00+10:00,2023-06-05,00:48,0,3,3
54,2023-06-05T00:48:00+10:00,2023-06-05,00:48,0,1,1
77,2023-06-05T00:48:00+10:00,2023-06-05,00:48,0,1,1
49,2023-06-05T00:48:00+10:00,2023-06-05,00:48,7,0,7
21,2023-06-05T00:47:00+10:00,2023-06-05,00:47,0,1,1
55,2023-06-05T00:47:00+10:00,2023-06-05,00:47,1,0,1
30,2023-06-05T00:47:00+10:00,2023-06-05,00:47,2,1,3
49,2023-06-05T00:47:00+10:00,2023-06-05,00:47,0,1,1
56,2023-06-05T00:47:00+10:00,2023-06-05,00:47,0,1,1
3,2023-06-05T00:47:00+10:00,2023-06-05,00:47,2,1,3
6,2023-06-05T00:47:00+10:00,2023-06-05,00:47,0,2,2
26,2023-06-05T00:47:00+10:00,2023-06-05,00:47,3,0,3
66,2023-06-05T00:47:00+10:00,2023-06-05,00:47,2,3,5
19,2023-06-05T00:47:00+10:00,2023-06-05,00:47,1,0,1
58,2023-06-05T00:47:00+10:00,2023-06-05,00:47,2,0,2
86,2023-06-05T00:47:00+10:00,2023-06-05,00:47,0,1,1
4,2023-06-05T00:47:00+10:00,2023-06-05,00:47,3,0,3
36,2023-06-05T00:47:00+10:00,2023-06-05,00:47,2,0,2
47,2023-06-05T00:47:00+10:00,2023-06-05,00:47,1,0,1
35,2023-06-05T00:47:00+10:00,2023-06-05,00:47,3,2,5
53,2023-06-05T00:47:00+10:00,2023-06-05,00:47,0,1,1
6,2023-06-05T00:46:00+10:00,2023-06-05,00:46,0,2,2
26,2023-06-05T00:46:00+10:00,2023-06-05,00:46,0,1,1
36,2023-06-05T00:46:00+10:00,2023-06-05,00:46,3,0,3
41,2023-06-05T00:46:00+10:00,2023-06-05,00:46,2,0,2
55,2023-06-05T00:46:00+10:00,2023-06-05,00:46,2,3,5
61,2023-06-05T00:46:00+10:00,2023-06-05,00:46,0,2,2
66,2023-06-05T00:46:00+10:00,2023-06-05,00:46,2,0,2
1,2023-06-05T00:46:00+10:00,2023-06-05,00:46,1,0,1
17,2023-06-05T00:46:00+10:00,2023-06-05,00:46,1,0,1
46,2023-06-05T00:46:00+10:00,2023-06-05,00:46,0,1,1
52,2023-06-05T00:46:00+10:00,2023-06-05,00:46,0,1,1
62,2023-06-05T00:46:00+10:00,2023-06-05,00:46,4,1,5
79,2023-06-05T00:46:00+10:00,2023-06-05,00:46,0,1,1
49,2023-06-05T00:46:00+10:00,2023-06-05,00:46,0,2,2
3,2023-06-05T00:46:00+10:00,2023-06-05,00:46,1,2,3
4,2023-06-05T00:46:00+10:00,2023-06-05,00:46,0,1,1
28,2023-06-05T00:46:00+10:00,2023-06-05,00:46,1,0,1
47,2023-06-05T00:46:00+10:00,2023-06-05,00:46,1,2,3
75,2023-06-05T00:46:00+10:00,2023-06-05,00:46,1,2,3
57,2023-06-05T00:46:00+10:00,2023-06-05,00:46,1,0,1
6,2023-06-05T00:45:00+10:00,2023-06-05,00:45,1,0,1
59,2023-06-05T00:45:00+10:00,2023-06-05,00:45,1,1,2
84,2023-06-05T00:45:00+10:00,2023-06-05,00:45,4,1,5
107,2023-06-05T00:45:00+10:00,2023-06-05,00:45,1,3,4
12,2023-06-05T00:45:00+10:00,2023-06-05,00:45,1,0,1
49,2023-06-05T00:45:00+10:00,2023-06-05,00:45,2,0,2
62,2023-06-05T00:45:00+10:00,2023-06-05,00:45,1,0,1
117,2023-06-05T00:45:00+10:00,2023-06-05,00:45,5,0,5
47,2023-06-05T00:45:00+10:00,2023-06-05,00:45,0,1,1
24,2023-06-05T00:45:00+10:00,2023-06-05,00:45,1,0,1
51,2023-06-05T00:45:00+10:00,2023-06-05,00:45,1,0,1
3,2023-06-05T00:45:00+10:00,2023-06-05,00:45,2,0,2
55,2023-06-05T00:45:00+10:00,2023-06-05,00:45,1,1,2
66,2023-06-05T00:45:00+10:00,2023-06-05,00:45,0,1,1
30,2023-06-05T00:45:00+10:00,2023-06-05,00:45,0,3,3
35,2023-06-05T00:45:00+10:00,2023-06-05,00:45,0,3,3
58,2023-06-05T00:45:00+10:00,2023-06-05,00:45,0,2,2
67,2023-06-05T00:45:00+10:00,2023-06-05,00:45,3,0,3
79,2023-06-05T00:45:00+10:00,2023-06-05,00:45,1,1,2
109,2023-06-05T00:45:00+10:00,2023-06-05,00:45,0,2,2
5,2023-06-05T00:44:00+10:00,2023-06-05,00:44,0,1,1
21,2023-06-05T00:44:00+10:00,2023-06-05,00:44,3,3,6
26,2023-06-05T00:44:00+10:00,2023-06-05,00:44,3,0,3
24,2023-06-05T00:44:00+10:00,2023-06-05,00:44,0,1,1
49,2023-06-05T00:44:00+10:00,2023-06-05,00:44,0,2,2
3,2023-06-05T00:44:00+10:00,2023-06-05,00:44,4,0,4
4,2023-06-05T00:44:00+10:00,2023-06-05,00:44,1,0,1
47,2023-06-05T00:44:00+10:00,2023-06-05,00:44,2,1,3
51,2023-06-05T00:44:00+10:00,2023-06-05,00:44,3,2,5
62,2023-06-05T00:44:00+10:00,2023-06-05,00:44,0,2,2
41,2023-06-05T00:44:00+10:00,2023-06-05,00:44,2,3,5
55,2023-06-05T00:44:00+10:00,2023-06-05,00:44,2,3,5
65,2023-06-05T00:44:00+10:00,2023-06-05,00:44,2,2,4
71,2023-06-05T00:44:00+10:00,2023-06-05,00:44,1,1,2
72,2023-06-05T00:44:00+10:00,2023-06-05,00:44,2,0,2
6,2023-06-05T00:43:00+10:00,2023-06-05,00:43,0,2,2
26,2023-06-05T00:43:00+10:00,2023-06-05,00:43,0,2,2
54,2023-06-05T00:43:00+10:00,2023-06-05,00:43,1,0,1
65,2023-06-05T00:43:00+10:00,2023-06-05,00:43,0,1,1
71,2023-06-05T00:43:00+10:00,2023-06-05,00:43,1,0,1
75,2023-06-05T00:43:00+10:00,2023-06-05,00:43,1,0,1
30,2023-06-05T00:43:00+10:00,2023-06-05,00:43,2,0,2
48,2023-06-05T00:43:00+10:00,2023-06-05,00:43,0,2,2
52,2023-06-05T00:43:00+10:00,2023-06-05,00:43,0,2,2
3,2023-06-05T00:43:00+10:00,2023-06-05,00:43,4,4,8
4,2023-06-05T00:43:00+10:00,2023-06-05,00:43,3,0,3
21,2023-06-05T00:43:00+10:00,2023-06-05,00:43,0,3,3
41,2023-06-05T00:43:00+10:00,2023-06-05,00:43,0,1,1
42,2023-06-05T00:43:00+10:00,2023-06-05,00:43,1,0,1
47,2023-06-05T00:43:00+10:00,2023-06-05,00:43,2,0,2
55,2023-06-05T00:43:00+10:00,2023-06-05,00:43,2,3,5
77,2023-06-05T00:43:00+10:00,2023-06-05,00:43,1,0,1
24,2023-06-05T00:43:00+10:00,2023-06-05,00:43,0,3,3
58,2023-06-05T00:43:00+10:00,2023-06-05,00:43,1,1,2
62,2023-06-05T00:43:00+10:00,2023-06-05,00:43,1,0,1
3,2023-06-05T00:42:00+10:00,2023-06-05,00:42,0,2,2
4,2023-06-05T00:42:00+10:00,2023-06-05,00:42,0,1,1
36,2023-06-05T00:42:00+10:00,2023-06-05,00:42,1,0,1
58,2023-06-05T00:42:00+10:00,2023-06-05,00:42,2,0,2
62,2023-06-05T00:42:00+10:00,2023-06-05,00:42,8,1,9
5,2023-06-05T00:42:00+10:00,2023-06-05,00:42,1,0,1
21,2023-06-05T00:42:00+10:00,2023-06-05,00:42,0,8,8
26,2023-06-05T00:42:00+10:00,2023-06-05,00:42,0,1,1
41,2023-06-05T00:42:00+10:00,2023-06-05,00:42,0,2,2
42,2023-06-05T00:42:00+10:00,2023-06-05,00:42,1,0,1
54,2023-06-05T00:42:00+10:00,2023-06-05,00:42,0,2,2
55,2023-06-05T00:42:00+10:00,2023-06-05,00:42,0,1,1
46,2023-06-05T00:42:00+10:00,2023-06-05,00:42,0,2,2
61,2023-06-05T00:42:00+10:00,2023-06-05,00:42,0,4,4
35,2023-06-05T00:42:00+10:00,2023-06-05,00:42,0,3,3
79,2023-06-05T00:42:00+10:00,2023-06-05,00:42,0,1,1
14,2023-06-05T00:41:00+10:00,2023-06-05,00:41,1,0,1
54,2023-06-05T00:41:00+10:00,2023-06-05,00:41,0,1,1
77,2023-06-05T00:41:00+10:00,2023-06-05,00:41,1,0,1
30,2023-06-05T00:41:00+10:00,2023-06-05,00:41,0,1,1
46,2023-06-05T00:41:00+10:00,2023-06-05,00:41,2,0,2
58,2023-06-05T00:41:00+10:00,2023-06-05,00:41,1,0,1
3,2023-06-05T00:41:00+10:00,2023-06-05,00:41,1,2,3
41,2023-06-05T00:41:00+10:00,2023-06-05,00:41,2,0,2
45,2023-06-05T00:41:00+10:00,2023-06-05,00:41,0,2,2
50,2023-06-05T00:41:00+10:00,2023-06-05,00:41,0,1,1
6,2023-06-05T00:41:00+10:00,2023-06-05,00:41,1,1,2
26,2023-06-05T00:41:00+10:00,2023-06-05,00:41,1,2,3
42,2023-06-05T00:41:00+10:00,2023-06-05,00:41,0,3,3
47,2023-06-05T00:41:00+10:00,2023-06-05,00:41,0,2,2
55,2023-06-05T00:41:00+10:00,2023-06-05,00:41,1,3,4
2,2023-06-05T00:41:00+10:00,2023-06-05,00:41,1,1,2
19,2023-06-05T00:41:00+10:00,2023-06-05,00:41,1,0,1
49,2023-06-05T00:41:00+10:00,2023-06-05,00:41,1,4,5
62,2023-06-05T00:41:00+10:00,2023-06-05,00:41,0,2,2
4,2023-06-05T00:40:00+10:00,2023-06-05,00:40,0,4,4
47,2023-06-05T00:40:00+10:00,2023-06-05,00:40,0,1,1
107,2023-06-05T00:40:00+10:00,2023-06-05,00:40,2,0,2
2,2023-06-05T00:40:00+10:00,2023-06-05,00:40,0,1,1
30,2023-06-05T00:40:00+10:00,2023-06-05,00:40,1,0,1
49,2023-06-05T00:40:00+10:00,2023-06-05,00:40,0,2,2
6,2023-06-05T00:40:00+10:00,2023-06-05,00:40,1,0,1
21,2023-06-05T00:40:00+10:00,2023-06-05,00:40,0,2,2
26,2023-06-05T00:40:00+10:00,2023-06-05,00:40,1,0,1
45,2023-06-05T00:40:00+10:00,2023-06-05,00:40,2,0,2
59,2023-06-05T00:40:00+10:00,2023-06-05,00:40,8,4,12
84,2023-06-05T00:40:00+10:00,2023-06-05,00:40,1,2,3
20,2023-06-05T00:40:00+10:00,2023-06-05,00:40,0,2,2
24,2023-06-05T00:40:00+10:00,2023-06-05,00:40,0,2,2
3,2023-06-05T00:40:00+10:00,2023-06-05,00:40,1,1,2
54,2023-06-05T00:40:00+10:00,2023-06-05,00:40,0,3,3
55,2023-06-05T00:40:00+10:00,2023-06-05,00:40,3,7,10
71,2023-06-05T00:40:00+10:00,2023-06-05,00:40,0,1,1
11,2023-06-05T00:40:00+10:00,2023-06-05,00:40,1,0,1
35,2023-06-05T00:40:00+10:00,2023-06-05,00:40,0,1,1
52,2023-06-05T00:40:00+10:00,2023-06-05,00:40,0,1,1
62,2023-06-05T00:40:00+10:00,2023-06-05,00:40,3,1,4
1,2023-06-05T00:39:00+10:00,2023-06-05,00:39,0,1,1
24,2023-06-05T00:39:00+10:00,2023-06-05,00:39,1,0,1
49,2023-06-05T00:39:00+10:00,2023-06-05,00:39,3,1,4
62,2023-06-05T00:39:00+10:00,2023-06-05,00:39,2,2,4
4,2023-06-05T00:39:00+10:00,2023-06-05,00:39,1,2,3
5,2023-06-05T00:39:00+10:00,2023-06-05,00:39,1,0,1
26,2023-06-05T00:39:00+10:00,2023-06-05,00:39,0,1,1
28,2023-06-05T00:39:00+10:00,2023-06-05,00:39,0,2,2
40,2023-06-05T00:39:00+10:00,2023-06-05,00:39,1,0,1
2,2023-06-05T00:39:00+10:00,2023-06-05,00:39,1,0,1
46,2023-06-05T00:39:00+10:00,2023-06-05,00:39,1,1,2
85,2023-06-05T00:39:00+10:00,2023-06-05,00:39,0,1,1
3,2023-06-05T00:39:00+10:00,2023-06-05,00:39,3,0,3
6,2023-06-05T00:39:00+10:00,2023-06-05,00:39,0,3,3
21,2023-06-05T00:39:00+10:00,2023-06-05,00:39,2,0,2
55,2023-06-05T00:39:00+10:00,2023-06-05,00:39,5,0,5
61,2023-06-05T00:39:00+10:00,2023-06-05,00:39,3,0,3
65,2023-06-05T00:39:00+10:00,2023-06-05,00:39,0,1,1
58,2023-06-05T00:39:00+10:00,2023-06-05,00:39,2,3,5
26,2023-06-05T00:38:00+10:00,2023-06-05,00:38,1,0,1
41,2023-06-05T00:38:00+10:00,2023-06-05,00:38,1,0,1
61,2023-06-05T00:38:00+10:00,2023-06-05,00:38,0,1,1
77,2023-06-05T00:38:00+10:00,2023-06-05,00:38,1,0,1
17,2023-06-05T00:38:00+10:00,2023-06-05,00:38,2,0,2
19,2023-06-05T00:38:00+10:00,2023-06-05,00:38,0,1,1
24,2023-06-05T00:38:00+10:00,2023-06-05,00:38,6,0,6
58,2023-06-05T00:38:00+10:00,2023-06-05,00:38,0,1,1
6,2023-06-05T00:38:00+10:00,2023-06-05,00:38,0,2,2
37,2023-06-05T00:38:00+10:00,2023-06-05,00:38,1,0,1
54,2023-06-05T00:38:00+10:00,2023-06-05,00:38,1,1,2
55,2023-06-05T00:38:00+10:00,2023-06-05,00:38,0,2,2
1,2023-06-05T00:38:00+10:00,2023-06-05,00:38,2,0,2
9,2023-06-05T00:38:00+10:00,2023-06-05,00:38,0,1,1
48,2023-06-05T00:38:00+10:00,2023-06-05,00:38,0,1,1
49,2023-06-05T00:38:00+10:00,2023-06-05,00:38,0,1,1
3,2023-06-05T00:38:00+10:00,2023-06-05,00:38,0,3,3
5,2023-06-05T00:38:00+10:00,2023-06-05,00:38,1,1,2
66,2023-06-05T00:38:00+10:00,2023-06-05,00:38,0,1,1
108,2023-06-05T00:38:00+10:00,2023-06-05,00:38,0,1,1
35,2023-06-05T00:38:00+10:00,2023-06-05,00:38,1,0,1
5,2023-06-05T00:37:00+10:00,2023-06-05,00:37,1,0,1
42,2023-06-05T00:37:00+10:00,2023-06-05,00:37,0,3,3
47,2023-06-05T00:37:00+10:00,2023-06-05,00:37,3,0,3
54,2023-06-05T00:37:00+10:00,2023-06-05,00:37,0,3,3
55,2023-06-05T00:37:00+10:00,2023-06-05,00:37,3,0,3
9,2023-06-05T00:37:00+10:00,2023-06-05,00:37,2,0,2
30,2023-06-05T00:37:00+10:00,2023-06-05,00:37,0,3,3
79,2023-06-05T00:37:00+10:00,2023-06-05,00:37,2,0,2
45,2023-06-05T00:37:00+10:00,2023-06-05,00:37,0,4,4
71,2023-06-05T00:37:00+10:00,2023-06-05,00:37,1,0,1
2,2023-06-05T00:37:00+10:00,2023-06-05,00:37,1,0,1
24,2023-06-05T00:37:00+10:00,2023-06-05,00:37,1,0,1
35,2023-06-05T00:37:00+10:00,2023-06-05,00:37,0,1,1
49,2023-06-05T00:37:00+10:00,2023-06-05,00:37,4,0,4
62,2023-06-05T00:37:00+10:00,2023-06-05,00:37,6,1,7
3,2023-06-05T00:37:00+10:00,2023-06-05,00:37,1,4,5
26,2023-06-05T00:37:00+10:00,2023-06-05,00:37,2,0,2
29,2023-06-05T00:37:00+10:00,2023-06-05,00:37,0,1,1
41,2023-06-05T00:37:00+10:00,2023-06-05,00:37,1,0,1
61,2023-06-05T00:37:00+10:00,2023-06-05,00:37,2,0,2
19,2023-06-05T00:37:00+10:00,2023-06-05,00:37,4,0,4
23,2023-06-05T00:37:00+10:00,2023-06-05,00:37,1,0,1
58,2023-06-05T00:37:00+10:00,2023-06-05,00:37,0,2,2
67,2023-06-05T00:37:00+10:00,2023-06-05,00:37,1,0,1
4,2023-06-05T00:36:00+10:00,2023-06-05,00:36,1,0,1
26,2023-06-05T00:36:00+10:00,2023-06-05,00:36,2,1,3
41,2023-06-05T00:36:00+10:00,2023-06-05,00:36,0,3,3
45,2023-06-05T00:36:00+10:00,2023-06-05,00:36,0,1,1
47,2023-06-05T00:36:00+10:00,2023-06-05,00:36,2,0,2
65,2023-06-05T00:36:00+10:00,2023-06-05,00:36,0,2,2
2,2023-06-05T00:36:00+10:00,2023-06-05,00:36,0,1,1
79,2023-06-05T00:36:00+10:00,2023-06-05,00:36,0,4,4
36,2023-06-05T00:36:00+10:00,2023-06-05,00:36,1,0,1
55,2023-06-05T00:36:00+10:00,2023-06-05,00:36,5,3,8
66,2023-06-05T00:36:00+10:00,2023-06-05,00:36,2,0,2
71,2023-06-05T00:36:00+10:00,2023-06-05,00:36,0,1,1
62,2023-06-05T00:36:00+10:00,2023-06-05,00:36,5,0,5
72,2023-06-05T00:36:00+10:00,2023-06-05,00:36,0,1,1
3,2023-06-05T00:36:00+10:00,2023-06-05,00:36,6,0,6
18,2023-06-05T00:36:00+10:00,2023-06-05,00:36,1,0,1
23,2023-06-05T00:36:00+10:00,2023-06-05,00:36,0,2,2
27,2023-06-05T00:36:00+10:00,2023-06-05,00:36,2,0,2
35,2023-06-05T00:36:00+10:00,2023-06-05,00:36,4,0,4
47,2023-06-05T00:35:00+10:00,2023-06-05,00:35,5,0,5
84,2023-06-05T00:35:00+10:00,2023-06-05,00:35,4,3,7
17,2023-06-05T00:35:00+10:00,2023-06-05,00:35,4,0,4
57,2023-06-05T00:35:00+10:00,2023-06-05,00:35,2,1,3
79,2023-06-05T00:35:00+10:00,2023-06-05,00:35,1,3,4
3,2023-06-05T00:35:00+10:00,2023-06-05,00:35,3,0,3
4,2023-06-05T00:35:00+10:00,2023-06-05,00:35,2,0,2
31,2023-06-05T00:35:00+10:00,2023-06-05,00:35,0,1,1
42,2023-06-05T00:35:00+10:00,2023-06-05,00:35,0,2,2
44,2023-06-05T00:35:00+10:00,2023-06-05,00:35,0,1,1
59,2023-06-05T00:35:00+10:00,2023-06-05,00:35,7,2,9
66,2023-06-05T00:35:00+10:00,2023-06-05,00:35,3,0,3
24,2023-06-05T00:35:00+10:00,2023-06-05,00:35,2,1,3
52,2023-06-05T00:35:00+10:00,2023-06-05,00:35,1,1,2
56,2023-06-05T00:35:00+10:00,2023-06-05,00:35,0,1,1
58,2023-06-05T00:35:00+10:00,2023-06-05,00:35,0,1,1
21,2023-06-05T00:35:00+10:00,2023-06-05,00:35,0,3,3
26,2023-06-05T00:35:00+10:00,2023-06-05,00:35,0,1,1
28,2023-06-05T00:35:00+10:00,2023-06-05,00:35,2,0,2
37,2023-06-05T00:35:00+10:00,2023-06-05,00:35,4,0,4
45,2023-06-05T00:35:00+10:00,2023-06-05,00:35,0,1,1
55,2023-06-05T00:35:00+10:00,2023-06-05,00:35,1,3,4
71,2023-06-05T00:35:00+10:00,2023-06-05,00:35,1,0,1
1,2023-06-05T00:35:00+10:00,2023-06-05,00:35,0,1,1
49,2023-06-05T00:35:00+10:00,2023-06-05,00:35,0,1,1
62,2023-06-05T00:35:00+10:00,2023-06-05,00:35,0,1,1
109,2023-06-05T00:35:00+10:00,2023-06-05,00:35,4,0,4
117,2023-06-05T00:35:00+10:00,2023-06-05,00:35,2,0,2
4,2023-06-05T00:34:00+10:00,2023-06-05,00:34,1,0,1
21,2023-06-05T00:34:00+10:00,2023-06-05,00:34,11,2,13
44,2023-06-05T00:34:00+10:00,2023-06-05,00:34,1,0,1
47,2023-06-05T00:34:00+10:00,2023-06-05,00:34,1,1,2
71,2023-06-05T00:34:00+10:00,2023-06-05,00:34,0,1,1
56,2023-06-05T00:34:00+10:00,2023-06-05,00:34,0,1,1
58,2023-06-05T00:34:00+10:00,2023-06-05,00:34,1,3,4
24,2023-06-05T00:34:00+10:00,2023-06-05,00:34,2,0,2
30,2023-06-05T00:34:00+10:00,2023-06-05,00:34,1,2,3
35,2023-06-05T00:34:00+10:00,2023-06-05,00:34,2,2,4
48,2023-06-05T00:34:00+10:00,2023-06-05,00:34,0,1,1
62,2023-06-05T00:34:00+10:00,2023-06-05,00:34,2,0,2
79,2023-06-05T00:34:00+10:00,2023-06-05,00:34,0,2,2
3,2023-06-05T00:34:00+10:00,2023-06-05,00:34,2,2,4
26,2023-06-05T00:34:00+10:00,2023-06-05,00:34,1,2,3
41,2023-06-05T00:34:00+10:00,2023-06-05,00:34,2,0,2
55,2023-06-05T00:34:00+10:00,2023-06-05,00:34,1,1,2
66,2023-06-05T00:34:00+10:00,2023-06-05,00:34,6,0,6
77,2023-06-05T00:34:00+10:00,2023-06-05,00:34,0,1,1
27,2023-06-05T00:34:00+10:00,2023-06-05,00:34,1,0,1
26,2023-06-05T00:33:00+10:00,2023-06-05,00:33,0,1,1
29,2023-06-05T00:33:00+10:00,2023-06-05,00:33,1,0,1
71,2023-06-05T00:33:00+10:00,2023-06-05,00:33,1,0,1
23,2023-06-05T00:33:00+10:00,2023-06-05,00:33,0,4,4
49,2023-06-05T00:33:00+10:00,2023-06-05,00:33,0,1,1
4,2023-06-05T00:33:00+10:00,2023-06-05,00:33,1,0,1
66,2023-06-05T00:33:00+10:00,2023-06-05,00:33,1,0,1
9,2023-06-05T00:33:00+10:00,2023-06-05,00:33,0,1,1
18,2023-06-05T00:33:00+10:00,2023-06-05,00:33,1,0,1
19,2023-06-05T00:33:00+10:00,2023-06-05,00:33,1,0,1
24,2023-06-05T00:33:00+10:00,2023-06-05,00:33,0,2,2
30,2023-06-05T00:33:00+10:00,2023-06-05,00:33,0,4,4
58,2023-06-05T00:33:00+10:00,2023-06-05,00:33,1,0,1
3,2023-06-05T00:33:00+10:00,2023-06-05,00:33,4,0,4
28,2023-06-05T00:33:00+10:00,2023-06-05,00:33,2,0,2
37,2023-06-05T00:33:00+10:00,2023-06-05,00:33,0,3,3
41,2023-06-05T00:33:00+10:00,2023-06-05,00:33,2,0,2
45,2023-06-05T00:33:00+10:00,2023-06-05,00:33,0,2,2
47,2023-06-05T00:33:00+10:00,2023-06-05,00:33,1,0,1
54,2023-06-05T00:33:00+10:00,2023-06-05,00:33,0,2,2
55,2023-06-05T00:33:00+10:00,2023-06-05,00:33,5,4,9
61,2023-06-05T00:33:00+10:00,2023-06-05,00:33,2,1,3
12,2023-06-05T00:33:00+10:00,2023-06-05,00:33,0,1,1
51,2023-06-05T00:33:00+10:00,2023-06-05,00:33,1,0,1
79,2023-06-05T00:33:00+10:00,2023-06-05,00:33,1,4,5
3,2023-06-05T00:32:00+10:00,2023-06-05,00:32,2,1,3
4,2023-06-05T00:32:00+10:00,2023-06-05,00:32,1,0,1
6,2023-06-05T00:32:00+10:00,2023-06-05,00:32,2,0,2
41,2023-06-05T00:32:00+10:00,2023-06-05,00:32,0,2,2
55,2023-06-05T00:32:00+10:00,2023-06-05,00:32,0,1,1
48,2023-06-05T00:32:00+10:00,2023-06-05,00:32,0,1,1
62,2023-06-05T00:32:00+10:00,2023-06-05,00:32,0,4,4
37,2023-06-05T00:32:00+10:00,2023-06-05,00:32,0,4,4
45,2023-06-05T00:32:00+10:00,2023-06-05,00:32,0,2,2
61,2023-06-05T00:32:00+10:00,2023-06-05,00:32,1,0,1
23,2023-06-05T00:32:00+10:00,2023-06-05,00:32,2,0,2
24,2023-06-05T00:32:00+10:00,2023-06-05,00:32,3,3,6
30,2023-06-05T00:32:00+10:00,2023-06-05,00:32,3,3,6
35,2023-06-05T00:32:00+10:00,2023-06-05,00:32,0,2,2
21,2023-06-05T00:32:00+10:00,2023-06-05,00:32,2,1,3
28,2023-06-05T00:32:00+10:00,2023-06-05,00:32,3,0,3
29,2023-06-05T00:32:00+10:00,2023-06-05,00:32,0,1,1
54,2023-06-05T00:32:00+10:00,2023-06-05,00:32,0,3,3
65,2023-06-05T00:32:00+10:00,2023-06-05,00:32,1,0,1
66,2023-06-05T00:32:00+10:00,2023-06-05,00:32,1,0,1
71,2023-06-05T00:32:00+10:00,2023-06-05,00:32,2,1,3
3,2023-06-05T00:31:00+10:00,2023-06-05,00:31,1,0,1
4,2023-06-05T00:31:00+10:00,2023-06-05,00:31,2,0,2
21,2023-06-05T00:31:00+10:00,2023-06-05,00:31,3,4,7
47,2023-06-05T00:31:00+10:00,2023-06-05,00:31,5,5,10
55,2023-06-05T00:31:00+10:00,2023-06-05,00:31,2,0,2
71,2023-06-05T00:31:00+10:00,2023-06-05,00:31,0,1,1
1,2023-06-05T00:31:00+10:00,2023-06-05,00:31,1,0,1
12,2023-06-05T00:31:00+10:00,2023-06-05,00:31,0,1,1
19,2023-06-05T00:31:00+10:00,2023-06-05,00:31,0,5,5
37,2023-06-05T00:31:00+10:00,2023-06-05,00:31,1,0,1
58,2023-06-05T00:31:00+10:00,2023-06-05,00:31,3,0,3
26,2023-06-05T00:31:00+10:00,2023-06-05,00:31,2,1,3
41,2023-06-05T00:31:00+10:00,2023-06-05,00:31,1,5,6
65,2023-06-05T00:31:00+10:00,2023-06-05,00:31,0,3,3
66,2023-06-05T00:31:00+10:00,2023-06-05,00:31,0,1,1
2,2023-06-05T00:31:00+10:00,2023-06-05,00:31,1,0,1
30,2023-06-05T00:31:00+10:00,2023-06-05,00:31,0,2,2
49,2023-06-05T00:31:00+10:00,2023-06-05,00:31,2,2,4
79,2023-06-05T00:31:00+10:00,2023-06-05,00:31,1,1,2
41,2023-06-05T00:30:00+10:00,2023-06-05,00:30,4,2,6
42,2023-06-05T00:30:00+10:00,2023-06-05,00:30,0,2,2
59,2023-06-05T00:30:00+10:00,2023-06-05,00:30,8,1,9
9,2023-06-05T00:30:00+10:00,2023-06-05,00:30,0,1,1
20,2023-06-05T00:30:00+10:00,2023-06-05,00:30,0,1,1
30,2023-06-05T00:30:00+10:00,2023-06-05,00:30,2,5,7
52,2023-06-05T00:30:00+10:00,2023-06-05,00:30,1,0,1
4,2023-06-05T00:30:00+10:00,2023-06-05,00:30,1,2,3
5,2023-06-05T00:30:00+10:00,2023-06-05,00:30,0,3,3
6,2023-06-05T00:30:00+10:00,2023-06-05,00:30,0,2,2
26,2023-06-05T00:30:00+10:00,2023-06-05,00:30,4,0,4
28,2023-06-05T00:30:00+10:00,2023-06-05,00:30,2,0,2
45,2023-06-05T00:30:00+10:00,2023-06-05,00:30,0,1,1
19,2023-06-05T00:30:00+10:00,2023-06-05,00:30,3,4,7
24,2023-06-05T00:30:00+10:00,2023-06-05,00:30,3,0,3
48,2023-06-05T00:30:00+10:00,2023-06-05,00:30,0,1,1
56,2023-06-05T00:30:00+10:00,2023-06-05,00:30,1,0,1
62,2023-06-05T00:30:00+10:00,2023-06-05,00:30,0,1,1
79,2023-06-05T00:30:00+10:00,2023-06-05,00:30,2,0,2
3,2023-06-05T00:30:00+10:00,2023-06-05,00:30,3,0,3
47,2023-06-05T00:30:00+10:00,2023-06-05,00:30,0,4,4
54,2023-06-05T00:30:00+10:00,2023-06-05,00:30,3,0,3
55,2023-06-05T00:30:00+10:00,2023-06-05,00:30,0,6,6
65,2023-06-05T00:30:00+10:00,2023-06-05,00:30,0,1,1
71,2023-06-05T00:30:00+10:00,2023-06-05,00:30,0,1,1
84,2023-06-05T00:30:00+10:00,2023-06-05,00:30,3,4,7
107,2023-06-05T00:30:00+10:00,2023-06-05,00:30,3,0,3
35,2023-06-05T00:30:00+10:00,2023-06-05,00:30,6,1,7
58,2023-06-05T00:30:00+10:00,2023-06-05,00:30,3,0,3
28,2023-06-05T00:29:00+10:00,2023-06-05,00:29,1,0,1
41,2023-06-05T00:29:00+10:00,2023-06-05,00:29,2,0,2
47,2023-06-05T00:29:00+10:00,2023-06-05,00:29,0,1,1
55,2023-06-05T00:29:00+10:00,2023-06-05,00:29,3,1,4
71,2023-06-05T00:29:00+10:00,2023-06-05,00:29,0,1,1
23,2023-06-05T00:29:00+10:00,2023-06-05,00:29,0,1,1
30,2023-06-05T00:29:00+10:00,2023-06-05,00:29,2,3,5
4,2023-06-05T00:29:00+10:00,2023-06-05,00:29,0,3,3
6,2023-06-05T00:29:00+10:00,2023-06-05,00:29,1,0,1
45,2023-06-05T00:29:00+10:00,2023-06-05,00:29,1,0,1
54,2023-06-05T00:29:00+10:00,2023-06-05,00:29,0,2,2
51,2023-06-05T00:29:00+10:00,2023-06-05,00:29,0,1,1
62,2023-06-05T00:29:00+10:00,2023-06-05,00:29,2,0,2
79,2023-06-05T00:29:00+10:00,2023-06-05,00:29,1,0,1
3,2023-06-05T00:29:00+10:00,2023-06-05,00:29,0,1,1
21,2023-06-05T00:29:00+10:00,2023-06-05,00:29,2,1,3
26,2023-06-05T00:29:00+10:00,2023-06-05,00:29,0,1,1
36,2023-06-05T00:29:00+10:00,2023-06-05,00:29,0,1,1
42,2023-06-05T00:29:00+10:00,2023-06-05,00:29,2,1,3
65,2023-06-05T00:29:00+10:00,2023-06-05,00:29,0,1,1
66,2023-06-05T00:29:00+10:00,2023-06-05,00:29,2,1,3
24,2023-06-05T00:29:00+10:00,2023-06-05,00:29,2,5,7
35,2023-06-05T00:29:00+10:00,2023-06-05,00:29,0,1,1
48,2023-06-05T00:29:00+10:00,2023-06-05,00:29,0,1,1
52,2023-06-05T00:29:00+10:00,2023-06-05,00:29,0,1,1
76,2023-06-05T00:29:00+10:00,2023-06-05,00:29,0,1,1
85,2023-06-05T00:29:00+10:00,2023-06-05,00:29,0,2,2
3,2023-06-05T00:28:00+10:00,2023-06-05,00:28,2,0,2
6,2023-06-05T00:28:00+10:00,2023-06-05,00:28,1,0,1
28,2023-06-05T00:28:00+10:00,2023-06-05,00:28,1,0,1
41,2023-06-05T00:28:00+10:00,2023-06-05,00:28,3,2,5
45,2023-06-05T00:28:00+10:00,2023-06-05,00:28,1,5,6
47,2023-06-05T00:28:00+10:00,2023-06-05,00:28,1,0,1
9,2023-06-05T00:28:00+10:00,2023-06-05,00:28,2,0,2
24,2023-06-05T00:28:00+10:00,2023-06-05,00:28,2,2,4
30,2023-06-05T00:28:00+10:00,2023-06-05,00:28,3,2,5
58,2023-06-05T00:28:00+10:00,2023-06-05,00:28,1,0,1
62,2023-06-05T00:28:00+10:00,2023-06-05,00:28,1,0,1
79,2023-06-05T00:28:00+10:00,2023-06-05,00:28,1,0,1
21,2023-06-05T00:28:00+10:00,2023-06-05,00:28,1,0,1
26,2023-06-05T00:28:00+10:00,2023-06-05,00:28,1,0,1
42,2023-06-05T00:28:00+10:00,2023-06-05,00:28,0,1,1
61,2023-06-05T00:28:00+10:00,2023-06-05,00:28,1,3,4
71,2023-06-05T00:28:00+10:00,2023-06-05,00:28,1,0,1
20,2023-06-05T00:28:00+10:00,2023-06-05,00:28,0,2,2
23,2023-06-05T00:28:00+10:00,2023-06-05,00:28,2,0,2
51,2023-06-05T00:28:00+10:00,2023-06-05,00:28,0,1,1
52,2023-06-05T00:28:00+10:00,2023-06-05,00:28,1,0,1
53,2023-06-05T00:28:00+10:00,2023-06-05,00:28,0,3,3
57,2023-06-05T00:28:00+10:00,2023-06-05,00:28,0,1,1
4,2023-06-05T00:28:00+10:00,2023-06-05,00:28,1,8,9
8,2023-06-05T00:28:00+10:00,2023-06-05,00:28,1,0,1
55,2023-06-05T00:28:00+10:00,2023-06-05,00:28,3,4,7
77,2023-06-05T00:28:00+10:00,2023-06-05,00:28,2,0,2
3,2023-06-05T00:27:00+10:00,2023-06-05,00:27,1,1,2
21,2023-06-05T00:27:00+10:00,2023-06-05,00:27,1,2,3
28,2023-06-05T00:27:00+10:00,2023-06-05,00:27,1,2,3
45,2023-06-05T00:27:00+10:00,2023-06-05,00:27,2,0,2
55,2023-06-05T00:27:00+10:00,2023-06-05,00:27,5,3,8
61,2023-06-05T00:27:00+10:00,2023-06-05,00:27,1,0,1
1,2023-06-05T00:27:00+10:00,2023-06-05,00:27,2,2,4
58,2023-06-05T00:27:00+10:00,2023-06-05,00:27,1,0,1
62,2023-06-05T00:27:00+10:00,2023-06-05,00:27,2,0,2
79,2023-06-05T00:27:00+10:00,2023-06-05,00:27,0,2,2
6,2023-06-05T00:27:00+10:00,2023-06-05,00:27,0,1,1
26,2023-06-05T00:27:00+10:00,2023-06-05,00:27,2,3,5
41,2023-06-05T00:27:00+10:00,2023-06-05,00:27,1,2,3
65,2023-06-05T00:27:00+10:00,2023-06-05,00:27,1,0,1
24,2023-06-05T00:27:00+10:00,2023-06-05,00:27,1,0,1
30,2023-06-05T00:27:00+10:00,2023-06-05,00:27,1,0,1
48,2023-06-05T00:27:00+10:00,2023-06-05,00:27,0,2,2
52,2023-06-05T00:27:00+10:00,2023-06-05,00:27,0,4,4
53,2023-06-05T00:27:00+10:00,2023-06-05,00:27,0,1,1
47,2023-06-05T00:27:00+10:00,2023-06-05,00:27,1,0,1
54,2023-06-05T00:27:00+10:00,2023-06-05,00:27,1,2,3
35,2023-06-05T00:27:00+10:00,2023-06-05,00:27,1,1,2
76,2023-06-05T00:27:00+10:00,2023-06-05,00:27,0,1,1
26,2023-06-05T00:26:00+10:00,2023-06-05,00:26,3,1,4
45,2023-06-05T00:26:00+10:00,2023-06-05,00:26,0,1,1
54,2023-06-05T00:26:00+10:00,2023-06-05,00:26,1,0,1
55,2023-06-05T00:26:00+10:00,2023-06-05,00:26,3,0,3
9,2023-06-05T00:26:00+10:00,2023-06-05,00:26,3,0,3
30,2023-06-05T00:26:00+10:00,2023-06-05,00:26,0,2,2
3,2023-06-05T00:26:00+10:00,2023-06-05,00:26,2,0,2
28,2023-06-05T00:26:00+10:00,2023-06-05,00:26,2,0,2
41,2023-06-05T00:26:00+10:00,2023-06-05,00:26,6,0,6
61,2023-06-05T00:26:00+10:00,2023-06-05,00:26,2,0,2
1,2023-06-05T00:26:00+10:00,2023-06-05,00:26,0,1,1
24,2023-06-05T00:26:00+10:00,2023-06-05,00:26,0,2,2
51,2023-06-05T00:26:00+10:00,2023-06-05,00:26,1,1,2
52,2023-06-05T00:26:00+10:00,2023-06-05,00:26,0,1,1
56,2023-06-05T00:26:00+10:00,2023-06-05,00:26,1,0,1
72,2023-06-05T00:26:00+10:00,2023-06-05,00:26,1,0,1
6,2023-06-05T00:26:00+10:00,2023-06-05,00:26,0,1,1
21,2023-06-05T00:26:00+10:00,2023-06-05,00:26,3,1,4
47,2023-06-05T00:26:00+10:00,2023-06-05,00:26,3,4,7
71,2023-06-05T00:26:00+10:00,2023-06-05,00:26,0,1,1
77,2023-06-05T00:26:00+10:00,2023-06-05,00:26,0,1,1
19,2023-06-05T00:26:00+10:00,2023-06-05,00:26,0,2,2
35,2023-06-05T00:26:00+10:00,2023-06-05,00:26,0,3,3
49,2023-06-05T00:26:00+10:00,2023-06-05,00:26,0,3,3
58,2023-06-05T00:26:00+10:00,2023-06-05,00:26,0,2,2
26,2023-06-05T00:25:00+10:00,2023-06-05,00:25,0,1,1
37,2023-06-05T00:25:00+10:00,2023-06-05,00:25,2,0,2
47,2023-06-05T00:25:00+10:00,2023-06-05,00:25,2,0,2
54,2023-06-05T00:25:00+10:00,2023-06-05,00:25,0,1,1
59,2023-06-05T00:25:00+10:00,2023-06-05,00:25,10,4,14
75,2023-06-05T00:25:00+10:00,2023-06-05,00:25,0,1,1
30,2023-06-05T00:25:00+10:00,2023-06-05,00:25,5,2,7
48,2023-06-05T00:25:00+10:00,2023-06-05,00:25,2,0,2
51,2023-06-05T00:25:00+10:00,2023-06-05,00:25,1,0,1
55,2023-06-05T00:25:00+10:00,2023-06-05,00:25,3,2,5
84,2023-06-05T00:25:00+10:00,2023-06-05,00:25,15,10,25
108,2023-06-05T00:25:00+10:00,2023-06-05,00:25,1,0,1
19,2023-06-05T00:25:00+10:00,2023-06-05,00:25,3,2,5
58,2023-06-05T00:25:00+10:00,2023-06-05,00:25,2,1,3
62,2023-06-05T00:25:00+10:00,2023-06-05,00:25,4,0,4
67,2023-06-05T00:25:00+10:00,2023-06-05,00:25,0,2,2
79,2023-06-05T00:25:00+10:00,2023-06-05,00:25,0,1,1
3,2023-06-05T00:25:00+10:00,2023-06-05,00:25,1,2,3
4,2023-06-05T00:25:00+10:00,2023-06-05,00:25,15,1,16
6,2023-06-05T00:25:00+10:00,2023-06-05,00:25,5,0,5
8,2023-06-05T00:25:00+10:00,2023-06-05,00:25,1,0,1
14,2023-06-05T00:25:00+10:00,2023-06-05,00:25,0,1,1
41,2023-06-05T00:25:00+10:00,2023-06-05,00:25,1,0,1
42,2023-06-05T00:25:00+10:00,2023-06-05,00:25,0,1,1
107,2023-06-05T00:25:00+10:00,2023-06-05,00:25,0,1,1
20,2023-06-05T00:25:00+10:00,2023-06-05,00:25,4,0,4
117,2023-06-05T00:25:00+10:00,2023-06-05,00:25,1,0,1
3,2023-06-05T00:24:00+10:00,2023-06-05,00:24,2,5,7
4,2023-06-05T00:24:00+10:00,2023-06-05,00:24,2,0,2
21,2023-06-05T00:24:00+10:00,2023-06-05,00:24,5,1,6
71,2023-06-05T00:24:00+10:00,2023-06-05,00:24,1,0,1
35,2023-06-05T00:24:00+10:00,2023-06-05,00:24,0,1,1
56,2023-06-05T00:24:00+10:00,2023-06-05,00:24,0,4,4
5,2023-06-05T00:24:00+10:00,2023-06-05,00:24,1,2,3
42,2023-06-05T00:24:00+10:00,2023-06-05,00:24,0,6,6
65,2023-06-05T00:24:00+10:00,2023-06-05,00:24,0,2,2
11,2023-06-05T00:24:00+10:00,2023-06-05,00:24,0,1,1
24,2023-06-05T00:24:00+10:00,2023-06-05,00:24,0,2,2
30,2023-06-05T00:24:00+10:00,2023-06-05,00:24,0,3,3
51,2023-06-05T00:24:00+10:00,2023-06-05,00:24,3,2,5
52,2023-06-05T00:24:00+10:00,2023-06-05,00:24,1,0,1
79,2023-06-05T00:24:00+10:00,2023-06-05,00:24,0,1,1
54,2023-06-05T00:24:00+10:00,2023-06-05,00:24,0,4,4
55,2023-06-05T00:24:00+10:00,2023-06-05,00:24,1,1,2
66,2023-06-05T00:24:00+10:00,2023-06-05,00:24,2,0,2
19,2023-06-05T00:24:00+10:00,2023-06-05,00:24,0,3,3
48,2023-06-05T00:24:00+10:00,2023-06-05,00:24,0,4,4
57,2023-06-05T00:24:00+10:00,2023-06-05,00:24,0,1,1
62,2023-06-05T00:24:00+10:00,2023-06-05,00:24,2,0,2
6,2023-06-05T00:23:00+10:00,2023-06-05,00:23,2,0,2
66,2023-06-05T00:23:00+10:00,2023-06-05,00:23,2,1,3
70,2023-06-05T00:23:00+10:00,2023-06-05,00:23,0,2,2
87,2023-06-05T00:23:00+10:00,2023-06-05,00:23,1,0,1
10,2023-06-05T00:23:00+10:00,2023-06-05,00:23,0,1,1
35,2023-06-05T00:23:00+10:00,2023-06-05,00:23,3,0,3
51,2023-06-05T00:23:00+10:00,2023-06-05,00:23,2,1,3
62,2023-06-05T00:23:00+10:00,2023-06-05,00:23,5,0,5
3,2023-06-05T00:23:00+10:00,2023-06-05,00:23,1,2,3
4,2023-06-05T00:23:00+10:00,2023-06-05,00:23,3,0,3
21,2023-06-05T00:23:00+10:00,2023-06-05,00:23,1,1,2
41,2023-06-05T00:23:00+10:00,2023-06-05,00:23,1,0,1
54,2023-06-05T00:23:00+10:00,2023-06-05,00:23,4,0,4
65,2023-06-05T00:23:00+10:00,2023-06-05,00:23,0,3,3
69,2023-06-05T00:23:00+10:00,2023-06-05,00:23,1,0,1
58,2023-06-05T00:23:00+10:00,2023-06-05,00:23,1,5,6
67,2023-06-05T00:23:00+10:00,2023-06-05,00:23,0,2,2
5,2023-06-05T00:23:00+10:00,2023-06-05,00:23,1,4,5
26,2023-06-05T00:23:00+10:00,2023-06-05,00:23,3,0,3
37,2023-06-05T00:23:00+10:00,2023-06-05,00:23,1,0,1
55,2023-06-05T00:23:00+10:00,2023-06-05,00:23,2,2,4
61,2023-06-05T00:23:00+10:00,2023-06-05,00:23,2,0,2
46,2023-06-05T00:23:00+10:00,2023-06-05,00:23,0,2,2
28,2023-06-05T00:22:00+10:00,2023-06-05,00:22,2,0,2
36,2023-06-05T00:22:00+10:00,2023-06-05,00:22,0,2,2
45,2023-06-05T00:22:00+10:00,2023-06-05,00:22,0,3,3
55,2023-06-05T00:22:00+10:00,2023-06-05,00:22,0,4,4
61,2023-06-05T00:22:00+10:00,2023-06-05,00:22,0,1,1
66,2023-06-05T00:22:00+10:00,2023-06-05,00:22,1,0,1
58,2023-06-05T00:22:00+10:00,2023-06-05,00:22,0,2,2
62,2023-06-05T00:22:00+10:00,2023-06-05,00:22,2,1,3
86,2023-06-05T00:22:00+10:00,2023-06-05,00:22,0,1,1
37,2023-06-05T00:22:00+10:00,2023-06-05,00:22,0,4,4
30,2023-06-05T00:22:00+10:00,2023-06-05,00:22,0,2,2
3,2023-06-05T00:22:00+10:00,2023-06-05,00:22,1,0,1
5,2023-06-05T00:22:00+10:00,2023-06-05,00:22,0,1,1
14,2023-06-05T00:22:00+10:00,2023-06-05,00:22,1,0,1
41,2023-06-05T00:22:00+10:00,2023-06-05,00:22,2,0,2
47,2023-06-05T00:22:00+10:00,2023-06-05,00:22,2,2,4
54,2023-06-05T00:22:00+10:00,2023-06-05,00:22,0,1,1
77,2023-06-05T00:22:00+10:00,2023-06-05,00:22,0,3,3
2,2023-06-05T00:22:00+10:00,2023-06-05,00:22,2,0,2
24,2023-06-05T00:22:00+10:00,2023-06-05,00:22,0,2,2
51,2023-06-05T00:22:00+10:00,2023-06-05,00:22,0,2,2
52,2023-06-05T00:22:00+10:00,2023-06-05,00:22,0,1,1
79,2023-06-05T00:22:00+10:00,2023-06-05,00:22,0,2,2
54,2023-06-05T00:21:00+10:00,2023-06-05,00:21,0,3,3
30,2023-06-05T00:21:00+10:00,2023-06-05,00:21,2,0,2
51,2023-06-05T00:21:00+10:00,2023-06-05,00:21,3,0,3
52,2023-06-05T00:21:00+10:00,2023-06-05,00:21,0,1,1
3,2023-06-05T00:21:00+10:00,2023-06-05,00:21,1,11,12
4,2023-06-05T00:21:00+10:00,2023-06-05,00:21,1,1,2
5,2023-06-05T00:21:00+10:00,2023-06-05,00:21,0,1,1
6,2023-06-05T00:21:00+10:00,2023-06-05,00:21,1,1,2
31,2023-06-05T00:21:00+10:00,2023-06-05,00:21,0,1,1
47,2023-06-05T00:21:00+10:00,2023-06-05,00:21,0,3,3
65,2023-06-05T00:21:00+10:00,2023-06-05,00:21,0,3,3
66,2023-06-05T00:21:00+10:00,2023-06-05,00:21,1,0,1
2,2023-06-05T00:21:00+10:00,2023-06-05,00:21,0,3,3
12,2023-06-05T00:21:00+10:00,2023-06-05,00:21,0,2,2
20,2023-06-05T00:21:00+10:00,2023-06-05,00:21,1,1,2
79,2023-06-05T00:21:00+10:00,2023-06-05,00:21,0,1,1
21,2023-06-05T00:21:00+10:00,2023-06-05,00:21,0,2,2
26,2023-06-05T00:21:00+10:00,2023-06-05,00:21,0,2,2
41,2023-06-05T00:21:00+10:00,2023-06-05,00:21,1,0,1
45,2023-06-05T00:21:00+10:00,2023-06-05,00:21,1,0,1
55,2023-06-05T00:21:00+10:00,2023-06-05,00:21,5,1,6
61,2023-06-05T00:21:00+10:00,2023-06-05,00:21,0,1,1
71,2023-06-05T00:21:00+10:00,2023-06-05,00:21,2,0,2
77,2023-06-05T00:21:00+10:00,2023-06-05,00:21,2,0,2
19,2023-06-05T00:21:00+10:00,2023-06-05,00:21,0,4,4
35,2023-06-05T00:21:00+10:00,2023-06-05,00:21,2,0,2
62,2023-06-05T00:21:00+10:00,2023-06-05,00:21,0,1,1
3,2023-06-05T00:20:00+10:00,2023-06-05,00:20,0,7,7
45,2023-06-05T00:20:00+10:00,2023-06-05,00:20,0,4,4
47,2023-06-05T00:20:00+10:00,2023-06-05,00:20,2,0,2
78,2023-06-05T00:20:00+10:00,2023-06-05,00:20,0,1,1
107,2023-06-05T00:20:00+10:00,2023-06-05,00:20,5,0,5
19,2023-06-05T00:20:00+10:00,2023-06-05,00:20,1,1,2
30,2023-06-05T00:20:00+10:00,2023-06-05,00:20,2,2,4
35,2023-06-05T00:20:00+10:00,2023-06-05,00:20,0,1,1
49,2023-06-05T00:20:00+10:00,2023-06-05,00:20,1,1,2
58,2023-06-05T00:20:00+10:00,2023-06-05,00:20,1,0,1
79,2023-06-05T00:20:00+10:00,2023-06-05,00:20,2,0,2
109,2023-06-05T00:20:00+10:00,2023-06-05,00:20,2,0,2
4,2023-06-05T00:20:00+10:00,2023-06-05,00:20,2,2,4
5,2023-06-05T00:20:00+10:00,2023-06-05,00:20,0,2,2
59,2023-06-05T00:20:00+10:00,2023-06-05,00:20,7,3,10
61,2023-06-05T00:20:00+10:00,2023-06-05,00:20,1,0,1
66,2023-06-05T00:20:00+10:00,2023-06-05,00:20,0,1,1
77,2023-06-05T00:20:00+10:00,2023-06-05,00:20,1,0,1
20,2023-06-05T00:20:00+10:00,2023-06-05,00:20,0,1,1
62,2023-06-05T00:20:00+10:00,2023-06-05,00:20,1,4,5
72,2023-06-05T00:20:00+10:00,2023-06-05,00:20,0,1,1
117,2023-06-05T00:20:00+10:00,2023-06-05,00:20,6,0,6
14,2023-06-05T00:20:00+10:00,2023-06-05,00:20,2,0,2
31,2023-06-05T00:20:00+10:00,2023-06-05,00:20,0,1,1
39,2023-06-05T00:20:00+10:00,2023-06-05,00:20,0,1,1
41,2023-06-05T00:20:00+10:00,2023-06-05,00:20,0,1,1
55,2023-06-05T00:20:00+10:00,2023-06-05,00:20,5,7,12
65,2023-06-05T00:20:00+10:00,2023-06-05,00:20,2,0,2
84,2023-06-05T00:20:00+10:00,2023-06-05,00:20,8,8,16
12,2023-06-05T00:20:00+10:00,2023-06-05,00:20,3,0,3
24,2023-06-05T00:20:00+10:00,2023-06-05,00:20,1,2,3
85,2023-06-05T00:20:00+10:00,2023-06-05,00:20,0,1,1
3,2023-06-05T00:19:00+10:00,2023-06-05,00:19,1,5,6
37,2023-06-05T00:19:00+10:00,2023-06-05,00:19,1,0,1
45,2023-06-05T00:19:00+10:00,2023-06-05,00:19,2,1,3
19,2023-06-05T00:19:00+10:00,2023-06-05,00:19,1,0,1
24,2023-06-05T00:19:00+10:00,2023-06-05,00:19,3,3,6
67,2023-06-05T00:19:00+10:00,2023-06-05,00:19,1,2,3
79,2023-06-05T00:19:00+10:00,2023-06-05,00:19,1,1,2
4,2023-06-05T00:19:00+10:00,2023-06-05,00:19,1,2,3
41,2023-06-05T00:19:00+10:00,2023-06-05,00:19,4,1,5
54,2023-06-05T00:19:00+10:00,2023-06-05,00:19,0,2,2
55,2023-06-05T00:19:00+10:00,2023-06-05,00:19,2,2,4
23,2023-06-05T00:19:00+10:00,2023-06-05,00:19,0,2,2
35,2023-06-05T00:19:00+10:00,2023-06-05,00:19,0,1,1
5,2023-06-05T00:19:00+10:00,2023-06-05,00:19,0,2,2
14,2023-06-05T00:19:00+10:00,2023-06-05,00:19,1,0,1
26,2023-06-05T00:19:00+10:00,2023-06-05,00:19,0,1,1
44,2023-06-05T00:19:00+10:00,2023-06-05,00:19,1,0,1
61,2023-06-05T00:19:00+10:00,2023-06-05,00:19,1,0,1
66,2023-06-05T00:19:00+10:00,2023-06-05,00:19,0,1,1
77,2023-06-05T00:19:00+10:00,2023-06-05,00:19,1,0,1
20,2023-06-05T00:19:00+10:00,2023-06-05,00:19,1,0,1
30,2023-06-05T00:19:00+10:00,2023-06-05,00:19,4,4,8
49,2023-06-05T00:19:00+10:00,2023-06-05,00:19,0,1,1
56,2023-06-05T00:19:00+10:00,2023-06-05,00:19,2,0,2
58,2023-06-05T00:19:00+10:00,2023-06-05,00:19,0,1,1
4,2023-06-05T00:18:00+10:00,2023-06-05,00:18,0,2,2
5,2023-06-05T00:18:00+10:00,2023-06-05,00:18,0,1,1
21,2023-06-05T00:18:00+10:00,2023-06-05,00:18,0,1,1
41,2023-06-05T00:18:00+10:00,2023-06-05,00:18,1,0,1
55,2023-06-05T00:18:00+10:00,2023-06-05,00:18,2,1,3
66,2023-06-05T00:18:00+10:00,2023-06-05,00:18,2,1,3
71,2023-06-05T00:18:00+10:00,2023-06-05,00:18,0,1,1
20,2023-06-05T00:18:00+10:00,2023-06-05,00:18,1,1,2
30,2023-06-05T00:18:00+10:00,2023-06-05,00:18,0,6,6
46,2023-06-05T00:18:00+10:00,2023-06-05,00:18,0,2,2
48,2023-06-05T00:18:00+10:00,2023-06-05,00:18,0,1,1
62,2023-06-05T00:18:00+10:00,2023-06-05,00:18,0,2,2
6,2023-06-05T00:18:00+10:00,2023-06-05,00:18,0,1,1
14,2023-06-05T00:18:00+10:00,2023-06-05,00:18,3,0,3
42,2023-06-05T00:18:00+10:00,2023-06-05,00:18,1,0,1
19,2023-06-05T00:18:00+10:00,2023-06-05,00:18,1,1,2
52,2023-06-05T00:18:00+10:00,2023-06-05,00:18,0,2,2
3,2023-06-05T00:18:00+10:00,2023-06-05,00:18,1,0,1
26,2023-06-05T00:18:00+10:00,2023-06-05,00:18,2,3,5
47,2023-06-05T00:18:00+10:00,2023-06-05,00:18,2,0,2
54,2023-06-05T00:18:00+10:00,2023-06-05,00:18,1,0,1
65,2023-06-05T00:18:00+10:00,2023-06-05,00:18,0,3,3
77,2023-06-05T00:18:00+10:00,2023-06-05,00:18,1,0,1
23,2023-06-05T00:18:00+10:00,2023-06-05,00:18,1,0,1
24,2023-06-05T00:18:00+10:00,2023-06-05,00:18,3,1,4
49,2023-06-05T00:18:00+10:00,2023-06-05,00:18,0,1,1
56,2023-06-05T00:18:00+10:00,2023-06-05,00:18,1,0,1
3,2023-06-05T00:17:00+10:00,2023-06-05,00:17,3,3,6
4,2023-06-05T00:17:00+10:00,2023-06-05,00:17,1,0,1
39,2023-06-05T00:17:00+10:00,2023-06-05,00:17,0,1,1
41,2023-06-05T00:17:00+10:00,2023-06-05,00:17,1,4,5
42,2023-06-05T00:17:00+10:00,2023-06-05,00:17,0,2,2
49,2023-06-05T00:17:00+10:00,2023-06-05,00:17,0,1,1
72,2023-06-05T00:17:00+10:00,2023-06-05,00:17,7,0,7
5,2023-06-05T00:17:00+10:00,2023-06-05,00:17,3,0,3
26,2023-06-05T00:17:00+10:00,2023-06-05,00:17,1,0,1
36,2023-06-05T00:17:00+10:00,2023-06-05,00:17,1,0,1
55,2023-06-05T00:17:00+10:00,2023-06-05,00:17,2,7,9
71,2023-06-05T00:17:00+10:00,2023-06-05,00:17,1,0,1
9,2023-06-05T00:17:00+10:00,2023-06-05,00:17,0,1,1
19,2023-06-05T00:17:00+10:00,2023-06-05,00:17,0,2,2
24,2023-06-05T00:17:00+10:00,2023-06-05,00:17,0,4,4
35,2023-06-05T00:17:00+10:00,2023-06-05,00:17,0,2,2
56,2023-06-05T00:17:00+10:00,2023-06-05,00:17,0,1,1
62,2023-06-05T00:17:00+10:00,2023-06-05,00:17,2,0,2
6,2023-06-05T00:17:00+10:00,2023-06-05,00:17,1,1,2
28,2023-06-05T00:17:00+10:00,2023-06-05,00:17,2,0,2
66,2023-06-05T00:17:00+10:00,2023-06-05,00:17,4,0,4
27,2023-06-05T00:17:00+10:00,2023-06-05,00:17,1,0,1
51,2023-06-05T00:17:00+10:00,2023-06-05,00:17,2,0,2
79,2023-06-05T00:17:00+10:00,2023-06-05,00:17,0,6,6
41,2023-06-05T00:16:00+10:00,2023-06-05,00:16,5,1,6
23,2023-06-05T00:16:00+10:00,2023-06-05,00:16,0,1,1
53,2023-06-05T00:16:00+10:00,2023-06-05,00:16,1,0,1
58,2023-06-05T00:16:00+10:00,2023-06-05,00:16,1,1,2
3,2023-06-05T00:16:00+10:00,2023-06-05,00:16,8,1,9
4,2023-06-05T00:16:00+10:00,2023-06-05,00:16,0,2,2
6,2023-06-05T00:16:00+10:00,2023-06-05,00:16,3,0,3
21,2023-06-05T00:16:00+10:00,2023-06-05,00:16,0,1,1
26,2023-06-05T00:16:00+10:00,2023-06-05,00:16,2,0,2
45,2023-06-05T00:16:00+10:00,2023-06-05,00:16,1,0,1
47,2023-06-05T00:16:00+10:00,2023-06-05,00:16,3,0,3
54,2023-06-05T00:16:00+10:00,2023-06-05,00:16,1,0,1
55,2023-06-05T00:16:00+10:00,2023-06-05,00:16,4,2,6
61,2023-06-05T00:16:00+10:00,2023-06-05,00:16,1,0,1
2,2023-06-05T00:16:00+10:00,2023-06-05,00:16,6,0,6
17,2023-06-05T00:16:00+10:00,2023-06-05,00:16,1,0,1
24,2023-06-05T00:16:00+10:00,2023-06-05,00:16,5,0,5
46,2023-06-05T00:16:00+10:00,2023-06-05,00:16,2,0,2
52,2023-06-05T00:16:00+10:00,2023-06-05,00:16,2,0,2
62,2023-06-05T00:16:00+10:00,2023-06-05,00:16,4,1,5
79,2023-06-05T00:16:00+10:00,2023-06-05,00:16,3,2,5
5,2023-06-05T00:16:00+10:00,2023-06-05,00:16,1,1,2
31,2023-06-05T00:16:00+10:00,2023-06-05,00:16,0,1,1
69,2023-06-05T00:16:00+10:00,2023-06-05,00:16,1,0,1
30,2023-06-05T00:16:00+10:00,2023-06-05,00:16,2,0,2
35,2023-06-05T00:16:00+10:00,2023-06-05,00:16,1,0,1
36,2023-06-05T00:15:00+10:00,2023-06-05,00:15,1,0,1
40,2023-06-05T00:15:00+10:00,2023-06-05,00:15,2,0,2
54,2023-06-05T00:15:00+10:00,2023-06-05,00:15,0,1,1
61,2023-06-05T00:15:00+10:00,2023-06-05,00:15,4,2,6
66,2023-06-05T00:15:00+10:00,2023-06-05,00:15,3,3,6
87,2023-06-05T00:15:00+10:00,2023-06-05,00:15,0,1,1
1,2023-06-05T00:15:00+10:00,2023-06-05,00:15,0,5,5
30,2023-06-05T00:15:00+10:00,2023-06-05,00:15,0,1,1
62,2023-06-05T00:15:00+10:00,2023-06-05,00:15,0,1,1
72,2023-06-05T00:15:00+10:00,2023-06-05,00:15,0,1,1
117,2023-06-05T00:15:00+10:00,2023-06-05,00:15,0,1,1
6,2023-06-05T00:15:00+10:00,2023-06-05,00:15,0,2,2
31,2023-06-05T00:15:00+10:00,2023-06-05,00:15,0,1,1
47,2023-06-05T00:15:00+10:00,2023-06-05,00:15,2,1,3
55,2023-06-05T00:15:00+10:00,2023-06-05,00:15,7,1,8
65,2023-06-05T00:15:00+10:00,2023-06-05,00:15,1,0,1
71,2023-06-05T00:15:00+10:00,2023-06-05,00:15,1,0,1
84,2023-06-05T00:15:00+10:00,2023-06-05,00:15,11,3,14
11,2023-06-05T00:15:00+10:00,2023-06-05,00:15,1,0,1
23,2023-06-05T00:15:00+10:00,2023-06-05,00:15,1,0,1
24,2023-06-05T00:15:00+10:00,2023-06-05,00:15,1,1,2
35,2023-06-05T00:15:00+10:00,2023-06-05,00:15,0,1,1
52,2023-06-05T00:15:00+10:00,2023-06-05,00:15,0,2,2
79,2023-06-05T00:15:00+10:00,2023-06-05,00:15,1,0,1
3,2023-06-05T00:15:00+10:00,2023-06-05,00:15,5,7,12
5,2023-06-05T00:15:00+10:00,2023-06-05,00:15,0,2,2
21,2023-06-05T00:15:00+10:00,2023-06-05,00:15,2,1,3
26,2023-06-05T00:15:00+10:00,2023-06-05,00:15,2,1,3
41,2023-06-05T00:15:00+10:00,2023-06-05,00:15,0,2,2
45,2023-06-05T00:15:00+10:00,2023-06-05,00:15,2,0,2
59,2023-06-05T00:15:00+10:00,2023-06-05,00:15,7,4,11
107,2023-06-05T00:15:00+10:00,2023-06-05,00:15,1,2,3
20,2023-06-05T00:15:00+10:00,2023-06-05,00:15,1,1,2
58,2023-06-05T00:15:00+10:00,2023-06-05,00:15,4,2,6
109,2023-06-05T00:15:00+10:00,2023-06-05,00:15,2,0,2
3,2023-06-05T00:14:00+10:00,2023-06-05,00:14,5,1,6
4,2023-06-05T00:14:00+10:00,2023-06-05,00:14,4,0,4
26,2023-06-05T00:14:00+10:00,2023-06-05,00:14,0,4,4
28,2023-06-05T00:14:00+10:00,2023-06-05,00:14,1,0,1
29,2023-06-05T00:14:00+10:00,2023-06-05,00:14,0,2,2
31,2023-06-05T00:14:00+10:00,2023-06-05,00:14,0,4,4
41,2023-06-05T00:14:00+10:00,2023-06-05,00:14,1,5,6
47,2023-06-05T00:14:00+10:00,2023-06-05,00:14,1,0,1
61,2023-06-05T00:14:00+10:00,2023-06-05,00:14,2,0,2
12,2023-06-05T00:14:00+10:00,2023-06-05,00:14,2,0,2
30,2023-06-05T00:14:00+10:00,2023-06-05,00:14,0,2,2
62,2023-06-05T00:14:00+10:00,2023-06-05,00:14,1,0,1
42,2023-06-05T00:14:00+10:00,2023-06-05,00:14,0,1,1
54,2023-06-05T00:14:00+10:00,2023-06-05,00:14,0,1,1
55,2023-06-05T00:14:00+10:00,2023-06-05,00:14,5,1,6
18,2023-06-05T00:14:00+10:00,2023-06-05,00:14,1,13,14
53,2023-06-05T00:14:00+10:00,2023-06-05,00:14,0,4,4
57,2023-06-05T00:14:00+10:00,2023-06-05,00:14,0,2,2
5,2023-06-05T00:14:00+10:00,2023-06-05,00:14,0,5,5
6,2023-06-05T00:14:00+10:00,2023-06-05,00:14,2,0,2
14,2023-06-05T00:14:00+10:00,2023-06-05,00:14,0,1,1
21,2023-06-05T00:14:00+10:00,2023-06-05,00:14,0,2,2
50,2023-06-05T00:14:00+10:00,2023-06-05,00:14,0,1,1
66,2023-06-05T00:14:00+10:00,2023-06-05,00:14,2,1,3
71,2023-06-05T00:14:00+10:00,2023-06-05,00:14,0,3,3
24,2023-06-05T00:14:00+10:00,2023-06-05,00:14,1,0,1
35,2023-06-05T00:14:00+10:00,2023-06-05,00:14,3,1,4
49,2023-06-05T00:14:00+10:00,2023-06-05,00:14,0,1,1
85,2023-06-05T00:14:00+10:00,2023-06-05,00:14,0,1,1
5,2023-06-05T00:13:00+10:00,2023-06-05,00:13,0,1,1
31,2023-06-05T00:13:00+10:00,2023-06-05,00:13,1,1,2
66,2023-06-05T00:13:00+10:00,2023-06-05,00:13,0,4,4
108,2023-06-05T00:13:00+10:00,2023-06-05,00:13,0,1,1
9,2023-06-05T00:13:00+10:00,2023-06-05,00:13,0,1,1
20,2023-06-05T00:13:00+10:00,2023-06-05,00:13,2,1,3
23,2023-06-05T00:13:00+10:00,2023-06-05,00:13,0,1,1
24,2023-06-05T00:13:00+10:00,2023-06-05,00:13,0,1,1
30,2023-06-05T00:13:00+10:00,2023-06-05,00:13,0,2,2
62,2023-06-05T00:13:00+10:00,2023-06-05,00:13,3,0,3
3,2023-06-05T00:13:00+10:00,2023-06-05,00:13,2,0,2
6,2023-06-05T00:13:00+10:00,2023-06-05,00:13,2,0,2
21,2023-06-05T00:13:00+10:00,2023-06-05,00:13,0,2,2
61,2023-06-05T00:13:00+10:00,2023-06-05,00:13,0,1,1
19,2023-06-05T00:13:00+10:00,2023-06-05,00:13,0,1,1
35,2023-06-05T00:13:00+10:00,2023-06-05,00:13,2,0,2
46,2023-06-05T00:13:00+10:00,2023-06-05,00:13,2,0,2
49,2023-06-05T00:13:00+10:00,2023-06-05,00:13,1,0,1
79,2023-06-05T00:13:00+10:00,2023-06-05,00:13,0,3,3
4,2023-06-05T00:13:00+10:00,2023-06-05,00:13,0,2,2
41,2023-06-05T00:13:00+10:00,2023-06-05,00:13,4,0,4
42,2023-06-05T00:13:00+10:00,2023-06-05,00:13,0,1,1
45,2023-06-05T00:13:00+10:00,2023-06-05,00:13,0,2,2
47,2023-06-05T00:13:00+10:00,2023-06-05,00:13,1,1,2
55,2023-06-05T00:13:00+10:00,2023-06-05,00:13,5,1,6
77,2023-06-05T00:13:00+10:00,2023-06-05,00:13,0,1,1
58,2023-06-05T00:13:00+10:00,2023-06-05,00:13,1,2,3
3,2023-06-05T00:12:00+10:00,2023-06-05,00:12,3,3,6
4,2023-06-05T00:12:00+10:00,2023-06-05,00:12,0,1,1
26,2023-06-05T00:12:00+10:00,2023-06-05,00:12,2,2,4
28,2023-06-05T00:12:00+10:00,2023-06-05,00:12,0,1,1
31,2023-06-05T00:12:00+10:00,2023-06-05,00:12,3,0,3
39,2023-06-05T00:12:00+10:00,2023-06-05,00:12,1,1,2
19,2023-06-05T00:12:00+10:00,2023-06-05,00:12,5,0,5
51,2023-06-05T00:12:00+10:00,2023-06-05,00:12,0,1,1
5,2023-06-05T00:12:00+10:00,2023-06-05,00:12,0,1,1
21,2023-06-05T00:12:00+10:00,2023-06-05,00:12,2,5,7
41,2023-06-05T00:12:00+10:00,2023-06-05,00:12,3,2,5
45,2023-06-05T00:12:00+10:00,2023-06-05,00:12,0,5,5
1,2023-06-05T00:12:00+10:00,2023-06-05,00:12,0,1,1
9,2023-06-05T00:12:00+10:00,2023-06-05,00:12,0,2,2
20,2023-06-05T00:12:00+10:00,2023-06-05,00:12,1,0,1
23,2023-06-05T00:12:00+10:00,2023-06-05,00:12,0,2,2
24,2023-06-05T00:12:00+10:00,2023-06-05,00:12,0,5,5
30,2023-06-05T00:12:00+10:00,2023-06-05,00:12,0,2,2
48,2023-06-05T00:12:00+10:00,2023-06-05,00:12,0,1,1
62,2023-06-05T00:12:00+10:00,2023-06-05,00:12,3,0,3
67,2023-06-05T00:12:00+10:00,2023-06-05,00:12,0,2,2
72,2023-06-05T00:12:00+10:00,2023-06-05,00:12,0,2,2
47,2023-06-05T00:12:00+10:00,2023-06-05,00:12,3,0,3
55,2023-06-05T00:12:00+10:00,2023-06-05,00:12,8,5,13
65,2023-06-05T00:12:00+10:00,2023-06-05,00:12,0,2,2
66,2023-06-05T00:12:00+10:00,2023-06-05,00:12,0,3,3
71,2023-06-05T00:12:00+10:00,2023-06-05,00:12,1,0,1
77,2023-06-05T00:12:00+10:00,2023-06-05,00:12,0,2,2
27,2023-06-05T00:12:00+10:00,2023-06-05,00:12,0,2,2
35,2023-06-05T00:12:00+10:00,2023-06-05,00:12,1,2,3
56,2023-06-05T00:12:00+10:00,2023-06-05,00:12,4,0,4
58,2023-06-05T00:12:00+10:00,2023-06-05,00:12,3,0,3
3,2023-06-05T00:11:00+10:00,2023-06-05,00:11,4,0,4
66,2023-06-05T00:11:00+10:00,2023-06-05,00:11,0,2,2
71,2023-06-05T00:11:00+10:00,2023-06-05,00:11,1,0,1
17,2023-06-05T00:11:00+10:00,2023-06-05,00:11,1,0,1
30,2023-06-05T00:11:00+10:00,2023-06-05,00:11,3,0,3
5,2023-06-05T00:11:00+10:00,2023-06-05,00:11,0,1,1
6,2023-06-05T00:11:00+10:00,2023-06-05,00:11,1,0,1
36,2023-06-05T00:11:00+10:00,2023-06-05,00:11,1,0,1
39,2023-06-05T00:11:00+10:00,2023-06-05,00:11,8,2,10
41,2023-06-05T00:11:00+10:00,2023-06-05,00:11,0,6,6
54,2023-06-05T00:11:00+10:00,2023-06-05,00:11,1,0,1
55,2023-06-05T00:11:00+10:00,2023-06-05,00:11,2,1,3
61,2023-06-05T00:11:00+10:00,2023-06-05,00:11,3,0,3
1,2023-06-05T00:11:00+10:00,2023-06-05,00:11,0,2,2
49,2023-06-05T00:11:00+10:00,2023-06-05,00:11,1,2,3
14,2023-06-05T00:11:00+10:00,2023-06-05,00:11,1,0,1
21,2023-06-05T00:11:00+10:00,2023-06-05,00:11,0,3,3
28,2023-06-05T00:11:00+10:00,2023-06-05,00:11,0,2,2
29,2023-06-05T00:11:00+10:00,2023-06-05,00:11,0,2,2
31,2023-06-05T00:11:00+10:00,2023-06-05,00:11,2,0,2
47,2023-06-05T00:11:00+10:00,2023-06-05,00:11,3,3,6
11,2023-06-05T00:11:00+10:00,2023-06-05,00:11,1,0,1
12,2023-06-05T00:11:00+10:00,2023-06-05,00:11,1,0,1
24,2023-06-05T00:11:00+10:00,2023-06-05,00:11,0,1,1
35,2023-06-05T00:11:00+10:00,2023-06-05,00:11,2,1,3
62,2023-06-05T00:11:00+10:00,2023-06-05,00:11,0,1,1
72,2023-06-05T00:11:00+10:00,2023-06-05,00:11,1,2,3
79,2023-06-05T00:11:00+10:00,2023-06-05,00:11,0,3,3
28,2023-06-05T00:10:00+10:00,2023-06-05,00:10,2,0,2
36,2023-06-05T00:10:00+10:00,2023-06-05,00:10,1,0,1
37,2023-06-05T00:10:00+10:00,2023-06-05,00:10,1,0,1
47,2023-06-05T00:10:00+10:00,2023-06-05,00:10,3,1,4
1,2023-06-05T00:10:00+10:00,2023-06-05,00:10,1,0,1
58,2023-06-05T00:10:00+10:00,2023-06-05,00:10,0,2,2
79,2023-06-05T00:10:00+10:00,2023-06-05,00:10,1,2,3
109,2023-06-05T00:10:00+10:00,2023-06-05,00:10,5,0,5
3,2023-06-05T00:10:00+10:00,2023-06-05,00:10,3,4,7
26,2023-06-05T00:10:00+10:00,2023-06-05,00:10,0,1,1
45,2023-06-05T00:10:00+10:00,2023-06-05,00:10,0,3,3
59,2023-06-05T00:10:00+10:00,2023-06-05,00:10,8,1,9
77,2023-06-05T00:10:00+10:00,2023-06-05,00:10,0,2,2
84,2023-06-05T00:10:00+10:00,2023-06-05,00:10,5,7,12
118,2023-06-05T00:10:00+10:00,2023-06-05,00:10,1,0,1
17,2023-06-05T00:10:00+10:00,2023-06-05,00:10,1,0,1
19,2023-06-05T00:10:00+10:00,2023-06-05,00:10,1,2,3
46,2023-06-05T00:10:00+10:00,2023-06-05,00:10,1,0,1
62,2023-06-05T00:10:00+10:00,2023-06-05,00:10,1,0,1
117,2023-06-05T00:10:00+10:00,2023-06-05,00:10,2,0,2
6,2023-06-05T00:10:00+10:00,2023-06-05,00:10,0,1,1
21,2023-06-05T00:10:00+10:00,2023-06-05,00:10,3,1,4
31,2023-06-05T00:10:00+10:00,2023-06-05,00:10,0,1,1
41,2023-06-05T00:10:00+10:00,2023-06-05,00:10,0,4,4
42,2023-06-05T00:10:00+10:00,2023-06-05,00:10,1,0,1
54,2023-06-05T00:10:00+10:00,2023-06-05,00:10,2,0,2
55,2023-06-05T00:10:00+10:00,2023-06-05,00:10,6,1,7
70,2023-06-05T00:10:00+10:00,2023-06-05,00:10,1,0,1
2,2023-06-05T00:10:00+10:00,2023-06-05,00:10,0,1,1
9,2023-06-05T00:10:00+10:00,2023-06-05,00:10,0,1,1
20,2023-06-05T00:10:00+10:00,2023-06-05,00:10,0,1,1
24,2023-06-05T00:10:00+10:00,2023-06-05,00:10,1,1,2
30,2023-06-05T00:10:00+10:00,2023-06-05,00:10,0,4,4
35,2023-06-05T00:10:00+10:00,2023-06-05,00:10,2,0,2
14,2023-06-05T00:09:00+10:00,2023-06-05,00:09,1,0,1
21,2023-06-05T00:09:00+10:00,2023-06-05,00:09,1,3,4
28,2023-06-05T00:09:00+10:00,2023-06-05,00:09,0,1,1
39,2023-06-05T00:09:00+10:00,2023-06-05,00:09,0,1,1
42,2023-06-05T00:09:00+10:00,2023-06-05,00:09,1,0,1
55,2023-06-05T00:09:00+10:00,2023-06-05,00:09,3,7,10
61,2023-06-05T00:09:00+10:00,2023-06-05,00:09,1,0,1
65,2023-06-05T00:09:00+10:00,2023-06-05,00:09,0,3,3
24,2023-06-05T00:09:00+10:00,2023-06-05,00:09,1,0,1
49,2023-06-05T00:09:00+10:00,2023-06-05,00:09,0,2,2
79,2023-06-05T00:09:00+10:00,2023-06-05,00:09,0,1,1
26,2023-06-05T00:09:00+10:00,2023-06-05,00:09,2,3,5
41,2023-06-05T00:09:00+10:00,2023-06-05,00:09,3,1,4
66,2023-06-05T00:09:00+10:00,2023-06-05,00:09,1,0,1
12,2023-06-05T00:09:00+10:00,2023-06-05,00:09,2,0,2
20,2023-06-05T00:09:00+10:00,2023-06-05,00:09,0,2,2
23,2023-06-05T00:09:00+10:00,2023-06-05,00:09,0,1,1
27,2023-06-05T00:09:00+10:00,2023-06-05,00:09,2,0,2
30,2023-06-05T00:09:00+10:00,2023-06-05,00:09,1,2,3
46,2023-06-05T00:09:00+10:00,2023-06-05,00:09,0,1,1
58,2023-06-05T00:09:00+10:00,2023-06-05,00:09,3,1,4
72,2023-06-05T00:09:00+10:00,2023-06-05,00:09,1,0,1
4,2023-06-05T00:09:00+10:00,2023-06-05,00:09,0,2,2
6,2023-06-05T00:09:00+10:00,2023-06-05,00:09,2,1,3
40,2023-06-05T00:09:00+10:00,2023-06-05,00:09,1,0,1
45,2023-06-05T00:09:00+10:00,2023-06-05,00:09,1,0,1
9,2023-06-05T00:09:00+10:00,2023-06-05,00:09,1,0,1
19,2023-06-05T00:09:00+10:00,2023-06-05,00:09,8,2,10
48,2023-06-05T00:09:00+10:00,2023-06-05,00:09,1,0,1
51,2023-06-05T00:09:00+10:00,2023-06-05,00:09,0,1,1
62,2023-06-05T00:09:00+10:00,2023-06-05,00:09,2,0,2
67,2023-06-05T00:09:00+10:00,2023-06-05,00:09,1,0,1
4,2023-06-05T00:08:00+10:00,2023-06-05,00:08,0,2,2
6,2023-06-05T00:08:00+10:00,2023-06-05,00:08,2,2,4
40,2023-06-05T00:08:00+10:00,2023-06-05,00:08,3,0,3
47,2023-06-05T00:08:00+10:00,2023-06-05,00:08,1,1,2
55,2023-06-05T00:08:00+10:00,2023-06-05,00:08,4,3,7
66,2023-06-05T00:08:00+10:00,2023-06-05,00:08,1,0,1
1,2023-06-05T00:08:00+10:00,2023-06-05,00:08,0,1,1
12,2023-06-05T00:08:00+10:00,2023-06-05,00:08,2,0,2
79,2023-06-05T00:08:00+10:00,2023-06-05,00:08,3,2,5
45,2023-06-05T00:08:00+10:00,2023-06-05,00:08,0,1,1
77,2023-06-05T00:08:00+10:00,2023-06-05,00:08,1,0,1
19,2023-06-05T00:08:00+10:00,2023-06-05,00:08,0,2,2
24,2023-06-05T00:08:00+10:00,2023-06-05,00:08,3,1,4
46,2023-06-05T00:08:00+10:00,2023-06-05,00:08,1,0,1
72,2023-06-05T00:08:00+10:00,2023-06-05,00:08,3,0,3
3,2023-06-05T00:08:00+10:00,2023-06-05,00:08,0,2,2
5,2023-06-05T00:08:00+10:00,2023-06-05,00:08,1,3,4
21,2023-06-05T00:08:00+10:00,2023-06-05,00:08,0,1,1
26,2023-06-05T00:08:00+10:00,2023-06-05,00:08,0,4,4
54,2023-06-05T00:08:00+10:00,2023-06-05,00:08,2,4,6
61,2023-06-05T00:08:00+10:00,2023-06-05,00:08,2,1,3
23,2023-06-05T00:08:00+10:00,2023-06-05,00:08,0,1,1
30,2023-06-05T00:08:00+10:00,2023-06-05,00:08,4,1,5
52,2023-06-05T00:08:00+10:00,2023-06-05,00:08,0,1,1
56,2023-06-05T00:08:00+10:00,2023-06-05,00:08,1,0,1
57,2023-06-05T00:08:00+10:00,2023-06-05,00:08,0,1,1
58,2023-06-05T00:08:00+10:00,2023-06-05,00:08,2,3,5
21,2023-06-05T00:07:00+10:00,2023-06-05,00:07,0,2,2
54,2023-06-05T00:07:00+10:00,2023-06-05,00:07,1,0,1
61,2023-06-05T00:07:00+10:00,2023-06-05,00:07,2,0,2
65,2023-06-05T00:07:00+10:00,2023-06-05,00:07,0,2,2
1,2023-06-05T00:07:00+10:00,2023-06-05,00:07,0,2,2
23,2023-06-05T00:07:00+10:00,2023-06-05,00:07,5,0,5
30,2023-06-05T00:07:00+10:00,2023-06-05,00:07,4,1,5
46,2023-06-05T00:07:00+10:00,2023-06-05,00:07,2,0,2
62,2023-06-05T00:07:00+10:00,2023-06-05,00:07,0,2,2
3,2023-06-05T00:07:00+10:00,2023-06-05,00:07,3,8,11
4,2023-06-05T00:07:00+10:00,2023-06-05,00:07,0,1,1
42,2023-06-05T00:07:00+10:00,2023-06-05,00:07,0,2,2
66,2023-06-05T00:07:00+10:00,2023-06-05,00:07,0,1,1
24,2023-06-05T00:07:00+10:00,2023-06-05,00:07,0,5,5
51,2023-06-05T00:07:00+10:00,2023-06-05,00:07,1,0,1
5,2023-06-05T00:07:00+10:00,2023-06-05,00:07,0,4,4
6,2023-06-05T00:07:00+10:00,2023-06-05,00:07,1,0,1
26,2023-06-05T00:07:00+10:00,2023-06-05,00:07,2,1,3
41,2023-06-05T00:07:00+10:00,2023-06-05,00:07,1,0,1
45,2023-06-05T00:07:00+10:00,2023-06-05,00:07,1,2,3
47,2023-06-05T00:07:00+10:00,2023-06-05,00:07,1,1,2
55,2023-06-05T00:07:00+10:00,2023-06-05,00:07,4,3,7
12,2023-06-05T00:07:00+10:00,2023-06-05,00:07,0,2,2
19,2023-06-05T00:07:00+10:00,2023-06-05,00:07,2,0,2
20,2023-06-05T00:07:00+10:00,2023-06-05,00:07,2,0,2
49,2023-06-05T00:07:00+10:00,2023-06-05,00:07,4,3,7
58,2023-06-05T00:07:00+10:00,2023-06-05,00:07,2,2,4
4,2023-06-05T00:06:00+10:00,2023-06-05,00:06,3,0,3
41,2023-06-05T00:06:00+10:00,2023-06-05,00:06,0,3,3
55,2023-06-05T00:06:00+10:00,2023-06-05,00:06,6,0,6
65,2023-06-05T00:06:00+10:00,2023-06-05,00:06,0,2,2
35,2023-06-05T00:06:00+10:00,2023-06-05,00:06,2,1,3
48,2023-06-05T00:06:00+10:00,2023-06-05,00:06,0,1,1
62,2023-06-05T00:06:00+10:00,2023-06-05,00:06,1,1,2
72,2023-06-05T00:06:00+10:00,2023-06-05,00:06,0,1,1
21,2023-06-05T00:06:00+10:00,2023-06-05,00:06,2,0,2
26,2023-06-05T00:06:00+10:00,2023-06-05,00:06,0,3,3
45,2023-06-05T00:06:00+10:00,2023-06-05,00:06,0,2,2
54,2023-06-05T00:06:00+10:00,2023-06-05,00:06,1,1,2
61,2023-06-05T00:06:00+10:00,2023-06-05,00:06,1,0,1
66,2023-06-05T00:06:00+10:00,2023-06-05,00:06,0,1,1
49,2023-06-05T00:06:00+10:00,2023-06-05,00:06,0,1,1
51,2023-06-05T00:06:00+10:00,2023-06-05,00:06,0,1,1
53,2023-06-05T00:06:00+10:00,2023-06-05,00:06,1,0,1
58,2023-06-05T00:06:00+10:00,2023-06-05,00:06,0,2,2
86,2023-06-05T00:06:00+10:00,2023-06-05,00:06,1,0,1
3,2023-06-05T00:06:00+10:00,2023-06-05,00:06,1,0,1
50,2023-06-05T00:06:00+10:00,2023-06-05,00:06,1,0,1
24,2023-06-05T00:06:00+10:00,2023-06-05,00:06,1,5,6
107,2023-06-05T00:05:00+10:00,2023-06-05,00:05,4,1,5
2,2023-06-05T00:05:00+10:00,2023-06-05,00:05,0,2,2
20,2023-06-05T00:05:00+10:00,2023-06-05,00:05,5,0,5
30,2023-06-05T00:05:00+10:00,2023-06-05,00:05,4,0,4
3,2023-06-05T00:05:00+10:00,2023-06-05,00:05,2,2,4
28,2023-06-05T00:05:00+10:00,2023-06-05,00:05,3,0,3
37,2023-06-05T00:05:00+10:00,2023-06-05,00:05,0,3,3
41,2023-06-05T00:05:00+10:00,2023-06-05,00:05,5,0,5
47,2023-06-05T00:05:00+10:00,2023-06-05,00:05,5,1,6
55,2023-06-05T00:05:00+10:00,2023-06-05,00:05,5,1,6
59,2023-06-05T00:05:00+10:00,2023-06-05,00:05,10,1,11
19,2023-06-05T00:05:00+10:00,2023-06-05,00:05,3,0,3
24,2023-06-05T00:05:00+10:00,2023-06-05,00:05,2,2,4
62,2023-06-05T00:05:00+10:00,2023-06-05,00:05,8,5,13
85,2023-06-05T00:05:00+10:00,2023-06-05,00:05,2,0,2
109,2023-06-05T00:05:00+10:00,2023-06-05,00:05,1,1,2
4,2023-06-05T00:05:00+10:00,2023-06-05,00:05,0,3,3
5,2023-06-05T00:05:00+10:00,2023-06-05,00:05,0,1,1
6,2023-06-05T00:05:00+10:00,2023-06-05,00:05,3,0,3
54,2023-06-05T00:05:00+10:00,2023-06-05,00:05,0,1,1
66,2023-06-05T00:05:00+10:00,2023-06-05,00:05,0,3,3
84,2023-06-05T00:05:00+10:00,2023-06-05,00:05,6,10,16
1,2023-06-05T00:05:00+10:00,2023-06-05,00:05,2,5,7
11,2023-06-05T00:05:00+10:00,2023-06-05,00:05,3,0,3
23,2023-06-05T00:05:00+10:00,2023-06-05,00:05,0,4,4
35,2023-06-05T00:05:00+10:00,2023-06-05,00:05,1,1,2
46,2023-06-05T00:05:00+10:00,2023-06-05,00:05,0,2,2
117,2023-06-05T00:05:00+10:00,2023-06-05,00:05,0,6,6
4,2023-06-05T00:04:00+10:00,2023-06-05,00:04,1,0,1
29,2023-06-05T00:04:00+10:00,2023-06-05,00:04,0,1,1
41,2023-06-05T00:04:00+10:00,2023-06-05,00:04,0,1,1
24,2023-06-05T00:04:00+10:00,2023-06-05,00:04,1,1,2
30,2023-06-05T00:04:00+10:00,2023-06-05,00:04,1,1,2
46,2023-06-05T00:04:00+10:00,2023-06-05,00:04,0,1,1
49,2023-06-05T00:04:00+10:00,2023-06-05,00:04,0,1,1
51,2023-06-05T00:04:00+10:00,2023-06-05,00:04,0,1,1
57,2023-06-05T00:04:00+10:00,2023-06-05,00:04,0,1,1
79,2023-06-05T00:04:00+10:00,2023-06-05,00:04,0,5,5
21,2023-06-05T00:04:00+10:00,2023-06-05,00:04,2,3,5
26,2023-06-05T00:04:00+10:00,2023-06-05,00:04,3,0,3
37,2023-06-05T00:04:00+10:00,2023-06-05,00:04,0,1,1
47,2023-06-05T00:04:00+10:00,2023-06-05,00:04,1,0,1
55,2023-06-05T00:04:00+10:00,2023-06-05,00:04,6,4,10
65,2023-06-05T00:04:00+10:00,2023-06-05,00:04,4,0,4
77,2023-06-05T00:04:00+10:00,2023-06-05,00:04,0,2,2
48,2023-06-05T00:04:00+10:00,2023-06-05,00:04,1,0,1
58,2023-06-05T00:04:00+10:00,2023-06-05,00:04,2,1,3
67,2023-06-05T00:04:00+10:00,2023-06-05,00:04,3,0,3
3,2023-06-05T00:04:00+10:00,2023-06-05,00:04,4,0,4
45,2023-06-05T00:04:00+10:00,2023-06-05,00:04,1,0,1
61,2023-06-05T00:04:00+10:00,2023-06-05,00:04,4,0,4
1,2023-06-05T00:04:00+10:00,2023-06-05,00:04,3,0,3
20,2023-06-05T00:04:00+10:00,2023-06-05,00:04,3,0,3
27,2023-06-05T00:04:00+10:00,2023-06-05,00:04,1,0,1
35,2023-06-05T00:04:00+10:00,2023-06-05,00:04,0,1,1
56,2023-06-05T00:04:00+10:00,2023-06-05,00:04,0,1,1
62,2023-06-05T00:04:00+10:00,2023-06-05,00:04,2,3,5
4,2023-06-05T00:03:00+10:00,2023-06-05,00:03,2,2,4
26,2023-06-05T00:03:00+10:00,2023-06-05,00:03,1,3,4
37,2023-06-05T00:03:00+10:00,2023-06-05,00:03,2,0,2
61,2023-06-05T00:03:00+10:00,2023-06-05,00:03,1,0,1
71,2023-06-05T00:03:00+10:00,2023-06-05,00:03,0,1,1
87,2023-06-05T00:03:00+10:00,2023-06-05,00:03,0,1,1
35,2023-06-05T00:03:00+10:00,2023-06-05,00:03,6,2,8
62,2023-06-05T00:03:00+10:00,2023-06-05,00:03,0,2,2
41,2023-06-05T00:03:00+10:00,2023-06-05,00:03,0,4,4
45,2023-06-05T00:03:00+10:00,2023-06-05,00:03,0,1,1
55,2023-06-05T00:03:00+10:00,2023-06-05,00:03,5,4,9
78,2023-06-05T00:03:00+10:00,2023-06-05,00:03,1,0,1
19,2023-06-05T00:03:00+10:00,2023-06-05,00:03,3,0,3
3,2023-06-05T00:03:00+10:00,2023-06-05,00:03,0,6,6
65,2023-06-05T00:03:00+10:00,2023-06-05,00:03,3,0,3
66,2023-06-05T00:03:00+10:00,2023-06-05,00:03,0,5,5
30,2023-06-05T00:03:00+10:00,2023-06-05,00:03,0,1,1
52,2023-06-05T00:03:00+10:00,2023-06-05,00:03,0,1,1
57,2023-06-05T00:03:00+10:00,2023-06-05,00:03,0,1,1
58,2023-06-05T00:03:00+10:00,2023-06-05,00:03,2,4,6
6,2023-06-05T00:02:00+10:00,2023-06-05,00:02,0,2,2
42,2023-06-05T00:02:00+10:00,2023-06-05,00:02,0,1,1
61,2023-06-05T00:02:00+10:00,2023-06-05,00:02,0,1,1
2,2023-06-05T00:02:00+10:00,2023-06-05,00:02,2,2,4
19,2023-06-05T00:02:00+10:00,2023-06-05,00:02,2,0,2
30,2023-06-05T00:02:00+10:00,2023-06-05,00:02,0,8,8
46,2023-06-05T00:02:00+10:00,2023-06-05,00:02,0,2,2
56,2023-06-05T00:02:00+10:00,2023-06-05,00:02,3,0,3
3,2023-06-05T00:02:00+10:00,2023-06-05,00:02,1,7,8
5,2023-06-05T00:02:00+10:00,2023-06-05,00:02,4,2,6
28,2023-06-05T00:02:00+10:00,2023-06-05,00:02,2,0,2
41,2023-06-05T00:02:00+10:00,2023-06-05,00:02,1,3,4
12,2023-06-05T00:02:00+10:00,2023-06-05,00:02,0,1,1
23,2023-06-05T00:02:00+10:00,2023-06-05,00:02,0,2,2
21,2023-06-05T00:02:00+10:00,2023-06-05,00:02,1,2,3
31,2023-06-05T00:02:00+10:00,2023-06-05,00:02,1,0,1
39,2023-06-05T00:02:00+10:00,2023-06-05,00:02,2,2,4
45,2023-06-05T00:02:00+10:00,2023-06-05,00:02,0,2,2
47,2023-06-05T00:02:00+10:00,2023-06-05,00:02,4,4,8
55,2023-06-05T00:02:00+10:00,2023-06-05,00:02,9,7,16
66,2023-06-05T00:02:00+10:00,2023-06-05,00:02,1,2,3
108,2023-06-05T00:02:00+10:00,2023-06-05,00:02,0,2,2
10,2023-06-05T00:02:00+10:00,2023-06-05,00:02,0,1,1
17,2023-06-05T00:02:00+10:00,2023-06-05,00:02,0,1,1
24,2023-06-05T00:02:00+10:00,2023-06-05,00:02,3,0,3
27,2023-06-05T00:02:00+10:00,2023-06-05,00:02,1,0,1
35,2023-06-05T00:02:00+10:00,2023-06-05,00:02,0,1,1
52,2023-06-05T00:02:00+10:00,2023-06-05,00:02,1,0,1
53,2023-06-05T00:02:00+10:00,2023-06-05,00:02,1,0,1
58,2023-06-05T00:02:00+10:00,2023-06-05,00:02,2,0,2
67,2023-06-05T00:02:00+10:00,2023-06-05,00:02,1,0,1
72,2023-06-05T00:02:00+10:00,2023-06-05,00:02,1,0,1
3,2023-06-05T00:01:00+10:00,2023-06-05,00:01,2,3,5
6,2023-06-05T00:01:00+10:00,2023-06-05,00:01,0,2,2
36,2023-06-05T00:01:00+10:00,2023-06-05,00:01,1,0,1
42,2023-06-05T00:01:00+10:00,2023-06-05,00:01,2,0,2
47,2023-06-05T00:01:00+10:00,2023-06-05,00:01,0,1,1
65,2023-06-05T00:01:00+10:00,2023-06-05,00:01,0,1,1
66,2023-06-05T00:01:00+10:00,2023-06-05,00:01,3,0,3
17,2023-06-05T00:01:00+10:00,2023-06-05,00:01,1,0,1
46,2023-06-05T00:01:00+10:00,2023-06-05,00:01,4,0,4
48,2023-06-05T00:01:00+10:00,2023-06-05,00:01,1,1,2
49,2023-06-05T00:01:00+10:00,2023-06-05,00:01,2,0,2
51,2023-06-05T00:01:00+10:00,2023-06-05,00:01,1,0,1
53,2023-06-05T00:01:00+10:00,2023-06-05,00:01,1,0,1
57,2023-06-05T00:01:00+10:00,2023-06-05,00:01,0,1,1
58,2023-06-05T00:01:00+10:00,2023-06-05,00:01,3,0,3
4,2023-06-05T00:01:00+10:00,2023-06-05,00:01,1,2,3
5,2023-06-05T00:01:00+10:00,2023-06-05,00:01,1,0,1
21,2023-06-05T00:01:00+10:00,2023-06-05,00:01,0,4,4
31,2023-06-05T00:01:00+10:00,2023-06-05,00:01,0,1,1
45,2023-06-05T00:01:00+10:00,2023-06-05,00:01,2,0,2
55,2023-06-05T00:01:00+10:00,2023-06-05,00:01,4,7,11
2,2023-06-05T00:01:00+10:00,2023-06-05,00:01,2,2,4
10,2023-06-05T00:01:00+10:00,2023-06-05,00:01,0,1,1
11,2023-06-05T00:01:00+10:00,2023-06-05,00:01,0,2,2
67,2023-06-05T00:01:00+10:00,2023-06-05,00:01,2,1,3
14,2023-06-05T00:01:00+10:00,2023-06-05,00:01,1,0,1
26,2023-06-05T00:01:00+10:00,2023-06-05,00:01,2,0,2
19,2023-06-05T00:01:00+10:00,2023-06-05,00:01,3,0,3
35,2023-06-05T00:01:00+10:00,2023-06-05,00:01,2,0,2
62,2023-06-05T00:01:00+10:00,2023-06-05,00:01,0,6,6
79,2023-06-05T00:01:00+10:00,2023-06-05,00:01,1,0,1
41,2023-06-05T00:00:00+10:00,2023-06-05,00:00,0,5,5
47,2023-06-05T00:00:00+10:00,2023-06-05,00:00,0,1,1
84,2023-06-05T00:00:00+10:00,2023-06-05,00:00,4,13,17
35,2023-06-05T00:00:00+10:00,2023-06-05,00:00,0,4,4
57,2023-06-05T00:00:00+10:00,2023-06-05,00:00,0,1,1
5,2023-06-05T00:00:00+10:00,2023-06-05,00:00,0,1,1
26,2023-06-05T00:00:00+10:00,2023-06-05,00:00,0,1,1
59,2023-06-05T00:00:00+10:00,2023-06-05,00:00,14,6,20
24,2023-06-05T00:00:00+10:00,2023-06-05,00:00,1,3,4
109,2023-06-05T00:00:00+10:00,2023-06-05,00:00,2,2,4
3,2023-06-05T00:00:00+10:00,2023-06-05,00:00,5,5,10
4,2023-06-05T00:00:00+10:00,2023-06-05,00:00,2,2,4
6,2023-06-05T00:00:00+10:00,2023-06-05,00:00,0,1,1
45,2023-06-05T00:00:00+10:00,2023-06-05,00:00,0,2,2
55,2023-06-05T00:00:00+10:00,2023-06-05,00:00,6,1,7
61,2023-06-05T00:00:00+10:00,2023-06-05,00:00,1,0,1
65,2023-06-05T00:00:00+10:00,2023-06-05,00:00,0,1,1
66,2023-06-05T00:00:00+10:00,2023-06-05,00:00,3,1,4
107,2023-06-05T00:00:00+10:00,2023-06-05,00:00,0,1,1
19,2023-06-05T00:00:00+10:00,2023-06-05,00:00,1,0,1
46,2023-06-05T00:00:00+10:00,2023-06-05,00:00,1,1,2
49,2023-06-05T00:00:00+10:00,2023-06-05,00:00,3,2,5
62,2023-06-05T00:00:00+10:00,2023-06-05,00:00,2,2,4
67,2023-06-05T00:00:00+10:00,2023-06-05,00:00,0,1,1
79,2023-06-05T00:00:00+10:00,2023-06-05,00:00,1,2,3
117,2023-06-05T00:00:00+10:00,2023-06-05,00:00,2,2,4
3,2023-06-04T23:59:00+10:00,2023-06-04,23:59,2,4,6
40,2023-06-04T23:59:00+10:00,2023-06-04,23:59,0,1,1
45,2023-06-04T23:59:00+10:00,2023-06-04,23:59,1,3,4
75,2023-06-04T23:59:00+10:00,2023-06-04,23:59,0,1,1
77,2023-06-04T23:59:00+10:00,2023-06-04,23:59,1,0,1
2,2023-06-04T23:59:00+10:00,2023-06-04,23:59,1,0,1
20,2023-06-04T23:59:00+10:00,2023-06-04,23:59,2,0,2
35,2023-06-04T23:59:00+10:00,2023-06-04,23:59,0,2,2
52,2023-06-04T23:59:00+10:00,2023-06-04,23:59,0,1,1
54,2023-06-04T23:59:00+10:00,2023-06-04,23:59,0,2,2
55,2023-06-04T23:59:00+10:00,2023-06-04,23:59,2,1,3
19,2023-06-04T23:59:00+10:00,2023-06-04,23:59,2,1,3
23,2023-06-04T23:59:00+10:00,2023-06-04,23:59,0,1,1
67,2023-06-04T23:59:00+10:00,2023-06-04,23:59,0,2,2
79,2023-06-04T23:59:00+10:00,2023-06-04,23:59,3,0,3
5,2023-06-04T23:59:00+10:00,2023-06-04,23:59,1,2,3
6,2023-06-04T23:59:00+10:00,2023-06-04,23:59,0,2,2
26,2023-06-04T23:59:00+10:00,2023-06-04,23:59,1,0,1
36,2023-06-04T23:59:00+10:00,2023-06-04,23:59,3,0,3
41,2023-06-04T23:59:00+10:00,2023-06-04,23:59,3,7,10
47,2023-06-04T23:59:00+10:00,2023-06-04,23:59,3,0,3
61,2023-06-04T23:59:00+10:00,2023-06-04,23:59,5,0,5
66,2023-06-04T23:59:00+10:00,2023-06-04,23:59,0,1,1
24,2023-06-04T23:59:00+10:00,2023-06-04,23:59,1,1,2
51,2023-06-04T23:59:00+10:00,2023-06-04,23:59,1,0,1
28,2023-06-04T23:58:00+10:00,2023-06-04,23:58,1,1,2
66,2023-06-04T23:58:00+10:00,2023-06-04,23:58,1,2,3
20,2023-06-04T23:58:00+10:00,2023-06-04,23:58,0,2,2
35,2023-06-04T23:58:00+10:00,2023-06-04,23:58,0,2,2
49,2023-06-04T23:58:00+10:00,2023-06-04,23:58,2,0,2
58,2023-06-04T23:58:00+10:00,2023-06-04,23:58,0,3,3
79,2023-06-04T23:58:00+10:00,2023-06-04,23:58,1,2,3
6,2023-06-04T23:58:00+10:00,2023-06-04,23:58,1,0,1
47,2023-06-04T23:58:00+10:00,2023-06-04,23:58,4,1,5
65,2023-06-04T23:58:00+10:00,2023-06-04,23:58,2,0,2
9,2023-06-04T23:58:00+10:00,2023-06-04,23:58,0,1,1
57,2023-06-04T23:58:00+10:00,2023-06-04,23:58,2,0,2
3,2023-06-04T23:58:00+10:00,2023-06-04,23:58,3,4,7
4,2023-06-04T23:58:00+10:00,2023-06-04,23:58,1,3,4
5,2023-06-04T23:58:00+10:00,2023-06-04,23:58,2,1,3
21,2023-06-04T23:58:00+10:00,2023-06-04,23:58,2,0,2
26,2023-06-04T23:58:00+10:00,2023-06-04,23:58,1,2,3
41,2023-06-04T23:58:00+10:00,2023-06-04,23:58,0,2,2
42,2023-06-04T23:58:00+10:00,2023-06-04,23:58,0,4,4
55,2023-06-04T23:58:00+10:00,2023-06-04,23:58,3,3,6
61,2023-06-04T23:58:00+10:00,2023-06-04,23:58,9,0,9
19,2023-06-04T23:58:00+10:00,2023-06-04,23:58,1,0,1
62,2023-06-04T23:58:00+10:00,2023-06-04,23:58,2,1,3
6,2023-06-04T23:57:00+10:00,2023-06-04,23:57,0,2,2
21,2023-06-04T23:57:00+10:00,2023-06-04,23:57,2,0,2
26,2023-06-04T23:57:00+10:00,2023-06-04,23:57,7,0,7
41,2023-06-04T23:57:00+10:00,2023-06-04,23:57,0,4,4
65,2023-06-04T23:57:00+10:00,2023-06-04,23:57,0,1,1
12,2023-06-04T23:57:00+10:00,2023-06-04,23:57,1,2,3
24,2023-06-04T23:57:00+10:00,2023-06-04,23:57,3,3,6
49,2023-06-04T23:57:00+10:00,2023-06-04,23:57,1,2,3
58,2023-06-04T23:57:00+10:00,2023-06-04,23:57,1,2,3
3,2023-06-04T23:57:00+10:00,2023-06-04,23:57,2,6,8
4,2023-06-04T23:57:00+10:00,2023-06-04,23:57,1,1,2
14,2023-06-04T23:57:00+10:00,2023-06-04,23:57,1,0,1
47,2023-06-04T23:57:00+10:00,2023-06-04,23:57,0,7,7
54,2023-06-04T23:57:00+10:00,2023-06-04,23:57,3,0,3
61,2023-06-04T23:57:00+10:00,2023-06-04,23:57,0,2,2
66,2023-06-04T23:57:00+10:00,2023-06-04,23:57,0,2,2
77,2023-06-04T23:57:00+10:00,2023-06-04,23:57,2,0,2
1,2023-06-04T23:57:00+10:00,2023-06-04,23:57,0,4,4
10,2023-06-04T23:57:00+10:00,2023-06-04,23:57,0,2,2
51,2023-06-04T23:57:00+10:00,2023-06-04,23:57,1,2,3
56,2023-06-04T23:57:00+10:00,2023-06-04,23:57,3,0,3
5,2023-06-04T23:57:00+10:00,2023-06-04,23:57,1,0,1
29,2023-06-04T23:57:00+10:00,2023-06-04,23:57,0,2,2
36,2023-06-04T23:57:00+10:00,2023-06-04,23:57,1,0,1
42,2023-06-04T23:57:00+10:00,2023-06-04,23:57,3,0,3
55,2023-06-04T23:57:00+10:00,2023-06-04,23:57,3,1,4
27,2023-06-04T23:57:00+10:00,2023-06-04,23:57,2,0,2
30,2023-06-04T23:57:00+10:00,2023-06-04,23:57,2,9,11
35,2023-06-04T23:57:00+10:00,2023-06-04,23:57,0,1,1
57,2023-06-04T23:57:00+10:00,2023-06-04,23:57,3,1,4
62,2023-06-04T23:57:00+10:00,2023-06-04,23:57,2,4,6
72,2023-06-04T23:57:00+10:00,2023-06-04,23:57,0,1,1
4,2023-06-04T23:56:00+10:00,2023-06-04,23:56,2,2,4
6,2023-06-04T23:56:00+10:00,2023-06-04,23:56,3,0,3
26,2023-06-04T23:56:00+10:00,2023-06-04,23:56,3,3,6
29,2023-06-04T23:56:00+10:00,2023-06-04,23:56,0,1,1
39,2023-06-04T23:56:00+10:00,2023-06-04,23:56,1,0,1
55,2023-06-04T23:56:00+10:00,2023-06-04,23:56,2,6,8
61,2023-06-04T23:56:00+10:00,2023-06-04,23:56,1,0,1
23,2023-06-04T23:56:00+10:00,2023-06-04,23:56,7,0,7
35,2023-06-04T23:56:00+10:00,2023-06-04,23:56,0,2,2
58,2023-06-04T23:56:00+10:00,2023-06-04,23:56,2,0,2
79,2023-06-04T23:56:00+10:00,2023-06-04,23:56,1,6,7
5,2023-06-04T23:56:00+10:00,2023-06-04,23:56,2,0,2
47,2023-06-04T23:56:00+10:00,2023-06-04,23:56,1,0,1
30,2023-06-04T23:56:00+10:00,2023-06-04,23:56,0,2,2
86,2023-06-04T23:56:00+10:00,2023-06-04,23:56,0,1,1
3,2023-06-04T23:56:00+10:00,2023-06-04,23:56,0,1,1
37,2023-06-04T23:56:00+10:00,2023-06-04,23:56,0,3,3
41,2023-06-04T23:56:00+10:00,2023-06-04,23:56,1,4,5
65,2023-06-04T23:56:00+10:00,2023-06-04,23:56,2,3,5
66,2023-06-04T23:56:00+10:00,2023-06-04,23:56,1,0,1
19,2023-06-04T23:56:00+10:00,2023-06-04,23:56,1,2,3
24,2023-06-04T23:56:00+10:00,2023-06-04,23:56,1,2,3
52,2023-06-04T23:56:00+10:00,2023-06-04,23:56,0,2,2
26,2023-06-04T23:55:00+10:00,2023-06-04,23:55,1,2,3
42,2023-06-04T23:55:00+10:00,2023-06-04,23:55,0,1,1
54,2023-06-04T23:55:00+10:00,2023-06-04,23:55,0,4,4
84,2023-06-04T23:55:00+10:00,2023-06-04,23:55,8,20,28
108,2023-06-04T23:55:00+10:00,2023-06-04,23:55,0,1,1
118,2023-06-04T23:55:00+10:00,2023-06-04,23:55,0,1,1
19,2023-06-04T23:55:00+10:00,2023-06-04,23:55,2,1,3
24,2023-06-04T23:55:00+10:00,2023-06-04,23:55,4,2,6
56,2023-06-04T23:55:00+10:00,2023-06-04,23:55,1,1,2
58,2023-06-04T23:55:00+10:00,2023-06-04,23:55,0,3,3
67,2023-06-04T23:55:00+10:00,2023-06-04,23:55,2,3,5
21,2023-06-04T23:55:00+10:00,2023-06-04,23:55,2,0,2
40,2023-06-04T23:55:00+10:00,2023-06-04,23:55,2,0,2
41,2023-06-04T23:55:00+10:00,2023-06-04,23:55,2,1,3
47,2023-06-04T23:55:00+10:00,2023-06-04,23:55,0,3,3
55,2023-06-04T23:55:00+10:00,2023-06-04,23:55,4,1,5
66,2023-06-04T23:55:00+10:00,2023-06-04,23:55,5,1,6
107,2023-06-04T23:55:00+10:00,2023-06-04,23:55,1,1,2
23,2023-06-04T23:55:00+10:00,2023-06-04,23:55,1,0,1
35,2023-06-04T23:55:00+10:00,2023-06-04,23:55,0,6,6
79,2023-06-04T23:55:00+10:00,2023-06-04,23:55,1,0,1
109,2023-06-04T23:55:00+10:00,2023-06-04,23:55,1,2,3
3,2023-06-04T23:55:00+10:00,2023-06-04,23:55,4,0,4
4,2023-06-04T23:55:00+10:00,2023-06-04,23:55,1,3,4
5,2023-06-04T23:55:00+10:00,2023-06-04,23:55,2,1,3
6,2023-06-04T23:55:00+10:00,2023-06-04,23:55,4,2,6
59,2023-06-04T23:55:00+10:00,2023-06-04,23:55,8,3,11
61,2023-06-04T23:55:00+10:00,2023-06-04,23:55,1,1,2
65,2023-06-04T23:55:00+10:00,2023-06-04,23:55,1,0,1
11,2023-06-04T23:55:00+10:00,2023-06-04,23:55,3,0,3
30,2023-06-04T23:55:00+10:00,2023-06-04,23:55,1,8,9
51,2023-06-04T23:55:00+10:00,2023-06-04,23:55,3,0,3
117,2023-06-04T23:55:00+10:00,2023-06-04,23:55,4,1,5
26,2023-06-04T23:54:00+10:00,2023-06-04,23:54,2,0,2
41,2023-06-04T23:54:00+10:00,2023-06-04,23:54,3,1,4
47,2023-06-04T23:54:00+10:00,2023-06-04,23:54,1,1,2
66,2023-06-04T23:54:00+10:00,2023-06-04,23:54,3,2,5
87,2023-06-04T23:54:00+10:00,2023-06-04,23:54,2,0,2
30,2023-06-04T23:54:00+10:00,2023-06-04,23:54,0,1,1
58,2023-06-04T23:54:00+10:00,2023-06-04,23:54,0,3,3
62,2023-06-04T23:54:00+10:00,2023-06-04,23:54,0,5,5
79,2023-06-04T23:54:00+10:00,2023-06-04,23:54,2,1,3
3,2023-06-04T23:54:00+10:00,2023-06-04,23:54,4,0,4
6,2023-06-04T23:54:00+10:00,2023-06-04,23:54,2,0,2
28,2023-06-04T23:54:00+10:00,2023-06-04,23:54,1,1,2
31,2023-06-04T23:54:00+10:00,2023-06-04,23:54,0,1,1
54,2023-06-04T23:54:00+10:00,2023-06-04,23:54,0,5,5
77,2023-06-04T23:54:00+10:00,2023-06-04,23:54,2,0,2
1,2023-06-04T23:54:00+10:00,2023-06-04,23:54,0,1,1
12,2023-06-04T23:54:00+10:00,2023-06-04,23:54,0,2,2
19,2023-06-04T23:54:00+10:00,2023-06-04,23:54,2,1,3
24,2023-06-04T23:54:00+10:00,2023-06-04,23:54,2,6,8
35,2023-06-04T23:54:00+10:00,2023-06-04,23:54,2,7,9
46,2023-06-04T23:54:00+10:00,2023-06-04,23:54,1,0,1
4,2023-06-04T23:54:00+10:00,2023-06-04,23:54,0,3,3
42,2023-06-04T23:54:00+10:00,2023-06-04,23:54,2,0,2
45,2023-06-04T23:54:00+10:00,2023-06-04,23:54,0,1,1
55,2023-06-04T23:54:00+10:00,2023-06-04,23:54,2,9,11
61,2023-06-04T23:54:00+10:00,2023-06-04,23:54,2,0,2
2,2023-06-04T23:54:00+10:00,2023-06-04,23:54,0,2,2
48,2023-06-04T23:54:00+10:00,2023-06-04,23:54,1,0,1
52,2023-06-04T23:54:00+10:00,2023-06-04,23:54,0,3,3
44,2023-06-04T23:53:00+10:00,2023-06-04,23:53,1,0,1
55,2023-06-04T23:53:00+10:00,2023-06-04,23:53,6,4,10
66,2023-06-04T23:53:00+10:00,2023-06-04,23:53,6,2,8
18,2023-06-04T23:53:00+10:00,2023-06-04,23:53,0,1,1
19,2023-06-04T23:53:00+10:00,2023-06-04,23:53,4,2,6
20,2023-06-04T23:53:00+10:00,2023-06-04,23:53,1,2,3
30,2023-06-04T23:53:00+10:00,2023-06-04,23:53,2,2,4
79,2023-06-04T23:53:00+10:00,2023-06-04,23:53,1,4,5
4,2023-06-04T23:53:00+10:00,2023-06-04,23:53,0,3,3
6,2023-06-04T23:53:00+10:00,2023-06-04,23:53,4,1,5
39,2023-06-04T23:53:00+10:00,2023-06-04,23:53,0,3,3
41,2023-06-04T23:53:00+10:00,2023-06-04,23:53,4,1,5
45,2023-06-04T23:53:00+10:00,2023-06-04,23:53,0,2,2
108,2023-06-04T23:53:00+10:00,2023-06-04,23:53,0,1,1
1,2023-06-04T23:53:00+10:00,2023-06-04,23:53,1,0,1
24,2023-06-04T23:53:00+10:00,2023-06-04,23:53,0,4,4
35,2023-06-04T23:53:00+10:00,2023-06-04,23:53,2,5,7
49,2023-06-04T23:53:00+10:00,2023-06-04,23:53,2,0,2
52,2023-06-04T23:53:00+10:00,2023-06-04,23:53,0,2,2
62,2023-06-04T23:53:00+10:00,2023-06-04,23:53,1,4,5
67,2023-06-04T23:53:00+10:00,2023-06-04,23:53,0,2,2
3,2023-06-04T23:53:00+10:00,2023-06-04,23:53,5,1,6
5,2023-06-04T23:53:00+10:00,2023-06-04,23:53,1,2,3
14,2023-06-04T23:53:00+10:00,2023-06-04,23:53,2,0,2
17,2023-06-04T23:53:00+10:00,2023-06-04,23:53,1,0,1
58,2023-06-04T23:53:00+10:00,2023-06-04,23:53,2,0,2
39,2023-06-04T23:52:00+10:00,2023-06-04,23:52,1,0,1
45,2023-06-04T23:52:00+10:00,2023-06-04,23:52,0,2,2
23,2023-06-04T23:52:00+10:00,2023-06-04,23:52,0,1,1
51,2023-06-04T23:52:00+10:00,2023-06-04,23:52,3,0,3
72,2023-06-04T23:52:00+10:00,2023-06-04,23:52,0,1,1
3,2023-06-04T23:52:00+10:00,2023-06-04,23:52,4,1,5
5,2023-06-04T23:52:00+10:00,2023-06-04,23:52,4,0,4
26,2023-06-04T23:52:00+10:00,2023-06-04,23:52,1,1,2
41,2023-06-04T23:52:00+10:00,2023-06-04,23:52,1,1,2
47,2023-06-04T23:52:00+10:00,2023-06-04,23:52,3,1,4
54,2023-06-04T23:52:00+10:00,2023-06-04,23:52,1,0,1
61,2023-06-04T23:52:00+10:00,2023-06-04,23:52,1,0,1
69,2023-06-04T23:52:00+10:00,2023-06-04,23:52,0,1,1
30,2023-06-04T23:52:00+10:00,2023-06-04,23:52,3,1,4
35,2023-06-04T23:52:00+10:00,2023-06-04,23:52,2,1,3
48,2023-06-04T23:52:00+10:00,2023-06-04,23:52,1,0,1
79,2023-06-04T23:52:00+10:00,2023-06-04,23:52,0,3,3
6,2023-06-04T23:52:00+10:00,2023-06-04,23:52,3,4,7
14,2023-06-04T23:52:00+10:00,2023-06-04,23:52,3,0,3
28,2023-06-04T23:52:00+10:00,2023-06-04,23:52,1,0,1
55,2023-06-04T23:52:00+10:00,2023-06-04,23:52,3,3,6
65,2023-06-04T23:52:00+10:00,2023-06-04,23:52,0,2,2
12,2023-06-04T23:52:00+10:00,2023-06-04,23:52,0,2,2
20,2023-06-04T23:52:00+10:00,2023-06-04,23:52,0,1,1
24,2023-06-04T23:52:00+10:00,2023-06-04,23:52,0,1,1
56,2023-06-04T23:52:00+10:00,2023-06-04,23:52,1,0,1
58,2023-06-04T23:52:00+10:00,2023-06-04,23:52,3,2,5
62,2023-06-04T23:52:00+10:00,2023-06-04,23:52,3,2,5
3,2023-06-04T23:51:00+10:00,2023-06-04,23:51,0,5,5
26,2023-06-04T23:51:00+10:00,2023-06-04,23:51,0,1,1
41,2023-06-04T23:51:00+10:00,2023-06-04,23:51,1,1,2
65,2023-06-04T23:51:00+10:00,2023-06-04,23:51,1,2,3
78,2023-06-04T23:51:00+10:00,2023-06-04,23:51,0,2,2
10,2023-06-04T23:51:00+10:00,2023-06-04,23:51,2,0,2
17,2023-06-04T23:51:00+10:00,2023-06-04,23:51,1,0,1
19,2023-06-04T23:51:00+10:00,2023-06-04,23:51,2,1,3
62,2023-06-04T23:51:00+10:00,2023-06-04,23:51,0,5,5
67,2023-06-04T23:51:00+10:00,2023-06-04,23:51,0,2,2
79,2023-06-04T23:51:00+10:00,2023-06-04,23:51,0,3,3
6,2023-06-04T23:51:00+10:00,2023-06-04,23:51,2,2,4
21,2023-06-04T23:51:00+10:00,2023-06-04,23:51,0,4,4
42,2023-06-04T23:51:00+10:00,2023-06-04,23:51,0,1,1
45,2023-06-04T23:51:00+10:00,2023-06-04,23:51,1,0,1
47,2023-06-04T23:51:00+10:00,2023-06-04,23:51,0,1,1
2,2023-06-04T23:51:00+10:00,2023-06-04,23:51,1,0,1
20,2023-06-04T23:51:00+10:00,2023-06-04,23:51,0,1,1
35,2023-06-04T23:51:00+10:00,2023-06-04,23:51,1,5,6
52,2023-06-04T23:51:00+10:00,2023-06-04,23:51,0,1,1
57,2023-06-04T23:51:00+10:00,2023-06-04,23:51,0,2,2
58,2023-06-04T23:51:00+10:00,2023-06-04,23:51,1,0,1
5,2023-06-04T23:51:00+10:00,2023-06-04,23:51,4,3,7
14,2023-06-04T23:51:00+10:00,2023-06-04,23:51,4,0,4
54,2023-06-04T23:51:00+10:00,2023-06-04,23:51,1,1,2
55,2023-06-04T23:51:00+10:00,2023-06-04,23:51,4,6,10
61,2023-06-04T23:51:00+10:00,2023-06-04,23:51,1,1,2
66,2023-06-04T23:51:00+10:00,2023-06-04,23:51,3,2,5
70,2023-06-04T23:51:00+10:00,2023-06-04,23:51,0,1,1
1,2023-06-04T23:51:00+10:00,2023-06-04,23:51,0,1,1
12,2023-06-04T23:51:00+10:00,2023-06-04,23:51,0,2,2
24,2023-06-04T23:51:00+10:00,2023-06-04,23:51,0,3,3
30,2023-06-04T23:51:00+10:00,2023-06-04,23:51,0,2,2
49,2023-06-04T23:51:00+10:00,2023-06-04,23:51,0,1,1
14,2023-06-04T23:50:00+10:00,2023-06-04,23:50,1,0,1
21,2023-06-04T23:50:00+10:00,2023-06-04,23:50,4,1,5
37,2023-06-04T23:50:00+10:00,2023-06-04,23:50,1,0,1
45,2023-06-04T23:50:00+10:00,2023-06-04,23:50,0,2,2
65,2023-06-04T23:50:00+10:00,2023-06-04,23:50,3,3,6
107,2023-06-04T23:50:00+10:00,2023-06-04,23:50,2,3,5
35,2023-06-04T23:50:00+10:00,2023-06-04,23:50,1,0,1
58,2023-06-04T23:50:00+10:00,2023-06-04,23:50,0,1,1
26,2023-06-04T23:50:00+10:00,2023-06-04,23:50,1,0,1
61,2023-06-04T23:50:00+10:00,2023-06-04,23:50,2,2,4
118,2023-06-04T23:50:00+10:00,2023-06-04,23:50,0,1,1
52,2023-06-04T23:50:00+10:00,2023-06-04,23:50,1,0,1
62,2023-06-04T23:50:00+10:00,2023-06-04,23:50,0,1,1
3,2023-06-04T23:50:00+10:00,2023-06-04,23:50,3,2,5
4,2023-06-04T23:50:00+10:00,2023-06-04,23:50,1,2,3
5,2023-06-04T23:50:00+10:00,2023-06-04,23:50,2,5,7
28,2023-06-04T23:50:00+10:00,2023-06-04,23:50,1,0,1
47,2023-06-04T23:50:00+10:00,2023-06-04,23:50,7,0,7
55,2023-06-04T23:50:00+10:00,2023-06-04,23:50,2,4,6
59,2023-06-04T23:50:00+10:00,2023-06-04,23:50,19,8,27
66,2023-06-04T23:50:00+10:00,2023-06-04,23:50,2,4,6
84,2023-06-04T23:50:00+10:00,2023-06-04,23:50,12,13,25
23,2023-06-04T23:50:00+10:00,2023-06-04,23:50,0,2,2
24,2023-06-04T23:50:00+10:00,2023-06-04,23:50,1,4,5
27,2023-06-04T23:50:00+10:00,2023-06-04,23:50,0,1,1
49,2023-06-04T23:50:00+10:00,2023-06-04,23:50,1,0,1
53,2023-06-04T23:50:00+10:00,2023-06-04,23:50,1,0,1
117,2023-06-04T23:50:00+10:00,2023-06-04,23:50,0,6,6
3,2023-06-04T23:49:00+10:00,2023-06-04,23:49,1,0,1
4,2023-06-04T23:49:00+10:00,2023-06-04,23:49,1,0,1
5,2023-06-04T23:49:00+10:00,2023-06-04,23:49,1,0,1
21,2023-06-04T23:49:00+10:00,2023-06-04,23:49,3,0,3
54,2023-06-04T23:49:00+10:00,2023-06-04,23:49,3,0,3
55,2023-06-04T23:49:00+10:00,2023-06-04,23:49,6,1,7
61,2023-06-04T23:49:00+10:00,2023-06-04,23:49,0,1,1
66,2023-06-04T23:49:00+10:00,2023-06-04,23:49,1,0,1
2,2023-06-04T23:49:00+10:00,2023-06-04,23:49,0,2,2
9,2023-06-04T23:49:00+10:00,2023-06-04,23:49,1,0,1
35,2023-06-04T23:49:00+10:00,2023-06-04,23:49,1,5,6
48,2023-06-04T23:49:00+10:00,2023-06-04,23:49,2,0,2
28,2023-06-04T23:49:00+10:00,2023-06-04,23:49,0,1,1
37,2023-06-04T23:49:00+10:00,2023-06-04,23:49,1,0,1
41,2023-06-04T23:49:00+10:00,2023-06-04,23:49,5,3,8
45,2023-06-04T23:49:00+10:00,2023-06-04,23:49,1,2,3
77,2023-06-04T23:49:00+10:00,2023-06-04,23:49,2,0,2
1,2023-06-04T23:49:00+10:00,2023-06-04,23:49,1,0,1
24,2023-06-04T23:49:00+10:00,2023-06-04,23:49,1,2,3
30,2023-06-04T23:49:00+10:00,2023-06-04,23:49,5,1,6
57,2023-06-04T23:49:00+10:00,2023-06-04,23:49,0,3,3
6,2023-06-04T23:49:00+10:00,2023-06-04,23:49,6,0,6
14,2023-06-04T23:49:00+10:00,2023-06-04,23:49,2,0,2
26,2023-06-04T23:49:00+10:00,2023-06-04,23:49,3,1,4
42,2023-06-04T23:49:00+10:00,2023-06-04,23:49,0,4,4
47,2023-06-04T23:49:00+10:00,2023-06-04,23:49,1,0,1
65,2023-06-04T23:49:00+10:00,2023-06-04,23:49,3,2,5
20,2023-06-04T23:49:00+10:00,2023-06-04,23:49,2,4,6
27,2023-06-04T23:49:00+10:00,2023-06-04,23:49,1,0,1
49,2023-06-04T23:49:00+10:00,2023-06-04,23:49,0,2,2
53,2023-06-04T23:49:00+10:00,2023-06-04,23:49,0,1,1
58,2023-06-04T23:49:00+10:00,2023-06-04,23:49,0,1,1
62,2023-06-04T23:49:00+10:00,2023-06-04,23:49,1,0,1
79,2023-06-04T23:49:00+10:00,2023-06-04,23:49,1,5,6
14,2023-06-04T23:48:00+10:00,2023-06-04,23:48,2,0,2
21,2023-06-04T23:48:00+10:00,2023-06-04,23:48,2,4,6
26,2023-06-04T23:48:00+10:00,2023-06-04,23:48,2,0,2
29,2023-06-04T23:48:00+10:00,2023-06-04,23:48,0,2,2
45,2023-06-04T23:48:00+10:00,2023-06-04,23:48,1,1,2
47,2023-06-04T23:48:00+10:00,2023-06-04,23:48,0,3,3
55,2023-06-04T23:48:00+10:00,2023-06-04,23:48,11,5,16
65,2023-06-04T23:48:00+10:00,2023-06-04,23:48,5,1,6
77,2023-06-04T23:48:00+10:00,2023-06-04,23:48,2,0,2
20,2023-06-04T23:48:00+10:00,2023-06-04,23:48,0,1,1
24,2023-06-04T23:48:00+10:00,2023-06-04,23:48,1,4,5
35,2023-06-04T23:48:00+10:00,2023-06-04,23:48,1,1,2
52,2023-06-04T23:48:00+10:00,2023-06-04,23:48,0,5,5
58,2023-06-04T23:48:00+10:00,2023-06-04,23:48,2,2,4
72,2023-06-04T23:48:00+10:00,2023-06-04,23:48,0,3,3
4,2023-06-04T23:48:00+10:00,2023-06-04,23:48,1,1,2
42,2023-06-04T23:48:00+10:00,2023-06-04,23:48,1,0,1
54,2023-06-04T23:48:00+10:00,2023-06-04,23:48,0,3,3
61,2023-06-04T23:48:00+10:00,2023-06-04,23:48,1,0,1
66,2023-06-04T23:48:00+10:00,2023-06-04,23:48,4,4,8
1,2023-06-04T23:48:00+10:00,2023-06-04,23:48,0,1,1
19,2023-06-04T23:48:00+10:00,2023-06-04,23:48,0,1,1
49,2023-06-04T23:48:00+10:00,2023-06-04,23:48,2,0,2
51,2023-06-04T23:48:00+10:00,2023-06-04,23:48,0,3,3
62,2023-06-04T23:48:00+10:00,2023-06-04,23:48,2,0,2
67,2023-06-04T23:48:00+10:00,2023-06-04,23:48,0,1,1
79,2023-06-04T23:48:00+10:00,2023-06-04,23:48,2,0,2
3,2023-06-04T23:48:00+10:00,2023-06-04,23:48,2,6,8
6,2023-06-04T23:48:00+10:00,2023-06-04,23:48,3,3,6
41,2023-06-04T23:48:00+10:00,2023-06-04,23:48,2,0,2
27,2023-06-04T23:48:00+10:00,2023-06-04,23:48,1,0,1
30,2023-06-04T23:48:00+10:00,2023-06-04,23:48,0,3,3
57,2023-06-04T23:48:00+10:00,2023-06-04,23:48,1,0,1
14,2023-06-04T23:47:00+10:00,2023-06-04,23:47,1,0,1
21,2023-06-04T23:47:00+10:00,2023-06-04,23:47,0,3,3
26,2023-06-04T23:47:00+10:00,2023-06-04,23:47,1,3,4
39,2023-06-04T23:47:00+10:00,2023-06-04,23:47,0,1,1
55,2023-06-04T23:47:00+10:00,2023-06-04,23:47,5,4,9
61,2023-06-04T23:47:00+10:00,2023-06-04,23:47,1,1,2
49,2023-06-04T23:47:00+10:00,2023-06-04,23:47,5,3,8
53,2023-06-04T23:47:00+10:00,2023-06-04,23:47,3,3,6
57,2023-06-04T23:47:00+10:00,2023-06-04,23:47,0,1,1
3,2023-06-04T23:47:00+10:00,2023-06-04,23:47,4,2,6
4,2023-06-04T23:47:00+10:00,2023-06-04,23:47,0,1,1
45,2023-06-04T23:47:00+10:00,2023-06-04,23:47,2,0,2
65,2023-06-04T23:47:00+10:00,2023-06-04,23:47,0,1,1
66,2023-06-04T23:47:00+10:00,2023-06-04,23:47,12,3,15
23,2023-06-04T23:47:00+10:00,2023-06-04,23:47,0,1,1
48,2023-06-04T23:47:00+10:00,2023-06-04,23:47,0,1,1
58,2023-06-04T23:47:00+10:00,2023-06-04,23:47,2,3,5
62,2023-06-04T23:47:00+10:00,2023-06-04,23:47,1,1,2
79,2023-06-04T23:47:00+10:00,2023-06-04,23:47,3,0,3
6,2023-06-04T23:47:00+10:00,2023-06-04,23:47,3,2,5
36,2023-06-04T23:47:00+10:00,2023-06-04,23:47,2,0,2
41,2023-06-04T23:47:00+10:00,2023-06-04,23:47,0,5,5
47,2023-06-04T23:47:00+10:00,2023-06-04,23:47,1,4,5
19,2023-06-04T23:47:00+10:00,2023-06-04,23:47,0,4,4
20,2023-06-04T23:47:00+10:00,2023-06-04,23:47,0,1,1
24,2023-06-04T23:47:00+10:00,2023-06-04,23:47,0,3,3
30,2023-06-04T23:47:00+10:00,2023-06-04,23:47,0,1,1
35,2023-06-04T23:47:00+10:00,2023-06-04,23:47,1,0,1
46,2023-06-04T23:47:00+10:00,2023-06-04,23:47,3,0,3
67,2023-06-04T23:47:00+10:00,2023-06-04,23:47,1,1,2
72,2023-06-04T23:47:00+10:00,2023-06-04,23:47,0,1,1
3,2023-06-04T23:46:00+10:00,2023-06-04,23:46,1,0,1
6,2023-06-04T23:46:00+10:00,2023-06-04,23:46,4,1,5
42,2023-06-04T23:46:00+10:00,2023-06-04,23:46,0,3,3
45,2023-06-04T23:46:00+10:00,2023-06-04,23:46,3,2,5
54,2023-06-04T23:46:00+10:00,2023-06-04,23:46,2,3,5
55,2023-06-04T23:46:00+10:00,2023-06-04,23:46,6,3,9
65,2023-06-04T23:46:00+10:00,2023-06-04,23:46,2,5,7
66,2023-06-04T23:46:00+10:00,2023-06-04,23:46,0,1,1
108,2023-06-04T23:46:00+10:00,2023-06-04,23:46,1,0,1
10,2023-06-04T23:46:00+10:00,2023-06-04,23:46,0,1,1
35,2023-06-04T23:46:00+10:00,2023-06-04,23:46,2,4,6
49,2023-06-04T23:46:00+10:00,2023-06-04,23:46,0,1,1
67,2023-06-04T23:46:00+10:00,2023-06-04,23:46,0,1,1
8,2023-06-04T23:46:00+10:00,2023-06-04,23:46,0,1,1
41,2023-06-04T23:46:00+10:00,2023-06-04,23:46,3,3,6
27,2023-06-04T23:46:00+10:00,2023-06-04,23:46,0,2,2
48,2023-06-04T23:46:00+10:00,2023-06-04,23:46,0,2,2
56,2023-06-04T23:46:00+10:00,2023-06-04,23:46,0,2,2
57,2023-06-04T23:46:00+10:00,2023-06-04,23:46,2,0,2
4,2023-06-04T23:46:00+10:00,2023-06-04,23:46,2,0,2
5,2023-06-04T23:46:00+10:00,2023-06-04,23:46,2,0,2
14,2023-06-04T23:46:00+10:00,2023-06-04,23:46,2,2,4
26,2023-06-04T23:46:00+10:00,2023-06-04,23:46,0,5,5
47,2023-06-04T23:46:00+10:00,2023-06-04,23:46,6,0,6
19,2023-06-04T23:46:00+10:00,2023-06-04,23:46,0,1,1
24,2023-06-04T23:46:00+10:00,2023-06-04,23:46,0,5,5
30,2023-06-04T23:46:00+10:00,2023-06-04,23:46,1,5,6
46,2023-06-04T23:46:00+10:00,2023-06-04,23:46,2,1,3
52,2023-06-04T23:46:00+10:00,2023-06-04,23:46,1,0,1
53,2023-06-04T23:46:00+10:00,2023-06-04,23:46,0,3,3
62,2023-06-04T23:46:00+10:00,2023-06-04,23:46,3,2,5
79,2023-06-04T23:46:00+10:00,2023-06-04,23:46,0,1,1
29,2023-06-04T23:45:00+10:00,2023-06-04,23:45,3,0,3
47,2023-06-04T23:45:00+10:00,2023-06-04,23:45,1,3,4
55,2023-06-04T23:45:00+10:00,2023-06-04,23:45,2,4,6
59,2023-06-04T23:45:00+10:00,2023-06-04,23:45,7,1,8
65,2023-06-04T23:45:00+10:00,2023-06-04,23:45,2,5,7
118,2023-06-04T23:45:00+10:00,2023-06-04,23:45,0,4,4
2,2023-06-04T23:45:00+10:00,2023-06-04,23:45,0,2,2
10,2023-06-04T23:45:00+10:00,2023-06-04,23:45,1,2,3
24,2023-06-04T23:45:00+10:00,2023-06-04,23:45,0,5,5
48,2023-06-04T23:45:00+10:00,2023-06-04,23:45,0,1,1
52,2023-06-04T23:45:00+10:00,2023-06-04,23:45,1,0,1
57,2023-06-04T23:45:00+10:00,2023-06-04,23:45,0,3,3
62,2023-06-04T23:45:00+10:00,2023-06-04,23:45,4,0,4
79,2023-06-04T23:45:00+10:00,2023-06-04,23:45,2,1,3
109,2023-06-04T23:45:00+10:00,2023-06-04,23:45,4,5,9
84,2023-06-04T23:45:00+10:00,2023-06-04,23:45,15,9,24
108,2023-06-04T23:45:00+10:00,2023-06-04,23:45,3,0,3
11,2023-06-04T23:45:00+10:00,2023-06-04,23:45,0,3,3
12,2023-06-04T23:45:00+10:00,2023-06-04,23:45,0,3,3
19,2023-06-04T23:45:00+10:00,2023-06-04,23:45,3,2,5
23,2023-06-04T23:45:00+10:00,2023-06-04,23:45,0,1,1
30,2023-06-04T23:45:00+10:00,2023-06-04,23:45,0,6,6
35,2023-06-04T23:45:00+10:00,2023-06-04,23:45,2,0,2
67,2023-06-04T23:45:00+10:00,2023-06-04,23:45,1,0,1
72,2023-06-04T23:45:00+10:00,2023-06-04,23:45,1,1,2
117,2023-06-04T23:45:00+10:00,2023-06-04,23:45,4,0,4
3,2023-06-04T23:45:00+10:00,2023-06-04,23:45,8,3,11
4,2023-06-04T23:45:00+10:00,2023-06-04,23:45,4,0,4
5,2023-06-04T23:45:00+10:00,2023-06-04,23:45,0,1,1
6,2023-06-04T23:45:00+10:00,2023-06-04,23:45,4,1,5
41,2023-06-04T23:45:00+10:00,2023-06-04,23:45,2,4,6
66,2023-06-04T23:45:00+10:00,2023-06-04,23:45,4,2,6
107,2023-06-04T23:45:00+10:00,2023-06-04,23:45,4,0,4
1,2023-06-04T23:45:00+10:00,2023-06-04,23:45,1,0,1
20,2023-06-04T23:45:00+10:00,2023-06-04,23:45,0,7,7
49,2023-06-04T23:45:00+10:00,2023-06-04,23:45,0,1,1
56,2023-06-04T23:45:00+10:00,2023-06-04,23:45,2,0,2
58,2023-06-04T23:45:00+10:00,2023-06-04,23:45,0,1,1
14,2023-06-04T23:44:00+10:00,2023-06-04,23:44,4,0,4
28,2023-06-04T23:44:00+10:00,2023-06-04,23:44,1,0,1
41,2023-06-04T23:44:00+10:00,2023-06-04,23:44,0,3,3
45,2023-06-04T23:44:00+10:00,2023-06-04,23:44,0,2,2
1,2023-06-04T23:44:00+10:00,2023-06-04,23:44,2,2,4
2,2023-06-04T23:44:00+10:00,2023-06-04,23:44,0,3,3
11,2023-06-04T23:44:00+10:00,2023-06-04,23:44,1,0,1
19,2023-06-04T23:44:00+10:00,2023-06-04,23:44,3,0,3
20,2023-06-04T23:44:00+10:00,2023-06-04,23:44,1,1,2
23,2023-06-04T23:44:00+10:00,2023-06-04,23:44,0,3,3
6,2023-06-04T23:44:00+10:00,2023-06-04,23:44,1,3,4
55,2023-06-04T23:44:00+10:00,2023-06-04,23:44,4,2,6
108,2023-06-04T23:44:00+10:00,2023-06-04,23:44,0,3,3
10,2023-06-04T23:44:00+10:00,2023-06-04,23:44,2,0,2
30,2023-06-04T23:44:00+10:00,2023-06-04,23:44,3,1,4
67,2023-06-04T23:44:00+10:00,2023-06-04,23:44,0,2,2
3,2023-06-04T23:44:00+10:00,2023-06-04,23:44,1,2,3
4,2023-06-04T23:44:00+10:00,2023-06-04,23:44,4,1,5
26,2023-06-04T23:44:00+10:00,2023-06-04,23:44,1,0,1
47,2023-06-04T23:44:00+10:00,2023-06-04,23:44,3,10,13
50,2023-06-04T23:44:00+10:00,2023-06-04,23:44,1,0,1
87,2023-06-04T23:44:00+10:00,2023-06-04,23:44,0,1,1
12,2023-06-04T23:44:00+10:00,2023-06-04,23:44,1,0,1
24,2023-06-04T23:44:00+10:00,2023-06-04,23:44,0,13,13
35,2023-06-04T23:44:00+10:00,2023-06-04,23:44,1,3,4
49,2023-06-04T23:44:00+10:00,2023-06-04,23:44,3,0,3
57,2023-06-04T23:44:00+10:00,2023-06-04,23:44,0,3,3
58,2023-06-04T23:44:00+10:00,2023-06-04,23:44,3,1,4
62,2023-06-04T23:44:00+10:00,2023-06-04,23:44,0,1,1
79,2023-06-04T23:44:00+10:00,2023-06-04,23:44,2,1,3
3,2023-06-04T23:43:00+10:00,2023-06-04,23:43,4,1,5
14,2023-06-04T23:43:00+10:00,2023-06-04,23:43,1,0,1
41,2023-06-04T23:43:00+10:00,2023-06-04,23:43,4,2,6
65,2023-06-04T23:43:00+10:00,2023-06-04,23:43,0,1,1
75,2023-06-04T23:43:00+10:00,2023-06-04,23:43,2,0,2
23,2023-06-04T23:43:00+10:00,2023-06-04,23:43,0,1,1
24,2023-06-04T23:43:00+10:00,2023-06-04,23:43,0,3,3
56,2023-06-04T23:43:00+10:00,2023-06-04,23:43,0,1,1
58,2023-06-04T23:43:00+10:00,2023-06-04,23:43,1,2,3
67,2023-06-04T23:43:00+10:00,2023-06-04,23:43,0,1,1
79,2023-06-04T23:43:00+10:00,2023-06-04,23:43,0,3,3
5,2023-06-04T23:43:00+10:00,2023-06-04,23:43,1,0,1
6,2023-06-04T23:43:00+10:00,2023-06-04,23:43,0,1,1
31,2023-06-04T23:43:00+10:00,2023-06-04,23:43,0,3,3
37,2023-06-04T23:43:00+10:00,2023-06-04,23:43,2,0,2
55,2023-06-04T23:43:00+10:00,2023-06-04,23:43,6,7,13
66,2023-06-04T23:43:00+10:00,2023-06-04,23:43,1,0,1
77,2023-06-04T23:43:00+10:00,2023-06-04,23:43,1,1,2
62,2023-06-04T23:43:00+10:00,2023-06-04,23:43,1,1,2
4,2023-06-04T23:43:00+10:00,2023-06-04,23:43,1,2,3
21,2023-06-04T23:43:00+10:00,2023-06-04,23:43,3,3,6
26,2023-06-04T23:43:00+10:00,2023-06-04,23:43,3,1,4
29,2023-06-04T23:43:00+10:00,2023-06-04,23:43,3,0,3
44,2023-06-04T23:43:00+10:00,2023-06-04,23:43,1,0,1
45,2023-06-04T23:43:00+10:00,2023-06-04,23:43,0,6,6
47,2023-06-04T23:43:00+10:00,2023-06-04,23:43,0,4,4
54,2023-06-04T23:43:00+10:00,2023-06-04,23:43,0,3,3
61,2023-06-04T23:43:00+10:00,2023-06-04,23:43,1,1,2
19,2023-06-04T23:43:00+10:00,2023-06-04,23:43,3,0,3
20,2023-06-04T23:43:00+10:00,2023-06-04,23:43,1,0,1
35,2023-06-04T23:43:00+10:00,2023-06-04,23:43,0,1,1
53,2023-06-04T23:43:00+10:00,2023-06-04,23:43,1,0,1
68,2023-06-04T23:43:00+10:00,2023-06-04,23:43,1,0,1
3,2023-06-04T23:42:00+10:00,2023-06-04,23:42,5,4,9
4,2023-06-04T23:42:00+10:00,2023-06-04,23:42,1,0,1
19,2023-06-04T23:42:00+10:00,2023-06-04,23:42,1,0,1
49,2023-06-04T23:42:00+10:00,2023-06-04,23:42,0,5,5
53,2023-06-04T23:42:00+10:00,2023-06-04,23:42,0,2,2
79,2023-06-04T23:42:00+10:00,2023-06-04,23:42,0,4,4
21,2023-06-04T23:42:00+10:00,2023-06-04,23:42,0,1,1
26,2023-06-04T23:42:00+10:00,2023-06-04,23:42,0,1,1
45,2023-06-04T23:42:00+10:00,2023-06-04,23:42,4,3,7
47,2023-06-04T23:42:00+10:00,2023-06-04,23:42,2,0,2
61,2023-06-04T23:42:00+10:00,2023-06-04,23:42,1,1,2
65,2023-06-04T23:42:00+10:00,2023-06-04,23:42,1,1,2
2,2023-06-04T23:42:00+10:00,2023-06-04,23:42,0,3,3
11,2023-06-04T23:42:00+10:00,2023-06-04,23:42,0,1,1
51,2023-06-04T23:42:00+10:00,2023-06-04,23:42,0,1,1
57,2023-06-04T23:42:00+10:00,2023-06-04,23:42,0,3,3
62,2023-06-04T23:42:00+10:00,2023-06-04,23:42,2,0,2
67,2023-06-04T23:42:00+10:00,2023-06-04,23:42,4,0,4
72,2023-06-04T23:42:00+10:00,2023-06-04,23:42,0,1,1
5,2023-06-04T23:42:00+10:00,2023-06-04,23:42,0,4,4
6,2023-06-04T23:42:00+10:00,2023-06-04,23:42,0,1,1
14,2023-06-04T23:42:00+10:00,2023-06-04,23:42,2,0,2
28,2023-06-04T23:42:00+10:00,2023-06-04,23:42,1,0,1
41,2023-06-04T23:42:00+10:00,2023-06-04,23:42,5,3,8
42,2023-06-04T23:42:00+10:00,2023-06-04,23:42,1,0,1
54,2023-06-04T23:42:00+10:00,2023-06-04,23:42,1,1,2
55,2023-06-04T23:42:00+10:00,2023-06-04,23:42,4,0,4
66,2023-06-04T23:42:00+10:00,2023-06-04,23:42,1,4,5
77,2023-06-04T23:42:00+10:00,2023-06-04,23:42,2,0,2
24,2023-06-04T23:42:00+10:00,2023-06-04,23:42,3,0,3
30,2023-06-04T23:42:00+10:00,2023-06-04,23:42,1,0,1
35,2023-06-04T23:42:00+10:00,2023-06-04,23:42,1,2,3
58,2023-06-04T23:42:00+10:00,2023-06-04,23:42,0,1,1
4,2023-06-04T23:41:00+10:00,2023-06-04,23:41,5,1,6
29,2023-06-04T23:41:00+10:00,2023-06-04,23:41,1,0,1
31,2023-06-04T23:41:00+10:00,2023-06-04,23:41,3,2,5
42,2023-06-04T23:41:00+10:00,2023-06-04,23:41,2,2,4
12,2023-06-04T23:41:00+10:00,2023-06-04,23:41,0,2,2
19,2023-06-04T23:41:00+10:00,2023-06-04,23:41,4,0,4
24,2023-06-04T23:41:00+10:00,2023-06-04,23:41,3,1,4
30,2023-06-04T23:41:00+10:00,2023-06-04,23:41,1,0,1
51,2023-06-04T23:41:00+10:00,2023-06-04,23:41,2,0,2
56,2023-06-04T23:41:00+10:00,2023-06-04,23:41,3,0,3
57,2023-06-04T23:41:00+10:00,2023-06-04,23:41,1,0,1
3,2023-06-04T23:41:00+10:00,2023-06-04,23:41,4,6,10
5,2023-06-04T23:41:00+10:00,2023-06-04,23:41,1,4,5
28,2023-06-04T23:41:00+10:00,2023-06-04,23:41,2,0,2
41,2023-06-04T23:41:00+10:00,2023-06-04,23:41,6,2,8
47,2023-06-04T23:41:00+10:00,2023-06-04,23:41,2,0,2
65,2023-06-04T23:41:00+10:00,2023-06-04,23:41,0,4,4
10,2023-06-04T23:41:00+10:00,2023-06-04,23:41,1,0,1
35,2023-06-04T23:41:00+10:00,2023-06-04,23:41,5,0,5
52,2023-06-04T23:41:00+10:00,2023-06-04,23:41,0,1,1
53,2023-06-04T23:41:00+10:00,2023-06-04,23:41,2,0,2
76,2023-06-04T23:41:00+10:00,2023-06-04,23:41,1,0,1
6,2023-06-04T23:41:00+10:00,2023-06-04,23:41,2,4,6
14,2023-06-04T23:41:00+10:00,2023-06-04,23:41,1,0,1
21,2023-06-04T23:41:00+10:00,2023-06-04,23:41,9,1,10
26,2023-06-04T23:41:00+10:00,2023-06-04,23:41,1,2,3
45,2023-06-04T23:41:00+10:00,2023-06-04,23:41,1,5,6
55,2023-06-04T23:41:00+10:00,2023-06-04,23:41,6,2,8
66,2023-06-04T23:41:00+10:00,2023-06-04,23:41,2,2,4
9,2023-06-04T23:41:00+10:00,2023-06-04,23:41,1,0,1
49,2023-06-04T23:41:00+10:00,2023-06-04,23:41,2,1,3
62,2023-06-04T23:41:00+10:00,2023-06-04,23:41,2,2,4
3,2023-06-04T23:40:00+10:00,2023-06-04,23:40,2,6,8
5,2023-06-04T23:40:00+10:00,2023-06-04,23:40,0,2,2
28,2023-06-04T23:40:00+10:00,2023-06-04,23:40,1,0,1
29,2023-06-04T23:40:00+10:00,2023-06-04,23:40,2,1,3
41,2023-06-04T23:40:00+10:00,2023-06-04,23:40,1,2,3
45,2023-06-04T23:40:00+10:00,2023-06-04,23:40,4,4,8
54,2023-06-04T23:40:00+10:00,2023-06-04,23:40,0,1,1
55,2023-06-04T23:40:00+10:00,2023-06-04,23:40,7,5,12
1,2023-06-04T23:40:00+10:00,2023-06-04,23:40,0,3,3
2,2023-06-04T23:40:00+10:00,2023-06-04,23:40,1,3,4
24,2023-06-04T23:40:00+10:00,2023-06-04,23:40,0,1,1
30,2023-06-04T23:40:00+10:00,2023-06-04,23:40,1,0,1
52,2023-06-04T23:40:00+10:00,2023-06-04,23:40,0,3,3
56,2023-06-04T23:40:00+10:00,2023-06-04,23:40,3,7,10
58,2023-06-04T23:40:00+10:00,2023-06-04,23:40,5,0,5
67,2023-06-04T23:40:00+10:00,2023-06-04,23:40,1,0,1
72,2023-06-04T23:40:00+10:00,2023-06-04,23:40,0,1,1
79,2023-06-04T23:40:00+10:00,2023-06-04,23:40,0,1,1
4,2023-06-04T23:40:00+10:00,2023-06-04,23:40,1,4,5
14,2023-06-04T23:40:00+10:00,2023-06-04,23:40,1,0,1
21,2023-06-04T23:40:00+10:00,2023-06-04,23:40,3,0,3
26,2023-06-04T23:40:00+10:00,2023-06-04,23:40,1,0,1
42,2023-06-04T23:40:00+10:00,2023-06-04,23:40,0,2,2
61,2023-06-04T23:40:00+10:00,2023-06-04,23:40,0,5,5
66,2023-06-04T23:40:00+10:00,2023-06-04,23:40,8,0,8
107,2023-06-04T23:40:00+10:00,2023-06-04,23:40,0,3,3
48,2023-06-04T23:40:00+10:00,2023-06-04,23:40,0,3,3
51,2023-06-04T23:40:00+10:00,2023-06-04,23:40,0,2,2
62,2023-06-04T23:40:00+10:00,2023-06-04,23:40,1,0,1
109,2023-06-04T23:40:00+10:00,2023-06-04,23:40,1,2,3
117,2023-06-04T23:40:00+10:00,2023-06-04,23:40,2,2,4
6,2023-06-04T23:40:00+10:00,2023-06-04,23:40,2,2,4
31,2023-06-04T23:40:00+10:00,2023-06-04,23:40,0,1,1
40,2023-06-04T23:40:00+10:00,2023-06-04,23:40,1,0,1
47,2023-06-04T23:40:00+10:00,2023-06-04,23:40,0,3,3
59,2023-06-04T23:40:00+10:00,2023-06-04,23:40,10,4,14
84,2023-06-04T23:40:00+10:00,2023-06-04,23:40,12,11,23
19,2023-06-04T23:40:00+10:00,2023-06-04,23:40,1,3,4
20,2023-06-04T23:40:00+10:00,2023-06-04,23:40,0,1,1
27,2023-06-04T23:40:00+10:00,2023-06-04,23:40,1,0,1
35,2023-06-04T23:40:00+10:00,2023-06-04,23:40,4,2,6
5,2023-06-04T23:39:00+10:00,2023-06-04,23:39,2,2,4
21,2023-06-04T23:39:00+10:00,2023-06-04,23:39,0,2,2
54,2023-06-04T23:39:00+10:00,2023-06-04,23:39,0,1,1
108,2023-06-04T23:39:00+10:00,2023-06-04,23:39,1,0,1
1,2023-06-04T23:39:00+10:00,2023-06-04,23:39,3,0,3
12,2023-06-04T23:39:00+10:00,2023-06-04,23:39,0,4,4
19,2023-06-04T23:39:00+10:00,2023-06-04,23:39,4,1,5
24,2023-06-04T23:39:00+10:00,2023-06-04,23:39,0,4,4
27,2023-06-04T23:39:00+10:00,2023-06-04,23:39,1,0,1
52,2023-06-04T23:39:00+10:00,2023-06-04,23:39,1,0,1
56,2023-06-04T23:39:00+10:00,2023-06-04,23:39,0,1,1
79,2023-06-04T23:39:00+10:00,2023-06-04,23:39,0,2,2
4,2023-06-04T23:39:00+10:00,2023-06-04,23:39,3,1,4
14,2023-06-04T23:39:00+10:00,2023-06-04,23:39,1,0,1
36,2023-06-04T23:39:00+10:00,2023-06-04,23:39,1,0,1
41,2023-06-04T23:39:00+10:00,2023-06-04,23:39,2,4,6
42,2023-06-04T23:39:00+10:00,2023-06-04,23:39,1,0,1
55,2023-06-04T23:39:00+10:00,2023-06-04,23:39,2,4,6
65,2023-06-04T23:39:00+10:00,2023-06-04,23:39,1,0,1
49,2023-06-04T23:39:00+10:00,2023-06-04,23:39,1,2,3
3,2023-06-04T23:39:00+10:00,2023-06-04,23:39,1,4,5
6,2023-06-04T23:39:00+10:00,2023-06-04,23:39,3,1,4
39,2023-06-04T23:39:00+10:00,2023-06-04,23:39,0,1,1
47,2023-06-04T23:39:00+10:00,2023-06-04,23:39,1,1,2
66,2023-06-04T23:39:00+10:00,2023-06-04,23:39,1,0,1
2,2023-06-04T23:39:00+10:00,2023-06-04,23:39,1,1,2
30,2023-06-04T23:39:00+10:00,2023-06-04,23:39,3,1,4
35,2023-06-04T23:39:00+10:00,2023-06-04,23:39,1,3,4
53,2023-06-04T23:39:00+10:00,2023-06-04,23:39,0,1,1
58,2023-06-04T23:39:00+10:00,2023-06-04,23:39,0,4,4
67,2023-06-04T23:39:00+10:00,2023-06-04,23:39,1,1,2
3,2023-06-04T23:38:00+10:00,2023-06-04,23:38,0,5,5
14,2023-06-04T23:38:00+10:00,2023-06-04,23:38,1,0,1
47,2023-06-04T23:38:00+10:00,2023-06-04,23:38,2,0,2
66,2023-06-04T23:38:00+10:00,2023-06-04,23:38,0,1,1
108,2023-06-04T23:38:00+10:00,2023-06-04,23:38,0,1,1
2,2023-06-04T23:38:00+10:00,2023-06-04,23:38,0,1,1
19,2023-06-04T23:38:00+10:00,2023-06-04,23:38,1,0,1
20,2023-06-04T23:38:00+10:00,2023-06-04,23:38,0,2,2
48,2023-06-04T23:38:00+10:00,2023-06-04,23:38,1,1,2
62,2023-06-04T23:38:00+10:00,2023-06-04,23:38,1,0,1
79,2023-06-04T23:38:00+10:00,2023-06-04,23:38,1,2,3
26,2023-06-04T23:38:00+10:00,2023-06-04,23:38,3,0,3
41,2023-06-04T23:38:00+10:00,2023-06-04,23:38,0,4,4
65,2023-06-04T23:38:00+10:00,2023-06-04,23:38,1,1,2
1,2023-06-04T23:38:00+10:00,2023-06-04,23:38,0,2,2
23,2023-06-04T23:38:00+10:00,2023-06-04,23:38,0,1,1
30,2023-06-04T23:38:00+10:00,2023-06-04,23:38,5,1,6
46,2023-06-04T23:38:00+10:00,2023-06-04,23:38,2,0,2
4,2023-06-04T23:38:00+10:00,2023-06-04,23:38,1,2,3
5,2023-06-04T23:38:00+10:00,2023-06-04,23:38,2,3,5
6,2023-06-04T23:38:00+10:00,2023-06-04,23:38,2,1,3
45,2023-06-04T23:38:00+10:00,2023-06-04,23:38,0,3,3
55,2023-06-04T23:38:00+10:00,2023-06-04,23:38,8,8,16
10,2023-06-04T23:38:00+10:00,2023-06-04,23:38,1,1,2
24,2023-06-04T23:38:00+10:00,2023-06-04,23:38,0,1,1
35,2023-06-04T23:38:00+10:00,2023-06-04,23:38,1,1,2
52,2023-06-04T23:38:00+10:00,2023-06-04,23:38,1,0,1
56,2023-06-04T23:38:00+10:00,2023-06-04,23:38,1,0,1
58,2023-06-04T23:38:00+10:00,2023-06-04,23:38,1,0,1
3,2023-06-04T23:37:00+10:00,2023-06-04,23:37,4,1,5
4,2023-06-04T23:37:00+10:00,2023-06-04,23:37,9,3,12
5,2023-06-04T23:37:00+10:00,2023-06-04,23:37,0,1,1
6,2023-06-04T23:37:00+10:00,2023-06-04,23:37,1,0,1
36,2023-06-04T23:37:00+10:00,2023-06-04,23:37,0,2,2
41,2023-06-04T23:37:00+10:00,2023-06-04,23:37,9,0,9
45,2023-06-04T23:37:00+10:00,2023-06-04,23:37,1,2,3
55,2023-06-04T23:37:00+10:00,2023-06-04,23:37,4,0,4
1,2023-06-04T23:37:00+10:00,2023-06-04,23:37,1,1,2
19,2023-06-04T23:37:00+10:00,2023-06-04,23:37,0,4,4
30,2023-06-04T23:37:00+10:00,2023-06-04,23:37,3,0,3
46,2023-06-04T23:37:00+10:00,2023-06-04,23:37,0,1,1
58,2023-06-04T23:37:00+10:00,2023-06-04,23:37,0,1,1
67,2023-06-04T23:37:00+10:00,2023-06-04,23:37,1,0,1
31,2023-06-04T23:37:00+10:00,2023-06-04,23:37,0,1,1
42,2023-06-04T23:37:00+10:00,2023-06-04,23:37,0,2,2
47,2023-06-04T23:37:00+10:00,2023-06-04,23:37,1,2,3
61,2023-06-04T23:37:00+10:00,2023-06-04,23:37,2,0,2
65,2023-06-04T23:37:00+10:00,2023-06-04,23:37,1,2,3
66,2023-06-04T23:37:00+10:00,2023-06-04,23:37,0,2,2
10,2023-06-04T23:37:00+10:00,2023-06-04,23:37,5,0,5
24,2023-06-04T23:37:00+10:00,2023-06-04,23:37,0,1,1
27,2023-06-04T23:37:00+10:00,2023-06-04,23:37,1,0,1
35,2023-06-04T23:37:00+10:00,2023-06-04,23:37,0,2,2
62,2023-06-04T23:37:00+10:00,2023-06-04,23:37,0,5,5
21,2023-06-04T23:37:00+10:00,2023-06-04,23:37,0,7,7
26,2023-06-04T23:37:00+10:00,2023-06-04,23:37,3,0,3
44,2023-06-04T23:37:00+10:00,2023-06-04,23:37,0,2,2
9,2023-06-04T23:37:00+10:00,2023-06-04,23:37,1,0,1
17,2023-06-04T23:37:00+10:00,2023-06-04,23:37,2,0,2
20,2023-06-04T23:37:00+10:00,2023-06-04,23:37,1,1,2
52,2023-06-04T23:37:00+10:00,2023-06-04,23:37,0,2,2
72,2023-06-04T23:37:00+10:00,2023-06-04,23:37,0,1,1
79,2023-06-04T23:37:00+10:00,2023-06-04,23:37,2,1,3
21,2023-06-04T23:36:00+10:00,2023-06-04,23:36,4,0,4
45,2023-06-04T23:36:00+10:00,2023-06-04,23:36,0,3,3
55,2023-06-04T23:36:00+10:00,2023-06-04,23:36,4,1,5
65,2023-06-04T23:36:00+10:00,2023-06-04,23:36,0,4,4
2,2023-06-04T23:36:00+10:00,2023-06-04,23:36,1,0,1
23,2023-06-04T23:36:00+10:00,2023-06-04,23:36,0,6,6
24,2023-06-04T23:36:00+10:00,2023-06-04,23:36,1,0,1
56,2023-06-04T23:36:00+10:00,2023-06-04,23:36,0,2,2
58,2023-06-04T23:36:00+10:00,2023-06-04,23:36,3,3,6
5,2023-06-04T23:36:00+10:00,2023-06-04,23:36,1,3,4
6,2023-06-04T23:36:00+10:00,2023-06-04,23:36,0,1,1
14,2023-06-04T23:36:00+10:00,2023-06-04,23:36,3,0,3
26,2023-06-04T23:36:00+10:00,2023-06-04,23:36,1,1,2
31,2023-06-04T23:36:00+10:00,2023-06-04,23:36,0,2,2
41,2023-06-04T23:36:00+10:00,2023-06-04,23:36,2,0,2
47,2023-06-04T23:36:00+10:00,2023-06-04,23:36,13,4,17
54,2023-06-04T23:36:00+10:00,2023-06-04,23:36,0,3,3
61,2023-06-04T23:36:00+10:00,2023-06-04,23:36,2,0,2
66,2023-06-04T23:36:00+10:00,2023-06-04,23:36,0,8,8
71,2023-06-04T23:36:00+10:00,2023-06-04,23:36,1,0,1
19,2023-06-04T23:36:00+10:00,2023-06-04,23:36,0,7,7
27,2023-06-04T23:36:00+10:00,2023-06-04,23:36,1,0,1
35,2023-06-04T23:36:00+10:00,2023-06-04,23:36,0,7,7
48,2023-06-04T23:36:00+10:00,2023-06-04,23:36,0,1,1
57,2023-06-04T23:36:00+10:00,2023-06-04,23:36,0,1,1
79,2023-06-04T23:36:00+10:00,2023-06-04,23:36,3,5,8
3,2023-06-04T23:36:00+10:00,2023-06-04,23:36,2,7,9
4,2023-06-04T23:36:00+10:00,2023-06-04,23:36,3,0,3
28,2023-06-04T23:36:00+10:00,2023-06-04,23:36,4,0,4
37,2023-06-04T23:36:00+10:00,2023-06-04,23:36,0,1,1
42,2023-06-04T23:36:00+10:00,2023-06-04,23:36,1,1,2
70,2023-06-04T23:36:00+10:00,2023-06-04,23:36,1,0,1
108,2023-06-04T23:36:00+10:00,2023-06-04,23:36,1,0,1
1,2023-06-04T23:36:00+10:00,2023-06-04,23:36,3,1,4
20,2023-06-04T23:36:00+10:00,2023-06-04,23:36,3,0,3
30,2023-06-04T23:36:00+10:00,2023-06-04,23:36,1,3,4
4,2023-06-04T23:35:00+10:00,2023-06-04,23:35,3,3,6
5,2023-06-04T23:35:00+10:00,2023-06-04,23:35,0,1,1
14,2023-06-04T23:35:00+10:00,2023-06-04,23:35,1,0,1
29,2023-06-04T23:35:00+10:00,2023-06-04,23:35,2,0,2
31,2023-06-04T23:35:00+10:00,2023-06-04,23:35,0,1,1
36,2023-06-04T23:35:00+10:00,2023-06-04,23:35,0,1,1
37,2023-06-04T23:35:00+10:00,2023-06-04,23:35,2,1,3
41,2023-06-04T23:35:00+10:00,2023-06-04,23:35,5,2,7
54,2023-06-04T23:35:00+10:00,2023-06-04,23:35,0,3,3
59,2023-06-04T23:35:00+10:00,2023-06-04,23:35,9,10,19
61,2023-06-04T23:35:00+10:00,2023-06-04,23:35,1,2,3
77,2023-06-04T23:35:00+10:00,2023-06-04,23:35,1,2,3
1,2023-06-04T23:35:00+10:00,2023-06-04,23:35,3,2,5
11,2023-06-04T23:35:00+10:00,2023-06-04,23:35,0,2,2
46,2023-06-04T23:35:00+10:00,2023-06-04,23:35,0,1,1
56,2023-06-04T23:35:00+10:00,2023-06-04,23:35,0,1,1
62,2023-06-04T23:35:00+10:00,2023-06-04,23:35,1,1,2
26,2023-06-04T23:35:00+10:00,2023-06-04,23:35,1,2,3
45,2023-06-04T23:35:00+10:00,2023-06-04,23:35,0,2,2
47,2023-06-04T23:35:00+10:00,2023-06-04,23:35,0,3,3
55,2023-06-04T23:35:00+10:00,2023-06-04,23:35,6,0,6
66,2023-06-04T23:35:00+10:00,2023-06-04,23:35,1,0,1
2,2023-06-04T23:35:00+10:00,2023-06-04,23:35,2,0,2
23,2023-06-04T23:35:00+10:00,2023-06-04,23:35,1,4,5
30,2023-06-04T23:35:00+10:00,2023-06-04,23:35,0,2,2
35,2023-06-04T23:35:00+10:00,2023-06-04,23:35,1,3,4
109,2023-06-04T23:35:00+10:00,2023-06-04,23:35,0,4,4
3,2023-06-04T23:35:00+10:00,2023-06-04,23:35,5,1,6
6,2023-06-04T23:35:00+10:00,2023-06-04,23:35,5,1,6
21,2023-06-04T23:35:00+10:00,2023-06-04,23:35,4,0,4
65,2023-06-04T23:35:00+10:00,2023-06-04,23:35,0,4,4
84,2023-06-04T23:35:00+10:00,2023-06-04,23:35,12,17,29
19,2023-06-04T23:35:00+10:00,2023-06-04,23:35,0,1,1
20,2023-06-04T23:35:00+10:00,2023-06-04,23:35,1,0,1
24,2023-06-04T23:35:00+10:00,2023-06-04,23:35,5,16,21
27,2023-06-04T23:35:00+10:00,2023-06-04,23:35,2,0,2
49,2023-06-04T23:35:00+10:00,2023-06-04,23:35,2,2,4
52,2023-06-04T23:35:00+10:00,2023-06-04,23:35,0,1,1
57,2023-06-04T23:35:00+10:00,2023-06-04,23:35,0,1,1
58,2023-06-04T23:35:00+10:00,2023-06-04,23:35,3,0,3
67,2023-06-04T23:35:00+10:00,2023-06-04,23:35,0,1,1
79,2023-06-04T23:35:00+10:00,2023-06-04,23:35,1,2,3
117,2023-06-04T23:35:00+10:00,2023-06-04,23:35,0,3,3
4,2023-06-04T23:34:00+10:00,2023-06-04,23:34,2,0,2
14,2023-06-04T23:34:00+10:00,2023-06-04,23:34,5,0,5
26,2023-06-04T23:34:00+10:00,2023-06-04,23:34,1,0,1
29,2023-06-04T23:34:00+10:00,2023-06-04,23:34,0,2,2
61,2023-06-04T23:34:00+10:00,2023-06-04,23:34,0,1,1
12,2023-06-04T23:34:00+10:00,2023-06-04,23:34,0,1,1
17,2023-06-04T23:34:00+10:00,2023-06-04,23:34,0,2,2
48,2023-06-04T23:34:00+10:00,2023-06-04,23:34,0,1,1
53,2023-06-04T23:34:00+10:00,2023-06-04,23:34,1,0,1
57,2023-06-04T23:34:00+10:00,2023-06-04,23:34,0,2,2
67,2023-06-04T23:34:00+10:00,2023-06-04,23:34,1,0,1
79,2023-06-04T23:34:00+10:00,2023-06-04,23:34,2,0,2
85,2023-06-04T23:34:00+10:00,2023-06-04,23:34,0,1,1
6,2023-06-04T23:34:00+10:00,2023-06-04,23:34,2,8,10
31,2023-06-04T23:34:00+10:00,2023-06-04,23:34,3,2,5
36,2023-06-04T23:34:00+10:00,2023-06-04,23:34,0,1,1
47,2023-06-04T23:34:00+10:00,2023-06-04,23:34,0,1,1
55,2023-06-04T23:34:00+10:00,2023-06-04,23:34,9,4,13
2,2023-06-04T23:34:00+10:00,2023-06-04,23:34,0,1,1
35,2023-06-04T23:34:00+10:00,2023-06-04,23:34,3,6,9
49,2023-06-04T23:34:00+10:00,2023-06-04,23:34,1,1,2
58,2023-06-04T23:34:00+10:00,2023-06-04,23:34,0,2,2
62,2023-06-04T23:34:00+10:00,2023-06-04,23:34,1,0,1
3,2023-06-04T23:34:00+10:00,2023-06-04,23:34,2,1,3
5,2023-06-04T23:34:00+10:00,2023-06-04,23:34,2,1,3
21,2023-06-04T23:34:00+10:00,2023-06-04,23:34,4,1,5
41,2023-06-04T23:34:00+10:00,2023-06-04,23:34,9,4,13
42,2023-06-04T23:34:00+10:00,2023-06-04,23:34,0,3,3
45,2023-06-04T23:34:00+10:00,2023-06-04,23:34,1,3,4
54,2023-06-04T23:34:00+10:00,2023-06-04,23:34,0,1,1
65,2023-06-04T23:34:00+10:00,2023-06-04,23:34,3,1,4
9,2023-06-04T23:34:00+10:00,2023-06-04,23:34,1,0,1
19,2023-06-04T23:34:00+10:00,2023-06-04,23:34,0,1,1
23,2023-06-04T23:34:00+10:00,2023-06-04,23:34,1,0,1
24,2023-06-04T23:34:00+10:00,2023-06-04,23:34,4,2,6
46,2023-06-04T23:34:00+10:00,2023-06-04,23:34,2,1,3
52,2023-06-04T23:34:00+10:00,2023-06-04,23:34,0,2,2
76,2023-06-04T23:34:00+10:00,2023-06-04,23:34,0,1,1
4,2023-06-04T23:33:00+10:00,2023-06-04,23:33,4,0,4
21,2023-06-04T23:33:00+10:00,2023-06-04,23:33,3,0,3
26,2023-06-04T23:33:00+10:00,2023-06-04,23:33,2,3,5
47,2023-06-04T23:33:00+10:00,2023-06-04,23:33,3,2,5
55,2023-06-04T23:33:00+10:00,2023-06-04,23:33,1,6,7
65,2023-06-04T23:33:00+10:00,2023-06-04,23:33,0,1,1
108,2023-06-04T23:33:00+10:00,2023-06-04,23:33,1,1,2
24,2023-06-04T23:33:00+10:00,2023-06-04,23:33,2,0,2
35,2023-06-04T23:33:00+10:00,2023-06-04,23:33,2,9,11
46,2023-06-04T23:33:00+10:00,2023-06-04,23:33,0,1,1
85,2023-06-04T23:33:00+10:00,2023-06-04,23:33,1,0,1
6,2023-06-04T23:33:00+10:00,2023-06-04,23:33,1,5,6
28,2023-06-04T23:33:00+10:00,2023-06-04,23:33,2,1,3
37,2023-06-04T23:33:00+10:00,2023-06-04,23:33,1,0,1
41,2023-06-04T23:33:00+10:00,2023-06-04,23:33,6,8,14
30,2023-06-04T23:33:00+10:00,2023-06-04,23:33,5,1,6
48,2023-06-04T23:33:00+10:00,2023-06-04,23:33,1,0,1
56,2023-06-04T23:33:00+10:00,2023-06-04,23:33,2,0,2
57,2023-06-04T23:33:00+10:00,2023-06-04,23:33,4,3,7
58,2023-06-04T23:33:00+10:00,2023-06-04,23:33,3,1,4
3,2023-06-04T23:33:00+10:00,2023-06-04,23:33,6,1,7
5,2023-06-04T23:33:00+10:00,2023-06-04,23:33,3,3,6
31,2023-06-04T23:33:00+10:00,2023-06-04,23:33,0,1,1
45,2023-06-04T23:33:00+10:00,2023-06-04,23:33,0,2,2
66,2023-06-04T23:33:00+10:00,2023-06-04,23:33,0,1,1
17,2023-06-04T23:33:00+10:00,2023-06-04,23:33,0,1,1
52,2023-06-04T23:33:00+10:00,2023-06-04,23:33,0,1,1
62,2023-06-04T23:33:00+10:00,2023-06-04,23:33,3,5,8
72,2023-06-04T23:33:00+10:00,2023-06-04,23:33,1,0,1
79,2023-06-04T23:33:00+10:00,2023-06-04,23:33,3,3,6
6,2023-06-04T23:32:00+10:00,2023-06-04,23:32,2,1,3
21,2023-06-04T23:32:00+10:00,2023-06-04,23:32,1,3,4
47,2023-06-04T23:32:00+10:00,2023-06-04,23:32,3,0,3
50,2023-06-04T23:32:00+10:00,2023-06-04,23:32,0,1,1
55,2023-06-04T23:32:00+10:00,2023-06-04,23:32,2,2,4
61,2023-06-04T23:32:00+10:00,2023-06-04,23:32,4,0,4
65,2023-06-04T23:32:00+10:00,2023-06-04,23:32,0,2,2
51,2023-06-04T23:32:00+10:00,2023-06-04,23:32,0,1,1
58,2023-06-04T23:32:00+10:00,2023-06-04,23:32,3,0,3
62,2023-06-04T23:32:00+10:00,2023-06-04,23:32,4,0,4
68,2023-06-04T23:32:00+10:00,2023-06-04,23:32,1,0,1
5,2023-06-04T23:32:00+10:00,2023-06-04,23:32,4,2,6
36,2023-06-04T23:32:00+10:00,2023-06-04,23:32,1,0,1
41,2023-06-04T23:32:00+10:00,2023-06-04,23:32,6,9,15
45,2023-06-04T23:32:00+10:00,2023-06-04,23:32,3,3,6
108,2023-06-04T23:32:00+10:00,2023-06-04,23:32,2,0,2
27,2023-06-04T23:32:00+10:00,2023-06-04,23:32,2,0,2
35,2023-06-04T23:32:00+10:00,2023-06-04,23:32,2,2,4
48,2023-06-04T23:32:00+10:00,2023-06-04,23:32,0,3,3
67,2023-06-04T23:32:00+10:00,2023-06-04,23:32,3,0,3
79,2023-06-04T23:32:00+10:00,2023-06-04,23:32,1,2,3
3,2023-06-04T23:32:00+10:00,2023-06-04,23:32,4,1,5
4,2023-06-04T23:32:00+10:00,2023-06-04,23:32,4,0,4
14,2023-06-04T23:32:00+10:00,2023-06-04,23:32,0,1,1
26,2023-06-04T23:32:00+10:00,2023-06-04,23:32,1,1,2
31,2023-06-04T23:32:00+10:00,2023-06-04,23:32,1,1,2
54,2023-06-04T23:32:00+10:00,2023-06-04,23:32,2,0,2
66,2023-06-04T23:32:00+10:00,2023-06-04,23:32,2,0,2
1,2023-06-04T23:32:00+10:00,2023-06-04,23:32,0,1,1
2,2023-06-04T23:32:00+10:00,2023-06-04,23:32,0,1,1
19,2023-06-04T23:32:00+10:00,2023-06-04,23:32,1,0,1
23,2023-06-04T23:32:00+10:00,2023-06-04,23:32,1,4,5
24,2023-06-04T23:32:00+10:00,2023-06-04,23:32,1,3,4
52,2023-06-04T23:32:00+10:00,2023-06-04,23:32,4,0,4
72,2023-06-04T23:32:00+10:00,2023-06-04,23:32,0,2,2
54,2023-06-04T23:31:00+10:00,2023-06-04,23:31,0,4,4
55,2023-06-04T23:31:00+10:00,2023-06-04,23:31,5,1,6
1,2023-06-04T23:31:00+10:00,2023-06-04,23:31,1,1,2
2,2023-06-04T23:31:00+10:00,2023-06-04,23:31,0,2,2
12,2023-06-04T23:31:00+10:00,2023-06-04,23:31,1,0,1
23,2023-06-04T23:31:00+10:00,2023-06-04,23:31,1,1,2
46,2023-06-04T23:31:00+10:00,2023-06-04,23:31,1,0,1
48,2023-06-04T23:31:00+10:00,2023-06-04,23:31,0,1,1
57,2023-06-04T23:31:00+10:00,2023-06-04,23:31,0,1,1
62,2023-06-04T23:31:00+10:00,2023-06-04,23:31,3,0,3
3,2023-06-04T23:31:00+10:00,2023-06-04,23:31,0,5,5
5,2023-06-04T23:31:00+10:00,2023-06-04,23:31,1,3,4
21,2023-06-04T23:31:00+10:00,2023-06-04,23:31,9,0,9
26,2023-06-04T23:31:00+10:00,2023-06-04,23:31,1,0,1
28,2023-06-04T23:31:00+10:00,2023-06-04,23:31,1,0,1
31,2023-06-04T23:31:00+10:00,2023-06-04,23:31,1,1,2
40,2023-06-04T23:31:00+10:00,2023-06-04,23:31,1,0,1
44,2023-06-04T23:31:00+10:00,2023-06-04,23:31,1,0,1
45,2023-06-04T23:31:00+10:00,2023-06-04,23:31,0,1,1
47,2023-06-04T23:31:00+10:00,2023-06-04,23:31,1,2,3
30,2023-06-04T23:31:00+10:00,2023-06-04,23:31,2,2,4
35,2023-06-04T23:31:00+10:00,2023-06-04,23:31,6,10,16
58,2023-06-04T23:31:00+10:00,2023-06-04,23:31,0,2,2
79,2023-06-04T23:31:00+10:00,2023-06-04,23:31,3,1,4
4,2023-06-04T23:31:00+10:00,2023-06-04,23:31,6,2,8
6,2023-06-04T23:31:00+10:00,2023-06-04,23:31,2,0,2
36,2023-06-04T23:31:00+10:00,2023-06-04,23:31,2,0,2
37,2023-06-04T23:31:00+10:00,2023-06-04,23:31,0,1,1
41,2023-06-04T23:31:00+10:00,2023-06-04,23:31,10,8,18
42,2023-06-04T23:31:00+10:00,2023-06-04,23:31,0,1,1
61,2023-06-04T23:31:00+10:00,2023-06-04,23:31,2,0,2
65,2023-06-04T23:31:00+10:00,2023-06-04,23:31,1,3,4
77,2023-06-04T23:31:00+10:00,2023-06-04,23:31,1,0,1
9,2023-06-04T23:31:00+10:00,2023-06-04,23:31,0,2,2
17,2023-06-04T23:31:00+10:00,2023-06-04,23:31,2,0,2
19,2023-06-04T23:31:00+10:00,2023-06-04,23:31,2,0,2
24,2023-06-04T23:31:00+10:00,2023-06-04,23:31,2,11,13
27,2023-06-04T23:31:00+10:00,2023-06-04,23:31,1,0,1
14,2023-06-04T23:30:00+10:00,2023-06-04,23:30,2,0,2
21,2023-06-04T23:30:00+10:00,2023-06-04,23:30,7,0,7
41,2023-06-04T23:30:00+10:00,2023-06-04,23:30,4,8,12
42,2023-06-04T23:30:00+10:00,2023-06-04,23:30,0,1,1
54,2023-06-04T23:30:00+10:00,2023-06-04,23:30,1,0,1
61,2023-06-04T23:30:00+10:00,2023-06-04,23:30,1,0,1
69,2023-06-04T23:30:00+10:00,2023-06-04,23:30,1,0,1
19,2023-06-04T23:30:00+10:00,2023-06-04,23:30,1,1,2
57,2023-06-04T23:30:00+10:00,2023-06-04,23:30,0,1,1
79,2023-06-04T23:30:00+10:00,2023-06-04,23:30,1,16,17
109,2023-06-04T23:30:00+10:00,2023-06-04,23:30,2,6,8
3,2023-06-04T23:30:00+10:00,2023-06-04,23:30,1,0,1
59,2023-06-04T23:30:00+10:00,2023-06-04,23:30,10,2,12
84,2023-06-04T23:30:00+10:00,2023-06-04,23:30,22,25,47
2,2023-06-04T23:30:00+10:00,2023-06-04,23:30,0,3,3
12,2023-06-04T23:30:00+10:00,2023-06-04,23:30,2,0,2
30,2023-06-04T23:30:00+10:00,2023-06-04,23:30,2,0,2
35,2023-06-04T23:30:00+10:00,2023-06-04,23:30,2,4,6
52,2023-06-04T23:30:00+10:00,2023-06-04,23:30,0,1,1
62,2023-06-04T23:30:00+10:00,2023-06-04,23:30,5,0,5
67,2023-06-04T23:30:00+10:00,2023-06-04,23:30,0,1,1
72,2023-06-04T23:30:00+10:00,2023-06-04,23:30,2,1,3
117,2023-06-04T23:30:00+10:00,2023-06-04,23:30,8,0,8
4,2023-06-04T23:30:00+10:00,2023-06-04,23:30,0,7,7
5,2023-06-04T23:30:00+10:00,2023-06-04,23:30,0,1,1
6,2023-06-04T23:30:00+10:00,2023-06-04,23:30,3,0,3
31,2023-06-04T23:30:00+10:00,2023-06-04,23:30,0,2,2
37,2023-06-04T23:30:00+10:00,2023-06-04,23:30,3,4,7
39,2023-06-04T23:30:00+10:00,2023-06-04,23:30,0,1,1
45,2023-06-04T23:30:00+10:00,2023-06-04,23:30,1,2,3
47,2023-06-04T23:30:00+10:00,2023-06-04,23:30,1,5,6
55,2023-06-04T23:30:00+10:00,2023-06-04,23:30,9,3,12
66,2023-06-04T23:30:00+10:00,2023-06-04,23:30,0,7,7
71,2023-06-04T23:30:00+10:00,2023-06-04,23:30,0,1,1
107,2023-06-04T23:30:00+10:00,2023-06-04,23:30,0,2,2
118,2023-06-04T23:30:00+10:00,2023-06-04,23:30,3,0,3
9,2023-06-04T23:30:00+10:00,2023-06-04,23:30,0,2,2
11,2023-06-04T23:30:00+10:00,2023-06-04,23:30,1,0,1
24,2023-06-04T23:30:00+10:00,2023-06-04,23:30,0,2,2
46,2023-06-04T23:30:00+10:00,2023-06-04,23:30,1,0,1
58,2023-06-04T23:30:00+10:00,2023-06-04,23:30,2,0,2
3,2023-06-04T23:29:00+10:00,2023-06-04,23:29,4,1,5
4,2023-06-04T23:29:00+10:00,2023-06-04,23:29,7,3,10
21,2023-06-04T23:29:00+10:00,2023-06-04,23:29,5,1,6
28,2023-06-04T23:29:00+10:00,2023-06-04,23:29,1,0,1
45,2023-06-04T23:29:00+10:00,2023-06-04,23:29,0,1,1
47,2023-06-04T23:29:00+10:00,2023-06-04,23:29,0,1,1
2,2023-06-04T23:29:00+10:00,2023-06-04,23:29,0,1,1
20,2023-06-04T23:29:00+10:00,2023-06-04,23:29,0,2,2
52,2023-06-04T23:29:00+10:00,2023-06-04,23:29,0,4,4
56,2023-06-04T23:29:00+10:00,2023-06-04,23:29,1,0,1
6,2023-06-04T23:29:00+10:00,2023-06-04,23:29,1,1,2
26,2023-06-04T23:29:00+10:00,2023-06-04,23:29,0,1,1
37,2023-06-04T23:29:00+10:00,2023-06-04,23:29,1,0,1
40,2023-06-04T23:29:00+10:00,2023-06-04,23:29,3,0,3
41,2023-06-04T23:29:00+10:00,2023-06-04,23:29,6,4,10
55,2023-06-04T23:29:00+10:00,2023-06-04,23:29,0,7,7
12,2023-06-04T23:29:00+10:00,2023-06-04,23:29,3,0,3
23,2023-06-04T23:29:00+10:00,2023-06-04,23:29,0,2,2
35,2023-06-04T23:29:00+10:00,2023-06-04,23:29,4,1,5
58,2023-06-04T23:29:00+10:00,2023-06-04,23:29,0,6,6
68,2023-06-04T23:29:00+10:00,2023-06-04,23:29,1,0,1
79,2023-06-04T23:29:00+10:00,2023-06-04,23:29,0,9,9
5,2023-06-04T23:29:00+10:00,2023-06-04,23:29,2,1,3
29,2023-06-04T23:29:00+10:00,2023-06-04,23:29,2,1,3
31,2023-06-04T23:29:00+10:00,2023-06-04,23:29,0,2,2
50,2023-06-04T23:29:00+10:00,2023-06-04,23:29,0,1,1
61,2023-06-04T23:29:00+10:00,2023-06-04,23:29,1,0,1
66,2023-06-04T23:29:00+10:00,2023-06-04,23:29,2,2,4
108,2023-06-04T23:29:00+10:00,2023-06-04,23:29,0,1,1
1,2023-06-04T23:29:00+10:00,2023-06-04,23:29,0,3,3
17,2023-06-04T23:29:00+10:00,2023-06-04,23:29,1,0,1
19,2023-06-04T23:29:00+10:00,2023-06-04,23:29,2,4,6
27,2023-06-04T23:29:00+10:00,2023-06-04,23:29,1,0,1
30,2023-06-04T23:29:00+10:00,2023-06-04,23:29,1,2,3
46,2023-06-04T23:29:00+10:00,2023-06-04,23:29,1,0,1
48,2023-06-04T23:29:00+10:00,2023-06-04,23:29,1,0,1
53,2023-06-04T23:29:00+10:00,2023-06-04,23:29,0,4,4
62,2023-06-04T23:29:00+10:00,2023-06-04,23:29,1,0,1
67,2023-06-04T23:29:00+10:00,2023-06-04,23:29,1,0,1
85,2023-06-04T23:29:00+10:00,2023-06-04,23:29,0,1,1
4,2023-06-04T23:28:00+10:00,2023-06-04,23:28,3,3,6
5,2023-06-04T23:28:00+10:00,2023-06-04,23:28,8,3,11
6,2023-06-04T23:28:00+10:00,2023-06-04,23:28,5,0,5
21,2023-06-04T23:28:00+10:00,2023-06-04,23:28,2,1,3
55,2023-06-04T23:28:00+10:00,2023-06-04,23:28,14,2,16
66,2023-06-04T23:28:00+10:00,2023-06-04,23:28,1,0,1
1,2023-06-04T23:28:00+10:00,2023-06-04,23:28,1,2,3
20,2023-06-04T23:28:00+10:00,2023-06-04,23:28,0,3,3
24,2023-06-04T23:28:00+10:00,2023-06-04,23:28,2,9,11
30,2023-06-04T23:28:00+10:00,2023-06-04,23:28,2,2,4
35,2023-06-04T23:28:00+10:00,2023-06-04,23:28,1,5,6
58,2023-06-04T23:28:00+10:00,2023-06-04,23:28,3,0,3
79,2023-06-04T23:28:00+10:00,2023-06-04,23:28,1,7,8
85,2023-06-04T23:28:00+10:00,2023-06-04,23:28,0,2,2
3,2023-06-04T23:28:00+10:00,2023-06-04,23:28,13,0,13
14,2023-06-04T23:28:00+10:00,2023-06-04,23:28,0,2,2
29,2023-06-04T23:28:00+10:00,2023-06-04,23:28,0,4,4
37,2023-06-04T23:28:00+10:00,2023-06-04,23:28,0,1,1
39,2023-06-04T23:28:00+10:00,2023-06-04,23:28,2,0,2
2,2023-06-04T23:28:00+10:00,2023-06-04,23:28,0,3,3
17,2023-06-04T23:28:00+10:00,2023-06-04,23:28,0,2,2
48,2023-06-04T23:28:00+10:00,2023-06-04,23:28,1,2,3
28,2023-06-04T23:28:00+10:00,2023-06-04,23:28,1,0,1
41,2023-06-04T23:28:00+10:00,2023-06-04,23:28,4,8,12
42,2023-06-04T23:28:00+10:00,2023-06-04,23:28,0,1,1
45,2023-06-04T23:28:00+10:00,2023-06-04,23:28,5,4,9
47,2023-06-04T23:28:00+10:00,2023-06-04,23:28,2,10,12
61,2023-06-04T23:28:00+10:00,2023-06-04,23:28,1,0,1
65,2023-06-04T23:28:00+10:00,2023-06-04,23:28,3,0,3
19,2023-06-04T23:28:00+10:00,2023-06-04,23:28,1,0,1
51,2023-06-04T23:28:00+10:00,2023-06-04,23:28,0,1,1
56,2023-06-04T23:28:00+10:00,2023-06-04,23:28,0,2,2
4,2023-06-04T23:27:00+10:00,2023-06-04,23:27,6,2,8
6,2023-06-04T23:27:00+10:00,2023-06-04,23:27,4,7,11
41,2023-06-04T23:27:00+10:00,2023-06-04,23:27,2,7,9
47,2023-06-04T23:27:00+10:00,2023-06-04,23:27,0,10,10
55,2023-06-04T23:27:00+10:00,2023-06-04,23:27,5,3,8
65,2023-06-04T23:27:00+10:00,2023-06-04,23:27,0,3,3
66,2023-06-04T23:27:00+10:00,2023-06-04,23:27,2,1,3
75,2023-06-04T23:27:00+10:00,2023-06-04,23:27,0,1,1
18,2023-06-04T23:27:00+10:00,2023-06-04,23:27,1,0,1
27,2023-06-04T23:27:00+10:00,2023-06-04,23:27,1,0,1
51,2023-06-04T23:27:00+10:00,2023-06-04,23:27,1,1,2
56,2023-06-04T23:27:00+10:00,2023-06-04,23:27,1,0,1
72,2023-06-04T23:27:00+10:00,2023-06-04,23:27,5,6,11
79,2023-06-04T23:27:00+10:00,2023-06-04,23:27,2,6,8
5,2023-06-04T23:27:00+10:00,2023-06-04,23:27,2,2,4
14,2023-06-04T23:27:00+10:00,2023-06-04,23:27,0,1,1
29,2023-06-04T23:27:00+10:00,2023-06-04,23:27,0,1,1
42,2023-06-04T23:27:00+10:00,2023-06-04,23:27,2,0,2
45,2023-06-04T23:27:00+10:00,2023-06-04,23:27,0,5,5
108,2023-06-04T23:27:00+10:00,2023-06-04,23:27,0,1,1
10,2023-06-04T23:27:00+10:00,2023-06-04,23:27,4,0,4
12,2023-06-04T23:27:00+10:00,2023-06-04,23:27,0,1,1
24,2023-06-04T23:27:00+10:00,2023-06-04,23:27,4,2,6
30,2023-06-04T23:27:00+10:00,2023-06-04,23:27,0,7,7
35,2023-06-04T23:27:00+10:00,2023-06-04,23:27,4,14,18
85,2023-06-04T23:27:00+10:00,2023-06-04,23:27,1,0,1
3,2023-06-04T23:27:00+10:00,2023-06-04,23:27,8,3,11
21,2023-06-04T23:27:00+10:00,2023-06-04,23:27,0,2,2
36,2023-06-04T23:27:00+10:00,2023-06-04,23:27,1,0,1
37,2023-06-04T23:27:00+10:00,2023-06-04,23:27,2,0,2
2,2023-06-04T23:27:00+10:00,2023-06-04,23:27,0,1,1
11,2023-06-04T23:27:00+10:00,2023-06-04,23:27,0,1,1
19,2023-06-04T23:27:00+10:00,2023-06-04,23:27,1,0,1
23,2023-06-04T23:27:00+10:00,2023-06-04,23:27,0,1,1
52,2023-06-04T23:27:00+10:00,2023-06-04,23:27,0,5,5
58,2023-06-04T23:27:00+10:00,2023-06-04,23:27,1,2,3
62,2023-06-04T23:27:00+10:00,2023-06-04,23:27,2,2,4
3,2023-06-04T23:26:00+10:00,2023-06-04,23:26,4,3,7
4,2023-06-04T23:26:00+10:00,2023-06-04,23:26,4,5,9
37,2023-06-04T23:26:00+10:00,2023-06-04,23:26,0,2,2
54,2023-06-04T23:26:00+10:00,2023-06-04,23:26,0,2,2
55,2023-06-04T23:26:00+10:00,2023-06-04,23:26,3,3,6
65,2023-06-04T23:26:00+10:00,2023-06-04,23:26,4,1,5
2,2023-06-04T23:26:00+10:00,2023-06-04,23:26,0,1,1
12,2023-06-04T23:26:00+10:00,2023-06-04,23:26,4,0,4
56,2023-06-04T23:26:00+10:00,2023-06-04,23:26,0,1,1
6,2023-06-04T23:26:00+10:00,2023-06-04,23:26,2,2,4
21,2023-06-04T23:26:00+10:00,2023-06-04,23:26,0,2,2
29,2023-06-04T23:26:00+10:00,2023-06-04,23:26,1,0,1
31,2023-06-04T23:26:00+10:00,2023-06-04,23:26,2,1,3
36,2023-06-04T23:26:00+10:00,2023-06-04,23:26,0,3,3
47,2023-06-04T23:26:00+10:00,2023-06-04,23:26,6,3,9
66,2023-06-04T23:26:00+10:00,2023-06-04,23:26,6,0,6
17,2023-06-04T23:26:00+10:00,2023-06-04,23:26,0,1,1
48,2023-06-04T23:26:00+10:00,2023-06-04,23:26,0,1,1
62,2023-06-04T23:26:00+10:00,2023-06-04,23:26,3,0,3
72,2023-06-04T23:26:00+10:00,2023-06-04,23:26,3,3,6
5,2023-06-04T23:26:00+10:00,2023-06-04,23:26,4,10,14
26,2023-06-04T23:26:00+10:00,2023-06-04,23:26,2,2,4
41,2023-06-04T23:26:00+10:00,2023-06-04,23:26,10,2,12
45,2023-06-04T23:26:00+10:00,2023-06-04,23:26,2,1,3
61,2023-06-04T23:26:00+10:00,2023-06-04,23:26,1,2,3
77,2023-06-04T23:26:00+10:00,2023-06-04,23:26,0,2,2
1,2023-06-04T23:26:00+10:00,2023-06-04,23:26,1,1,2
20,2023-06-04T23:26:00+10:00,2023-06-04,23:26,0,5,5
30,2023-06-04T23:26:00+10:00,2023-06-04,23:26,1,4,5
35,2023-06-04T23:26:00+10:00,2023-06-04,23:26,3,4,7
49,2023-06-04T23:26:00+10:00,2023-06-04,23:26,1,2,3
67,2023-06-04T23:26:00+10:00,2023-06-04,23:26,2,1,3
79,2023-06-04T23:26:00+10:00,2023-06-04,23:26,0,6,6
5,2023-06-04T23:25:00+10:00,2023-06-04,23:25,1,4,5
47,2023-06-04T23:25:00+10:00,2023-06-04,23:25,4,2,6
50,2023-06-04T23:25:00+10:00,2023-06-04,23:25,2,1,3
59,2023-06-04T23:25:00+10:00,2023-06-04,23:25,22,4,26
61,2023-06-04T23:25:00+10:00,2023-06-04,23:25,0,1,1
19,2023-06-04T23:25:00+10:00,2023-06-04,23:25,2,5,7
20,2023-06-04T23:25:00+10:00,2023-06-04,23:25,1,0,1
24,2023-06-04T23:25:00+10:00,2023-06-04,23:25,5,4,9
49,2023-06-04T23:25:00+10:00,2023-06-04,23:25,2,1,3
52,2023-06-04T23:25:00+10:00,2023-06-04,23:25,0,2,2
6,2023-06-04T23:25:00+10:00,2023-06-04,23:25,2,7,9
26,2023-06-04T23:25:00+10:00,2023-06-04,23:25,0,5,5
29,2023-06-04T23:25:00+10:00,2023-06-04,23:25,1,0,1
41,2023-06-04T23:25:00+10:00,2023-06-04,23:25,14,0,14
55,2023-06-04T23:25:00+10:00,2023-06-04,23:25,3,5,8
65,2023-06-04T23:25:00+10:00,2023-06-04,23:25,2,0,2
1,2023-06-04T23:25:00+10:00,2023-06-04,23:25,1,0,1
2,2023-06-04T23:25:00+10:00,2023-06-04,23:25,0,2,2
11,2023-06-04T23:25:00+10:00,2023-06-04,23:25,0,1,1
12,2023-06-04T23:25:00+10:00,2023-06-04,23:25,1,1,2
27,2023-06-04T23:25:00+10:00,2023-06-04,23:25,0,1,1
35,2023-06-04T23:25:00+10:00,2023-06-04,23:25,2,4,6
53,2023-06-04T23:25:00+10:00,2023-06-04,23:25,4,0,4
67,2023-06-04T23:25:00+10:00,2023-06-04,23:25,0,2,2
117,2023-06-04T23:25:00+10:00,2023-06-04,23:25,6,7,13
3,2023-06-04T23:25:00+10:00,2023-06-04,23:25,1,1,2
4,2023-06-04T23:25:00+10:00,2023-06-04,23:25,8,1,9
45,2023-06-04T23:25:00+10:00,2023-06-04,23:25,1,1,2
66,2023-06-04T23:25:00+10:00,2023-06-04,23:25,3,4,7
84,2023-06-04T23:25:00+10:00,2023-06-04,23:25,26,31,57
107,2023-06-04T23:25:00+10:00,2023-06-04,23:25,2,0,2
118,2023-06-04T23:25:00+10:00,2023-06-04,23:25,2,0,2
30,2023-06-04T23:25:00+10:00,2023-06-04,23:25,2,2,4
62,2023-06-04T23:25:00+10:00,2023-06-04,23:25,2,0,2
79,2023-06-04T23:25:00+10:00,2023-06-04,23:25,4,5,9
109,2023-06-04T23:25:00+10:00,2023-06-04,23:25,4,1,5
4,2023-06-04T23:24:00+10:00,2023-06-04,23:24,4,3,7
5,2023-06-04T23:24:00+10:00,2023-06-04,23:24,1,4,5
6,2023-06-04T23:24:00+10:00,2023-06-04,23:24,6,3,9
41,2023-06-04T23:24:00+10:00,2023-06-04,23:24,16,4,20
42,2023-06-04T23:24:00+10:00,2023-06-04,23:24,0,2,2
45,2023-06-04T23:24:00+10:00,2023-06-04,23:24,0,1,1
50,2023-06-04T23:24:00+10:00,2023-06-04,23:24,1,0,1
55,2023-06-04T23:24:00+10:00,2023-06-04,23:24,3,5,8
65,2023-06-04T23:24:00+10:00,2023-06-04,23:24,0,1,1
1,2023-06-04T23:24:00+10:00,2023-06-04,23:24,1,1,2
17,2023-06-04T23:24:00+10:00,2023-06-04,23:24,0,3,3
19,2023-06-04T23:24:00+10:00,2023-06-04,23:24,3,1,4
27,2023-06-04T23:24:00+10:00,2023-06-04,23:24,0,1,1
30,2023-06-04T23:24:00+10:00,2023-06-04,23:24,2,0,2
49,2023-06-04T23:24:00+10:00,2023-06-04,23:24,4,0,4
57,2023-06-04T23:24:00+10:00,2023-06-04,23:24,1,1,2
79,2023-06-04T23:24:00+10:00,2023-06-04,23:24,1,0,1
3,2023-06-04T23:24:00+10:00,2023-06-04,23:24,10,2,12
29,2023-06-04T23:24:00+10:00,2023-06-04,23:24,2,5,7
37,2023-06-04T23:24:00+10:00,2023-06-04,23:24,1,1,2
40,2023-06-04T23:24:00+10:00,2023-06-04,23:24,1,0,1
2,2023-06-04T23:24:00+10:00,2023-06-04,23:24,1,0,1
23,2023-06-04T23:24:00+10:00,2023-06-04,23:24,1,0,1
24,2023-06-04T23:24:00+10:00,2023-06-04,23:24,1,3,4
35,2023-06-04T23:24:00+10:00,2023-06-04,23:24,2,9,11
52,2023-06-04T23:24:00+10:00,2023-06-04,23:24,2,0,2
53,2023-06-04T23:24:00+10:00,2023-06-04,23:24,2,2,4
62,2023-06-04T23:24:00+10:00,2023-06-04,23:24,0,1,1
67,2023-06-04T23:24:00+10:00,2023-06-04,23:24,0,1,1
72,2023-06-04T23:24:00+10:00,2023-06-04,23:24,2,3,5
21,2023-06-04T23:24:00+10:00,2023-06-04,23:24,6,2,8
36,2023-06-04T23:24:00+10:00,2023-06-04,23:24,4,0,4
66,2023-06-04T23:24:00+10:00,2023-06-04,23:24,0,6,6
18,2023-06-04T23:24:00+10:00,2023-06-04,23:24,0,2,2
48,2023-06-04T23:24:00+10:00,2023-06-04,23:24,0,2,2
6,2023-06-04T23:23:00+10:00,2023-06-04,23:23,2,2,4
26,2023-06-04T23:23:00+10:00,2023-06-04,23:23,2,3,5
29,2023-06-04T23:23:00+10:00,2023-06-04,23:23,3,0,3
31,2023-06-04T23:23:00+10:00,2023-06-04,23:23,0,1,1
41,2023-06-04T23:23:00+10:00,2023-06-04,23:23,5,1,6
45,2023-06-04T23:23:00+10:00,2023-06-04,23:23,1,2,3
55,2023-06-04T23:23:00+10:00,2023-06-04,23:23,9,4,13
61,2023-06-04T23:23:00+10:00,2023-06-04,23:23,3,1,4
66,2023-06-04T23:23:00+10:00,2023-06-04,23:23,2,3,5
3,2023-06-04T23:23:00+10:00,2023-06-04,23:23,0,5,5
4,2023-06-04T23:23:00+10:00,2023-06-04,23:23,8,3,11
5,2023-06-04T23:23:00+10:00,2023-06-04,23:23,9,6,15
14,2023-06-04T23:23:00+10:00,2023-06-04,23:23,2,3,5
21,2023-06-04T23:23:00+10:00,2023-06-04,23:23,2,0,2
28,2023-06-04T23:23:00+10:00,2023-06-04,23:23,0,3,3
47,2023-06-04T23:23:00+10:00,2023-06-04,23:23,3,0,3
12,2023-06-04T23:23:00+10:00,2023-06-04,23:23,2,1,3
19,2023-06-04T23:23:00+10:00,2023-06-04,23:23,2,2,4
35,2023-06-04T23:23:00+10:00,2023-06-04,23:23,2,5,7
53,2023-06-04T23:23:00+10:00,2023-06-04,23:23,0,2,2
56,2023-06-04T23:23:00+10:00,2023-06-04,23:23,0,1,1
62,2023-06-04T23:23:00+10:00,2023-06-04,23:23,1,0,1
67,2023-06-04T23:23:00+10:00,2023-06-04,23:23,2,0,2
79,2023-06-04T23:23:00+10:00,2023-06-04,23:23,3,13,16
70,2023-06-04T23:23:00+10:00,2023-06-04,23:23,1,0,1
1,2023-06-04T23:23:00+10:00,2023-06-04,23:23,1,0,1
2,2023-06-04T23:23:00+10:00,2023-06-04,23:23,0,2,2
20,2023-06-04T23:23:00+10:00,2023-06-04,23:23,0,1,1
23,2023-06-04T23:23:00+10:00,2023-06-04,23:23,0,3,3
24,2023-06-04T23:23:00+10:00,2023-06-04,23:23,3,1,4
30,2023-06-04T23:23:00+10:00,2023-06-04,23:23,2,1,3
49,2023-06-04T23:23:00+10:00,2023-06-04,23:23,0,1,1
51,2023-06-04T23:23:00+10:00,2023-06-04,23:23,1,0,1
72,2023-06-04T23:23:00+10:00,2023-06-04,23:23,0,3,3
4,2023-06-04T23:22:00+10:00,2023-06-04,23:22,8,0,8
21,2023-06-04T23:22:00+10:00,2023-06-04,23:22,7,0,7
31,2023-06-04T23:22:00+10:00,2023-06-04,23:22,1,2,3
45,2023-06-04T23:22:00+10:00,2023-06-04,23:22,2,3,5
54,2023-06-04T23:22:00+10:00,2023-06-04,23:22,0,1,1
66,2023-06-04T23:22:00+10:00,2023-06-04,23:22,4,0,4
108,2023-06-04T23:22:00+10:00,2023-06-04,23:22,0,2,2
27,2023-06-04T23:22:00+10:00,2023-06-04,23:22,2,0,2
52,2023-06-04T23:22:00+10:00,2023-06-04,23:22,1,5,6
62,2023-06-04T23:22:00+10:00,2023-06-04,23:22,2,0,2
79,2023-06-04T23:22:00+10:00,2023-06-04,23:22,1,9,10
5,2023-06-04T23:22:00+10:00,2023-06-04,23:22,4,6,10
6,2023-06-04T23:22:00+10:00,2023-06-04,23:22,4,9,13
37,2023-06-04T23:22:00+10:00,2023-06-04,23:22,1,0,1
55,2023-06-04T23:22:00+10:00,2023-06-04,23:22,9,6,15
75,2023-06-04T23:22:00+10:00,2023-06-04,23:22,1,0,1
9,2023-06-04T23:22:00+10:00,2023-06-04,23:22,0,2,2
19,2023-06-04T23:22:00+10:00,2023-06-04,23:22,2,2,4
30,2023-06-04T23:22:00+10:00,2023-06-04,23:22,2,1,3
49,2023-06-04T23:22:00+10:00,2023-06-04,23:22,1,0,1
51,2023-06-04T23:22:00+10:00,2023-06-04,23:22,2,1,3
58,2023-06-04T23:22:00+10:00,2023-06-04,23:22,4,2,6
67,2023-06-04T23:22:00+10:00,2023-06-04,23:22,0,2,2
3,2023-06-04T23:22:00+10:00,2023-06-04,23:22,4,3,7
14,2023-06-04T23:22:00+10:00,2023-06-04,23:22,0,1,1
26,2023-06-04T23:22:00+10:00,2023-06-04,23:22,2,0,2
28,2023-06-04T23:22:00+10:00,2023-06-04,23:22,0,1,1
41,2023-06-04T23:22:00+10:00,2023-06-04,23:22,9,5,14
42,2023-06-04T23:22:00+10:00,2023-06-04,23:22,1,0,1
47,2023-06-04T23:22:00+10:00,2023-06-04,23:22,1,0,1
12,2023-06-04T23:22:00+10:00,2023-06-04,23:22,3,0,3
20,2023-06-04T23:22:00+10:00,2023-06-04,23:22,0,1,1
23,2023-06-04T23:22:00+10:00,2023-06-04,23:22,0,1,1
24,2023-06-04T23:22:00+10:00,2023-06-04,23:22,2,2,4
35,2023-06-04T23:22:00+10:00,2023-06-04,23:22,2,3,5
48,2023-06-04T23:22:00+10:00,2023-06-04,23:22,2,1,3
28,2023-06-04T23:21:00+10:00,2023-06-04,23:21,1,0,1
37,2023-06-04T23:21:00+10:00,2023-06-04,23:21,0,2,2
24,2023-06-04T23:21:00+10:00,2023-06-04,23:21,3,2,5
35,2023-06-04T23:21:00+10:00,2023-06-04,23:21,0,4,4
46,2023-06-04T23:21:00+10:00,2023-06-04,23:21,2,0,2
51,2023-06-04T23:21:00+10:00,2023-06-04,23:21,2,2,4
72,2023-06-04T23:21:00+10:00,2023-06-04,23:21,5,0,5
3,2023-06-04T23:21:00+10:00,2023-06-04,23:21,6,15,21
5,2023-06-04T23:21:00+10:00,2023-06-04,23:21,2,3,5
14,2023-06-04T23:21:00+10:00,2023-06-04,23:21,4,3,7
21,2023-06-04T23:21:00+10:00,2023-06-04,23:21,3,0,3
31,2023-06-04T23:21:00+10:00,2023-06-04,23:21,0,1,1
41,2023-06-04T23:21:00+10:00,2023-06-04,23:21,5,3,8
45,2023-06-04T23:21:00+10:00,2023-06-04,23:21,0,1,1
47,2023-06-04T23:21:00+10:00,2023-06-04,23:21,3,2,5
108,2023-06-04T23:21:00+10:00,2023-06-04,23:21,2,0,2
18,2023-06-04T23:21:00+10:00,2023-06-04,23:21,0,1,1
20,2023-06-04T23:21:00+10:00,2023-06-04,23:21,2,0,2
23,2023-06-04T23:21:00+10:00,2023-06-04,23:21,2,0,2
30,2023-06-04T23:21:00+10:00,2023-06-04,23:21,4,1,5
48,2023-06-04T23:21:00+10:00,2023-06-04,23:21,0,1,1
53,2023-06-04T23:21:00+10:00,2023-06-04,23:21,0,6,6
58,2023-06-04T23:21:00+10:00,2023-06-04,23:21,9,3,12
79,2023-06-04T23:21:00+10:00,2023-06-04,23:21,0,7,7
4,2023-06-04T23:21:00+10:00,2023-06-04,23:21,8,1,9
6,2023-06-04T23:21:00+10:00,2023-06-04,23:21,1,3,4
26,2023-06-04T23:21:00+10:00,2023-06-04,23:21,3,3,6
29,2023-06-04T23:21:00+10:00,2023-06-04,23:21,6,0,6
54,2023-06-04T23:21:00+10:00,2023-06-04,23:21,9,0,9
55,2023-06-04T23:21:00+10:00,2023-06-04,23:21,9,4,13
65,2023-06-04T23:21:00+10:00,2023-06-04,23:21,0,2,2
66,2023-06-04T23:21:00+10:00,2023-06-04,23:21,2,1,3
11,2023-06-04T23:21:00+10:00,2023-06-04,23:21,4,0,4
12,2023-06-04T23:21:00+10:00,2023-06-04,23:21,3,0,3
19,2023-06-04T23:21:00+10:00,2023-06-04,23:21,0,6,6
57,2023-06-04T23:21:00+10:00,2023-06-04,23:21,0,1,1
5,2023-06-04T23:20:00+10:00,2023-06-04,23:20,5,4,9
14,2023-06-04T23:20:00+10:00,2023-06-04,23:20,4,0,4
21,2023-06-04T23:20:00+10:00,2023-06-04,23:20,1,0,1
40,2023-06-04T23:20:00+10:00,2023-06-04,23:20,1,0,1
45,2023-06-04T23:20:00+10:00,2023-06-04,23:20,0,1,1
54,2023-06-04T23:20:00+10:00,2023-06-04,23:20,1,0,1
59,2023-06-04T23:20:00+10:00,2023-06-04,23:20,7,9,16
65,2023-06-04T23:20:00+10:00,2023-06-04,23:20,0,3,3
118,2023-06-04T23:20:00+10:00,2023-06-04,23:20,6,0,6
48,2023-06-04T23:20:00+10:00,2023-06-04,23:20,0,1,1
109,2023-06-04T23:20:00+10:00,2023-06-04,23:20,1,3,4
6,2023-06-04T23:20:00+10:00,2023-06-04,23:20,2,1,3
29,2023-06-04T23:20:00+10:00,2023-06-04,23:20,3,0,3
36,2023-06-04T23:20:00+10:00,2023-06-04,23:20,0,1,1
37,2023-06-04T23:20:00+10:00,2023-06-04,23:20,1,0,1
55,2023-06-04T23:20:00+10:00,2023-06-04,23:20,4,2,6
61,2023-06-04T23:20:00+10:00,2023-06-04,23:20,4,0,4
107,2023-06-04T23:20:00+10:00,2023-06-04,23:20,3,1,4
11,2023-06-04T23:20:00+10:00,2023-06-04,23:20,2,0,2
24,2023-06-04T23:20:00+10:00,2023-06-04,23:20,4,5,9
27,2023-06-04T23:20:00+10:00,2023-06-04,23:20,1,0,1
30,2023-06-04T23:20:00+10:00,2023-06-04,23:20,8,9,17
35,2023-06-04T23:20:00+10:00,2023-06-04,23:20,0,5,5
49,2023-06-04T23:20:00+10:00,2023-06-04,23:20,0,4,4
58,2023-06-04T23:20:00+10:00,2023-06-04,23:20,2,0,2
62,2023-06-04T23:20:00+10:00,2023-06-04,23:20,5,0,5
67,2023-06-04T23:20:00+10:00,2023-06-04,23:20,1,0,1
3,2023-06-04T23:20:00+10:00,2023-06-04,23:20,1,7,8
4,2023-06-04T23:20:00+10:00,2023-06-04,23:20,9,0,9
26,2023-06-04T23:20:00+10:00,2023-06-04,23:20,2,0,2
41,2023-06-04T23:20:00+10:00,2023-06-04,23:20,9,3,12
47,2023-06-04T23:20:00+10:00,2023-06-04,23:20,7,0,7
66,2023-06-04T23:20:00+10:00,2023-06-04,23:20,1,1,2
84,2023-06-04T23:20:00+10:00,2023-06-04,23:20,39,35,74
108,2023-06-04T23:20:00+10:00,2023-06-04,23:20,0,4,4
2,2023-06-04T23:20:00+10:00,2023-06-04,23:20,0,1,1
12,2023-06-04T23:20:00+10:00,2023-06-04,23:20,0,1,1
20,2023-06-04T23:20:00+10:00,2023-06-04,23:20,1,1,2
51,2023-06-04T23:20:00+10:00,2023-06-04,23:20,1,0,1
72,2023-06-04T23:20:00+10:00,2023-06-04,23:20,0,2,2
79,2023-06-04T23:20:00+10:00,2023-06-04,23:20,1,1,2
117,2023-06-04T23:20:00+10:00,2023-06-04,23:20,12,7,19
6,2023-06-04T23:19:00+10:00,2023-06-04,23:19,6,1,7
14,2023-06-04T23:19:00+10:00,2023-06-04,23:19,0,4,4
29,2023-06-04T23:19:00+10:00,2023-06-04,23:19,7,0,7
41,2023-06-04T23:19:00+10:00,2023-06-04,23:19,10,0,10
54,2023-06-04T23:19:00+10:00,2023-06-04,23:19,1,1,2
66,2023-06-04T23:19:00+10:00,2023-06-04,23:19,0,3,3
24,2023-06-04T23:19:00+10:00,2023-06-04,23:19,0,2,2
35,2023-06-04T23:19:00+10:00,2023-06-04,23:19,2,4,6
48,2023-06-04T23:19:00+10:00,2023-06-04,23:19,1,0,1
56,2023-06-04T23:19:00+10:00,2023-06-04,23:19,2,0,2
62,2023-06-04T23:19:00+10:00,2023-06-04,23:19,8,1,9
3,2023-06-04T23:19:00+10:00,2023-06-04,23:19,3,1,4
4,2023-06-04T23:19:00+10:00,2023-06-04,23:19,0,4,4
5,2023-06-04T23:19:00+10:00,2023-06-04,23:19,3,1,4
21,2023-06-04T23:19:00+10:00,2023-06-04,23:19,2,0,2
28,2023-06-04T23:19:00+10:00,2023-06-04,23:19,1,0,1
65,2023-06-04T23:19:00+10:00,2023-06-04,23:19,0,1,1
1,2023-06-04T23:19:00+10:00,2023-06-04,23:19,2,5,7
9,2023-06-04T23:19:00+10:00,2023-06-04,23:19,2,0,2
19,2023-06-04T23:19:00+10:00,2023-06-04,23:19,2,2,4
53,2023-06-04T23:19:00+10:00,2023-06-04,23:19,0,4,4
58,2023-06-04T23:19:00+10:00,2023-06-04,23:19,0,1,1
67,2023-06-04T23:19:00+10:00,2023-06-04,23:19,0,9,9
8,2023-06-04T23:19:00+10:00,2023-06-04,23:19,0,1,1
31,2023-06-04T23:19:00+10:00,2023-06-04,23:19,0,2,2
36,2023-06-04T23:19:00+10:00,2023-06-04,23:19,2,0,2
40,2023-06-04T23:19:00+10:00,2023-06-04,23:19,1,0,1
45,2023-06-04T23:19:00+10:00,2023-06-04,23:19,3,3,6
47,2023-06-04T23:19:00+10:00,2023-06-04,23:19,1,1,2
55,2023-06-04T23:19:00+10:00,2023-06-04,23:19,5,7,12
20,2023-06-04T23:19:00+10:00,2023-06-04,23:19,1,0,1
30,2023-06-04T23:19:00+10:00,2023-06-04,23:19,6,2,8
52,2023-06-04T23:19:00+10:00,2023-06-04,23:19,0,3,3
57,2023-06-04T23:19:00+10:00,2023-06-04,23:19,0,1,1
72,2023-06-04T23:19:00+10:00,2023-06-04,23:19,1,2,3
79,2023-06-04T23:19:00+10:00,2023-06-04,23:19,0,3,3
3,2023-06-04T23:18:00+10:00,2023-06-04,23:18,4,12,16
5,2023-06-04T23:18:00+10:00,2023-06-04,23:18,2,4,6
54,2023-06-04T23:18:00+10:00,2023-06-04,23:18,0,4,4
70,2023-06-04T23:18:00+10:00,2023-06-04,23:18,0,2,2
87,2023-06-04T23:18:00+10:00,2023-06-04,23:18,1,0,1
12,2023-06-04T23:18:00+10:00,2023-06-04,23:18,1,0,1
35,2023-06-04T23:18:00+10:00,2023-06-04,23:18,1,3,4
48,2023-06-04T23:18:00+10:00,2023-06-04,23:18,1,1,2
4,2023-06-04T23:18:00+10:00,2023-06-04,23:18,15,4,19
6,2023-06-04T23:18:00+10:00,2023-06-04,23:18,3,4,7
41,2023-06-04T23:18:00+10:00,2023-06-04,23:18,14,1,15
42,2023-06-04T23:18:00+10:00,2023-06-04,23:18,0,5,5
61,2023-06-04T23:18:00+10:00,2023-06-04,23:18,0,1,1
71,2023-06-04T23:18:00+10:00,2023-06-04,23:18,2,2,4
1,2023-06-04T23:18:00+10:00,2023-06-04,23:18,0,3,3
11,2023-06-04T23:18:00+10:00,2023-06-04,23:18,2,0,2
19,2023-06-04T23:18:00+10:00,2023-06-04,23:18,1,2,3
23,2023-06-04T23:18:00+10:00,2023-06-04,23:18,0,4,4
30,2023-06-04T23:18:00+10:00,2023-06-04,23:18,11,2,13
57,2023-06-04T23:18:00+10:00,2023-06-04,23:18,0,1,1
67,2023-06-04T23:18:00+10:00,2023-06-04,23:18,0,4,4
68,2023-06-04T23:18:00+10:00,2023-06-04,23:18,1,0,1
72,2023-06-04T23:18:00+10:00,2023-06-04,23:18,0,8,8
14,2023-06-04T23:18:00+10:00,2023-06-04,23:18,3,0,3
21,2023-06-04T23:18:00+10:00,2023-06-04,23:18,3,3,6
31,2023-06-04T23:18:00+10:00,2023-06-04,23:18,0,2,2
45,2023-06-04T23:18:00+10:00,2023-06-04,23:18,0,1,1
47,2023-06-04T23:18:00+10:00,2023-06-04,23:18,4,1,5
55,2023-06-04T23:18:00+10:00,2023-06-04,23:18,6,7,13
66,2023-06-04T23:18:00+10:00,2023-06-04,23:18,0,2,2
2,2023-06-04T23:18:00+10:00,2023-06-04,23:18,1,0,1
49,2023-06-04T23:18:00+10:00,2023-06-04,23:18,1,2,3
51,2023-06-04T23:18:00+10:00,2023-06-04,23:18,1,2,3
58,2023-06-04T23:18:00+10:00,2023-06-04,23:18,0,1,1
79,2023-06-04T23:18:00+10:00,2023-06-04,23:18,5,12,17
41,2023-06-04T23:17:00+10:00,2023-06-04,23:17,9,11,20
61,2023-06-04T23:17:00+10:00,2023-06-04,23:17,1,0,1
65,2023-06-04T23:17:00+10:00,2023-06-04,23:17,0,2,2
108,2023-06-04T23:17:00+10:00,2023-06-04,23:17,0,1,1
19,2023-06-04T23:17:00+10:00,2023-06-04,23:17,2,1,3
23,2023-06-04T23:17:00+10:00,2023-06-04,23:17,1,3,4
24,2023-06-04T23:17:00+10:00,2023-06-04,23:17,1,13,14
30,2023-06-04T23:17:00+10:00,2023-06-04,23:17,2,0,2
35,2023-06-04T23:17:00+10:00,2023-06-04,23:17,1,9,10
58,2023-06-04T23:17:00+10:00,2023-06-04,23:17,1,1,2
67,2023-06-04T23:17:00+10:00,2023-06-04,23:17,0,1,1
3,2023-06-04T23:17:00+10:00,2023-06-04,23:17,2,0,2
4,2023-06-04T23:17:00+10:00,2023-06-04,23:17,9,5,14
26,2023-06-04T23:17:00+10:00,2023-06-04,23:17,0,3,3
28,2023-06-04T23:17:00+10:00,2023-06-04,23:17,2,0,2
40,2023-06-04T23:17:00+10:00,2023-06-04,23:17,1,0,1
66,2023-06-04T23:17:00+10:00,2023-06-04,23:17,0,2,2
75,2023-06-04T23:17:00+10:00,2023-06-04,23:17,1,0,1
1,2023-06-04T23:17:00+10:00,2023-06-04,23:17,1,2,3
49,2023-06-04T23:17:00+10:00,2023-06-04,23:17,0,2,2
53,2023-06-04T23:17:00+10:00,2023-06-04,23:17,0,2,2
68,2023-06-04T23:17:00+10:00,2023-06-04,23:17,3,0,3
72,2023-06-04T23:17:00+10:00,2023-06-04,23:17,3,7,10
5,2023-06-04T23:17:00+10:00,2023-06-04,23:17,0,3,3
6,2023-06-04T23:17:00+10:00,2023-06-04,23:17,5,1,6
14,2023-06-04T23:17:00+10:00,2023-06-04,23:17,1,2,3
29,2023-06-04T23:17:00+10:00,2023-06-04,23:17,0,2,2
47,2023-06-04T23:17:00+10:00,2023-06-04,23:17,0,1,1
50,2023-06-04T23:17:00+10:00,2023-06-04,23:17,2,0,2
55,2023-06-04T23:17:00+10:00,2023-06-04,23:17,10,1,11
71,2023-06-04T23:17:00+10:00,2023-06-04,23:17,0,1,1
2,2023-06-04T23:17:00+10:00,2023-06-04,23:17,0,3,3
9,2023-06-04T23:17:00+10:00,2023-06-04,23:17,1,0,1
62,2023-06-04T23:17:00+10:00,2023-06-04,23:17,2,0,2
79,2023-06-04T23:17:00+10:00,2023-06-04,23:17,12,6,18
3,2023-06-04T23:16:00+10:00,2023-06-04,23:16,5,10,15
6,2023-06-04T23:16:00+10:00,2023-06-04,23:16,5,1,6
29,2023-06-04T23:16:00+10:00,2023-06-04,23:16,0,6,6
37,2023-06-04T23:16:00+10:00,2023-06-04,23:16,1,2,3
45,2023-06-04T23:16:00+10:00,2023-06-04,23:16,0,2,2
65,2023-06-04T23:16:00+10:00,2023-06-04,23:16,1,1,2
108,2023-06-04T23:16:00+10:00,2023-06-04,23:16,0,2,2
30,2023-06-04T23:16:00+10:00,2023-06-04,23:16,2,7,9
52,2023-06-04T23:16:00+10:00,2023-06-04,23:16,0,5,5
56,2023-06-04T23:16:00+10:00,2023-06-04,23:16,5,3,8
67,2023-06-04T23:16:00+10:00,2023-06-04,23:16,0,5,5
21,2023-06-04T23:16:00+10:00,2023-06-04,23:16,0,3,3
54,2023-06-04T23:16:00+10:00,2023-06-04,23:16,1,3,4
55,2023-06-04T23:16:00+10:00,2023-06-04,23:16,5,7,12
77,2023-06-04T23:16:00+10:00,2023-06-04,23:16,1,0,1
12,2023-06-04T23:16:00+10:00,2023-06-04,23:16,0,2,2
17,2023-06-04T23:16:00+10:00,2023-06-04,23:16,1,0,1
27,2023-06-04T23:16:00+10:00,2023-06-04,23:16,0,1,1
35,2023-06-04T23:16:00+10:00,2023-06-04,23:16,5,12,17
46,2023-06-04T23:16:00+10:00,2023-06-04,23:16,0,1,1
48,2023-06-04T23:16:00+10:00,2023-06-04,23:16,2,0,2
49,2023-06-04T23:16:00+10:00,2023-06-04,23:16,4,0,4
53,2023-06-04T23:16:00+10:00,2023-06-04,23:16,0,1,1
62,2023-06-04T23:16:00+10:00,2023-06-04,23:16,3,1,4
4,2023-06-04T23:16:00+10:00,2023-06-04,23:16,4,0,4
5,2023-06-04T23:16:00+10:00,2023-06-04,23:16,0,1,1
14,2023-06-04T23:16:00+10:00,2023-06-04,23:16,2,1,3
26,2023-06-04T23:16:00+10:00,2023-06-04,23:16,7,0,7
36,2023-06-04T23:16:00+10:00,2023-06-04,23:16,2,0,2
41,2023-06-04T23:16:00+10:00,2023-06-04,23:16,7,4,11
47,2023-06-04T23:16:00+10:00,2023-06-04,23:16,0,2,2
1,2023-06-04T23:16:00+10:00,2023-06-04,23:16,1,0,1
19,2023-06-04T23:16:00+10:00,2023-06-04,23:16,1,3,4
23,2023-06-04T23:16:00+10:00,2023-06-04,23:16,0,2,2
24,2023-06-04T23:16:00+10:00,2023-06-04,23:16,0,15,15
58,2023-06-04T23:16:00+10:00,2023-06-04,23:16,1,1,2
72,2023-06-04T23:16:00+10:00,2023-06-04,23:16,5,11,16
79,2023-06-04T23:16:00+10:00,2023-06-04,23:16,0,11,11
26,2023-06-04T23:15:00+10:00,2023-06-04,23:15,1,4,5
28,2023-06-04T23:15:00+10:00,2023-06-04,23:15,4,0,4
45,2023-06-04T23:15:00+10:00,2023-06-04,23:15,0,5,5
61,2023-06-04T23:15:00+10:00,2023-06-04,23:15,2,0,2
70,2023-06-04T23:15:00+10:00,2023-06-04,23:15,0,2,2
71,2023-06-04T23:15:00+10:00,2023-06-04,23:15,1,0,1
84,2023-06-04T23:15:00+10:00,2023-06-04,23:15,21,20,41
12,2023-06-04T23:15:00+10:00,2023-06-04,23:15,0,1,1
23,2023-06-04T23:15:00+10:00,2023-06-04,23:15,0,1,1
35,2023-06-04T23:15:00+10:00,2023-06-04,23:15,1,5,6
46,2023-06-04T23:15:00+10:00,2023-06-04,23:15,0,1,1
52,2023-06-04T23:15:00+10:00,2023-06-04,23:15,1,3,4
58,2023-06-04T23:15:00+10:00,2023-06-04,23:15,0,1,1
62,2023-06-04T23:15:00+10:00,2023-06-04,23:15,0,2,2
109,2023-06-04T23:15:00+10:00,2023-06-04,23:15,1,3,4
3,2023-06-04T23:15:00+10:00,2023-06-04,23:15,5,6,11
14,2023-06-04T23:15:00+10:00,2023-06-04,23:15,1,1,2
21,2023-06-04T23:15:00+10:00,2023-06-04,23:15,1,1,2
29,2023-06-04T23:15:00+10:00,2023-06-04,23:15,0,1,1
41,2023-06-04T23:15:00+10:00,2023-06-04,23:15,13,2,15
59,2023-06-04T23:15:00+10:00,2023-06-04,23:15,16,7,23
65,2023-06-04T23:15:00+10:00,2023-06-04,23:15,0,2,2
107,2023-06-04T23:15:00+10:00,2023-06-04,23:15,0,2,2
118,2023-06-04T23:15:00+10:00,2023-06-04,23:15,1,1,2
11,2023-06-04T23:15:00+10:00,2023-06-04,23:15,0,1,1
20,2023-06-04T23:15:00+10:00,2023-06-04,23:15,0,7,7
49,2023-06-04T23:15:00+10:00,2023-06-04,23:15,0,1,1
72,2023-06-04T23:15:00+10:00,2023-06-04,23:15,0,3,3
79,2023-06-04T23:15:00+10:00,2023-06-04,23:15,1,9,10
117,2023-06-04T23:15:00+10:00,2023-06-04,23:15,2,26,28
4,2023-06-04T23:15:00+10:00,2023-06-04,23:15,0,2,2
5,2023-06-04T23:15:00+10:00,2023-06-04,23:15,6,7,13
6,2023-06-04T23:15:00+10:00,2023-06-04,23:15,9,7,16
55,2023-06-04T23:15:00+10:00,2023-06-04,23:15,5,4,9
66,2023-06-04T23:15:00+10:00,2023-06-04,23:15,1,5,6
9,2023-06-04T23:15:00+10:00,2023-06-04,23:15,0,1,1
24,2023-06-04T23:15:00+10:00,2023-06-04,23:15,2,3,5
30,2023-06-04T23:15:00+10:00,2023-06-04,23:15,1,0,1
5,2023-06-04T23:14:00+10:00,2023-06-04,23:14,5,6,11
28,2023-06-04T23:14:00+10:00,2023-06-04,23:14,2,0,2
31,2023-06-04T23:14:00+10:00,2023-06-04,23:14,0,2,2
45,2023-06-04T23:14:00+10:00,2023-06-04,23:14,0,2,2
47,2023-06-04T23:14:00+10:00,2023-06-04,23:14,5,4,9
50,2023-06-04T23:14:00+10:00,2023-06-04,23:14,0,1,1
54,2023-06-04T23:14:00+10:00,2023-06-04,23:14,3,1,4
55,2023-06-04T23:14:00+10:00,2023-06-04,23:14,1,4,5
30,2023-06-04T23:14:00+10:00,2023-06-04,23:14,4,2,6
46,2023-06-04T23:14:00+10:00,2023-06-04,23:14,3,0,3
52,2023-06-04T23:14:00+10:00,2023-06-04,23:14,0,1,1
56,2023-06-04T23:14:00+10:00,2023-06-04,23:14,1,0,1
57,2023-06-04T23:14:00+10:00,2023-06-04,23:14,1,0,1
62,2023-06-04T23:14:00+10:00,2023-06-04,23:14,3,3,6
67,2023-06-04T23:14:00+10:00,2023-06-04,23:14,0,2,2
72,2023-06-04T23:14:00+10:00,2023-06-04,23:14,4,4,8
6,2023-06-04T23:14:00+10:00,2023-06-04,23:14,1,5,6
26,2023-06-04T23:14:00+10:00,2023-06-04,23:14,1,0,1
29,2023-06-04T23:14:00+10:00,2023-06-04,23:14,2,0,2
61,2023-06-04T23:14:00+10:00,2023-06-04,23:14,1,0,1
65,2023-06-04T23:14:00+10:00,2023-06-04,23:14,0,2,2
66,2023-06-04T23:14:00+10:00,2023-06-04,23:14,7,0,7
69,2023-06-04T23:14:00+10:00,2023-06-04,23:14,0,1,1
108,2023-06-04T23:14:00+10:00,2023-06-04,23:14,2,0,2
19,2023-06-04T23:14:00+10:00,2023-06-04,23:14,1,5,6
20,2023-06-04T23:14:00+10:00,2023-06-04,23:14,3,0,3
24,2023-06-04T23:14:00+10:00,2023-06-04,23:14,3,2,5
49,2023-06-04T23:14:00+10:00,2023-06-04,23:14,0,1,1
51,2023-06-04T23:14:00+10:00,2023-06-04,23:14,2,0,2
53,2023-06-04T23:14:00+10:00,2023-06-04,23:14,3,0,3
58,2023-06-04T23:14:00+10:00,2023-06-04,23:14,1,7,8
3,2023-06-04T23:14:00+10:00,2023-06-04,23:14,6,12,18
4,2023-06-04T23:14:00+10:00,2023-06-04,23:14,2,3,5
14,2023-06-04T23:14:00+10:00,2023-06-04,23:14,4,0,4
21,2023-06-04T23:14:00+10:00,2023-06-04,23:14,2,1,3
40,2023-06-04T23:14:00+10:00,2023-06-04,23:14,1,0,1
41,2023-06-04T23:14:00+10:00,2023-06-04,23:14,19,7,26
75,2023-06-04T23:14:00+10:00,2023-06-04,23:14,3,0,3
17,2023-06-04T23:14:00+10:00,2023-06-04,23:14,0,1,1
35,2023-06-04T23:14:00+10:00,2023-06-04,23:14,2,7,9
79,2023-06-04T23:14:00+10:00,2023-06-04,23:14,0,4,4
4,2023-06-04T23:13:00+10:00,2023-06-04,23:13,1,1,2
6,2023-06-04T23:13:00+10:00,2023-06-04,23:13,3,3,6
26,2023-06-04T23:13:00+10:00,2023-06-04,23:13,1,1,2
29,2023-06-04T23:13:00+10:00,2023-06-04,23:13,3,1,4
31,2023-06-04T23:13:00+10:00,2023-06-04,23:13,0,5,5
41,2023-06-04T23:13:00+10:00,2023-06-04,23:13,3,6,9
47,2023-06-04T23:13:00+10:00,2023-06-04,23:13,9,4,13
61,2023-06-04T23:13:00+10:00,2023-06-04,23:13,4,0,4
65,2023-06-04T23:13:00+10:00,2023-06-04,23:13,0,3,3
1,2023-06-04T23:13:00+10:00,2023-06-04,23:13,4,1,5
20,2023-06-04T23:13:00+10:00,2023-06-04,23:13,2,5,7
35,2023-06-04T23:13:00+10:00,2023-06-04,23:13,7,8,15
68,2023-06-04T23:13:00+10:00,2023-06-04,23:13,1,0,1
3,2023-06-04T23:13:00+10:00,2023-06-04,23:13,5,6,11
37,2023-06-04T23:13:00+10:00,2023-06-04,23:13,2,0,2
42,2023-06-04T23:13:00+10:00,2023-06-04,23:13,0,2,2
45,2023-06-04T23:13:00+10:00,2023-06-04,23:13,0,7,7
55,2023-06-04T23:13:00+10:00,2023-06-04,23:13,3,7,10
66,2023-06-04T23:13:00+10:00,2023-06-04,23:13,3,1,4
2,2023-06-04T23:13:00+10:00,2023-06-04,23:13,0,1,1
12,2023-06-04T23:13:00+10:00,2023-06-04,23:13,1,0,1
23,2023-06-04T23:13:00+10:00,2023-06-04,23:13,1,2,3
24,2023-06-04T23:13:00+10:00,2023-06-04,23:13,4,1,5
49,2023-06-04T23:13:00+10:00,2023-06-04,23:13,1,2,3
52,2023-06-04T23:13:00+10:00,2023-06-04,23:13,2,1,3
56,2023-06-04T23:13:00+10:00,2023-06-04,23:13,3,0,3
58,2023-06-04T23:13:00+10:00,2023-06-04,23:13,1,5,6
67,2023-06-04T23:13:00+10:00,2023-06-04,23:13,2,0,2
79,2023-06-04T23:13:00+10:00,2023-06-04,23:13,1,1,2
5,2023-06-04T23:13:00+10:00,2023-06-04,23:13,3,2,5
14,2023-06-04T23:13:00+10:00,2023-06-04,23:13,6,0,6
21,2023-06-04T23:13:00+10:00,2023-06-04,23:13,1,3,4
77,2023-06-04T23:13:00+10:00,2023-06-04,23:13,1,0,1
108,2023-06-04T23:13:00+10:00,2023-06-04,23:13,0,2,2
19,2023-06-04T23:13:00+10:00,2023-06-04,23:13,0,4,4
30,2023-06-04T23:13:00+10:00,2023-06-04,23:13,5,0,5
57,2023-06-04T23:13:00+10:00,2023-06-04,23:13,0,1,1
62,2023-06-04T23:13:00+10:00,2023-06-04,23:13,3,9,12
72,2023-06-04T23:13:00+10:00,2023-06-04,23:13,4,2,6
3,2023-06-04T23:12:00+10:00,2023-06-04,23:12,3,3,6
4,2023-06-04T23:12:00+10:00,2023-06-04,23:12,11,2,13
5,2023-06-04T23:12:00+10:00,2023-06-04,23:12,10,4,14
28,2023-06-04T23:12:00+10:00,2023-06-04,23:12,2,1,3
39,2023-06-04T23:12:00+10:00,2023-06-04,23:12,0,1,1
42,2023-06-04T23:12:00+10:00,2023-06-04,23:12,0,2,2
54,2023-06-04T23:12:00+10:00,2023-06-04,23:12,0,2,2
9,2023-06-04T23:12:00+10:00,2023-06-04,23:12,0,1,1
19,2023-06-04T23:12:00+10:00,2023-06-04,23:12,3,0,3
30,2023-06-04T23:12:00+10:00,2023-06-04,23:12,3,1,4
48,2023-06-04T23:12:00+10:00,2023-06-04,23:12,1,0,1
29,2023-06-04T23:12:00+10:00,2023-06-04,23:12,1,3,4
37,2023-06-04T23:12:00+10:00,2023-06-04,23:12,1,0,1
41,2023-06-04T23:12:00+10:00,2023-06-04,23:12,4,12,16
66,2023-06-04T23:12:00+10:00,2023-06-04,23:12,0,8,8
71,2023-06-04T23:12:00+10:00,2023-06-04,23:12,0,1,1
108,2023-06-04T23:12:00+10:00,2023-06-04,23:12,2,2,4
35,2023-06-04T23:12:00+10:00,2023-06-04,23:12,0,2,2
49,2023-06-04T23:12:00+10:00,2023-06-04,23:12,1,0,1
51,2023-06-04T23:12:00+10:00,2023-06-04,23:12,0,1,1
56,2023-06-04T23:12:00+10:00,2023-06-04,23:12,1,1,2
57,2023-06-04T23:12:00+10:00,2023-06-04,23:12,1,4,5
62,2023-06-04T23:12:00+10:00,2023-06-04,23:12,0,1,1
72,2023-06-04T23:12:00+10:00,2023-06-04,23:12,3,3,6
79,2023-06-04T23:12:00+10:00,2023-06-04,23:12,2,4,6
6,2023-06-04T23:12:00+10:00,2023-06-04,23:12,3,3,6
14,2023-06-04T23:12:00+10:00,2023-06-04,23:12,2,0,2
21,2023-06-04T23:12:00+10:00,2023-06-04,23:12,2,1,3
36,2023-06-04T23:12:00+10:00,2023-06-04,23:12,1,0,1
45,2023-06-04T23:12:00+10:00,2023-06-04,23:12,0,1,1
47,2023-06-04T23:12:00+10:00,2023-06-04,23:12,7,0,7
55,2023-06-04T23:12:00+10:00,2023-06-04,23:12,10,4,14
61,2023-06-04T23:12:00+10:00,2023-06-04,23:12,6,0,6
77,2023-06-04T23:12:00+10:00,2023-06-04,23:12,1,0,1
11,2023-06-04T23:12:00+10:00,2023-06-04,23:12,0,2,2
24,2023-06-04T23:12:00+10:00,2023-06-04,23:12,4,0,4
52,2023-06-04T23:12:00+10:00,2023-06-04,23:12,2,3,5
58,2023-06-04T23:12:00+10:00,2023-06-04,23:12,3,0,3
67,2023-06-04T23:12:00+10:00,2023-06-04,23:12,0,3,3
3,2023-06-04T23:11:00+10:00,2023-06-04,23:11,5,5,10
28,2023-06-04T23:11:00+10:00,2023-06-04,23:11,2,2,4
31,2023-06-04T23:11:00+10:00,2023-06-04,23:11,1,2,3
42,2023-06-04T23:11:00+10:00,2023-06-04,23:11,2,0,2
55,2023-06-04T23:11:00+10:00,2023-06-04,23:11,16,2,18
66,2023-06-04T23:11:00+10:00,2023-06-04,23:11,1,0,1
108,2023-06-04T23:11:00+10:00,2023-06-04,23:11,1,1,2
17,2023-06-04T23:11:00+10:00,2023-06-04,23:11,0,4,4
30,2023-06-04T23:11:00+10:00,2023-06-04,23:11,3,4,7
51,2023-06-04T23:11:00+10:00,2023-06-04,23:11,2,2,4
56,2023-06-04T23:11:00+10:00,2023-06-04,23:11,2,0,2
67,2023-06-04T23:11:00+10:00,2023-06-04,23:11,2,1,3
72,2023-06-04T23:11:00+10:00,2023-06-04,23:11,1,8,9
4,2023-06-04T23:11:00+10:00,2023-06-04,23:11,0,3,3
6,2023-06-04T23:11:00+10:00,2023-06-04,23:11,5,1,6
14,2023-06-04T23:11:00+10:00,2023-06-04,23:11,4,0,4
29,2023-06-04T23:11:00+10:00,2023-06-04,23:11,1,1,2
41,2023-06-04T23:11:00+10:00,2023-06-04,23:11,10,4,14
61,2023-06-04T23:11:00+10:00,2023-06-04,23:11,1,0,1
9,2023-06-04T23:11:00+10:00,2023-06-04,23:11,1,0,1
12,2023-06-04T23:11:00+10:00,2023-06-04,23:11,0,2,2
19,2023-06-04T23:11:00+10:00,2023-06-04,23:11,7,1,8
20,2023-06-04T23:11:00+10:00,2023-06-04,23:11,0,2,2
24,2023-06-04T23:11:00+10:00,2023-06-04,23:11,3,2,5
35,2023-06-04T23:11:00+10:00,2023-06-04,23:11,0,4,4
58,2023-06-04T23:11:00+10:00,2023-06-04,23:11,4,1,5
62,2023-06-04T23:11:00+10:00,2023-06-04,23:11,4,1,5
79,2023-06-04T23:11:00+10:00,2023-06-04,23:11,0,2,2
5,2023-06-04T23:11:00+10:00,2023-06-04,23:11,1,4,5
21,2023-06-04T23:11:00+10:00,2023-06-04,23:11,2,0,2
40,2023-06-04T23:11:00+10:00,2023-06-04,23:11,2,2,4
45,2023-06-04T23:11:00+10:00,2023-06-04,23:11,1,1,2
47,2023-06-04T23:11:00+10:00,2023-06-04,23:11,0,2,2
1,2023-06-04T23:11:00+10:00,2023-06-04,23:11,1,0,1
2,2023-06-04T23:11:00+10:00,2023-06-04,23:11,0,1,1
49,2023-06-04T23:11:00+10:00,2023-06-04,23:11,3,2,5
52,2023-06-04T23:11:00+10:00,2023-06-04,23:11,1,1,2
